Casual,Member,Total Rides,Humidity (%),Temperature (Â°C),WMO Code,Weather,Wind (km/h),Datetime,Hour
20,26,46,90,2.4,1,Mostly Clear,10.2,2021-01-01 00:00:00,0
23,23,46,88,1.8,1,Mostly Clear,10.0,2021-01-01 01:00:00,1
20,28,48,87,1.1,2,Partly Cloudy,10.1,2021-01-01 02:00:00,2
9,7,16,81,1.6,2,Partly Cloudy,10.6,2021-01-01 03:00:00,3
7,5,12,77,1.6,2,Partly Cloudy,9.9,2021-01-01 04:00:00,4
11,3,14,75,1.4,2,Partly Cloudy,8.7,2021-01-01 05:00:00,5
8,18,26,72,1.4,2,Partly Cloudy,8.9,2021-01-01 06:00:00,6
10,17,27,71,1.4,3,Cloudy,7.9,2021-01-01 07:00:00,7
22,33,55,71,1.4,3,Cloudy,7.1,2021-01-01 08:00:00,8
22,54,76,70,1.6,3,Cloudy,7.2,2021-01-01 09:00:00,9
29,56,85,69,1.9,3,Cloudy,9.0,2021-01-01 10:00:00,10
16,40,56,71,2.0,3,Cloudy,9.6,2021-01-01 11:00:00,11
21,38,59,80,2.0,51,Light Drizzle,8.4,2021-01-01 12:00:00,12
30,35,65,87,2.1,53,Heavy Drizzle,7.8,2021-01-01 13:00:00,13
39,54,93,90,2.2,53,Heavy Drizzle,9.4,2021-01-01 14:00:00,14
24,40,64,92,2.3,53,Heavy Drizzle,6.3,2021-01-01 15:00:00,15
14,32,46,94,2.5,53,Heavy Drizzle,8.4,2021-01-01 16:00:00,16
6,13,19,95,2.5,53,Heavy Drizzle,8.7,2021-01-01 17:00:00,17
3,12,15,96,2.7,61,Light Rain,8.5,2021-01-01 18:00:00,18
2,7,9,97,3.0,63,Rain,6.1,2021-01-01 19:00:00,19
6,10,16,97,3.5,63,Rain,5.0,2021-01-01 20:00:00,20
4,10,14,98,4.1,61,Light Rain,3.7,2021-01-01 21:00:00,21
12,9,21,98,4.7,63,Rain,7.6,2021-01-01 22:00:00,22
13,20,33,98,5.2,63,Rain,7.2,2021-01-01 23:00:00,23
4,8,12,99,5.2,61,Light Rain,5.5,2021-01-02 00:00:00,0
4,10,14,99,5.1,51,Light Drizzle,5.0,2021-01-02 01:00:00,1
1,0,1,98,5.2,3,Cloudy,9.5,2021-01-02 02:00:00,2
1,1,2,98,4.0,3,Cloudy,12.6,2021-01-02 03:00:00,3
4,2,6,98,4.4,3,Cloudy,15.5,2021-01-02 04:00:00,4
2,4,6,98,5.2,3,Cloudy,16.8,2021-01-02 05:00:00,5
8,18,26,97,5.9,3,Cloudy,11.9,2021-01-02 06:00:00,6
15,38,53,97,6.3,3,Cloudy,11.5,2021-01-02 07:00:00,7
31,53,84,96,6.5,3,Cloudy,9.1,2021-01-02 08:00:00,8
63,120,183,97,6.7,3,Cloudy,8.9,2021-01-02 09:00:00,9
106,151,257,97,7.7,3,Cloudy,8.5,2021-01-02 10:00:00,10
201,214,415,93,9.5,3,Cloudy,9.4,2021-01-02 11:00:00,11
349,283,632,80,11.2,1,Mostly Clear,11.2,2021-01-02 12:00:00,12
401,343,744,66,11.9,1,Mostly Clear,14.9,2021-01-02 13:00:00,13
499,332,831,62,11.8,3,Cloudy,19.1,2021-01-02 14:00:00,14
426,330,756,63,12.4,3,Cloudy,17.0,2021-01-02 15:00:00,15
281,309,590,63,11.8,2,Partly Cloudy,15.9,2021-01-02 16:00:00,16
125,200,325,64,11.1,1,Mostly Clear,13.6,2021-01-02 17:00:00,17
112,127,239,70,9.4,1,Mostly Clear,8.7,2021-01-02 18:00:00,18
65,106,171,76,8.1,1,Mostly Clear,8.6,2021-01-02 19:00:00,19
53,73,126,81,7.0,2,Partly Cloudy,8.7,2021-01-02 20:00:00,20
41,50,91,85,6.0,1,Mostly Clear,9.8,2021-01-02 21:00:00,21
46,39,85,89,5.0,1,Mostly Clear,8.2,2021-01-02 22:00:00,22
36,33,69,91,4.1,1,Mostly Clear,8.6,2021-01-02 23:00:00,23
16,25,41,92,3.4,1,Mostly Clear,9.9,2021-01-03 00:00:00,0
10,4,14,91,3.1,1,Mostly Clear,10.9,2021-01-03 01:00:00,1
5,3,8,91,2.9,1,Mostly Clear,8.4,2021-01-03 02:00:00,2
6,5,11,88,3.1,1,Mostly Clear,9.1,2021-01-03 03:00:00,3
1,0,1,86,3.3,3,Cloudy,10.0,2021-01-03 04:00:00,4
2,2,4,81,3.9,2,Partly Cloudy,13.0,2021-01-03 05:00:00,5
3,12,15,86,3.7,61,Light Rain,6.9,2021-01-03 06:00:00,6
5,11,16,91,3.6,61,Light Rain,6.6,2021-01-03 07:00:00,7
11,39,50,93,3.4,63,Rain,11.0,2021-01-03 08:00:00,8
16,62,78,93,3.2,53,Heavy Drizzle,11.7,2021-01-03 09:00:00,9
36,112,148,93,3.5,3,Cloudy,9.4,2021-01-03 10:00:00,10
44,132,176,92,3.9,3,Cloudy,11.8,2021-01-03 11:00:00,11
56,119,175,91,4.4,3,Cloudy,10.8,2021-01-03 12:00:00,12
59,119,178,89,5.1,3,Cloudy,8.7,2021-01-03 13:00:00,13
23,70,93,89,5.3,3,Cloudy,6.6,2021-01-03 14:00:00,14
34,57,91,95,4.5,53,Heavy Drizzle,8.4,2021-01-03 15:00:00,15
27,70,97,96,4.6,53,Heavy Drizzle,9.6,2021-01-03 16:00:00,16
20,65,85,97,4.5,53,Heavy Drizzle,10.5,2021-01-03 17:00:00,17
28,78,106,97,4.3,51,Light Drizzle,6.2,2021-01-03 18:00:00,18
28,56,84,98,4.3,3,Cloudy,7.6,2021-01-03 19:00:00,19
21,38,59,97,4.2,3,Cloudy,8.8,2021-01-03 20:00:00,20
16,29,45,97,4.1,2,Partly Cloudy,9.4,2021-01-03 21:00:00,21
16,15,31,96,4.0,2,Partly Cloudy,10.7,2021-01-03 22:00:00,22
12,10,22,95,3.8,1,Mostly Clear,12.2,2021-01-03 23:00:00,23
10,5,15,94,3.4,1,Mostly Clear,13.3,2021-01-04 00:00:00,0
4,2,6,94,2.8,0,Clear,13.2,2021-01-04 01:00:00,1
0,1,1,94,2.2,1,Mostly Clear,12.2,2021-01-04 02:00:00,2
3,1,4,95,2.2,0,Clear,11.5,2021-01-04 03:00:00,3
3,7,10,95,1.8,0,Clear,10.8,2021-01-04 04:00:00,4
7,22,29,96,1.3,0,Clear,9.7,2021-01-04 05:00:00,5
7,55,62,96,0.9,0,Clear,8.7,2021-01-04 06:00:00,6
26,133,159,95,0.6,0,Clear,8.3,2021-01-04 07:00:00,7
34,138,172,95,0.4,0,Clear,7.4,2021-01-04 08:00:00,8
29,91,120,94,0.7,0,Clear,7.1,2021-01-04 09:00:00,9
39,85,124,92,2.4,0,Clear,7.4,2021-01-04 10:00:00,10
39,118,157,82,4.9,1,Mostly Clear,7.9,2021-01-04 11:00:00,11
91,158,249,74,6.2,1,Mostly Clear,10.4,2021-01-04 12:00:00,12
78,133,211,63,7.0,1,Mostly Clear,9.7,2021-01-04 13:00:00,13
90,139,229,61,6.9,2,Partly Cloudy,7.4,2021-01-04 14:00:00,14
66,163,229,59,8.2,3,Cloudy,6.0,2021-01-04 15:00:00,15
89,203,292,60,7.8,3,Cloudy,5.6,2021-01-04 16:00:00,16
82,209,291,65,7.3,3,Cloudy,4.4,2021-01-04 17:00:00,17
68,161,229,70,6.7,3,Cloudy,4.5,2021-01-04 18:00:00,18
46,95,141,77,5.9,3,Cloudy,4.8,2021-01-04 19:00:00,19
34,59,93,83,5.1,3,Cloudy,5.3,2021-01-04 20:00:00,20
27,47,74,86,4.7,3,Cloudy,5.4,2021-01-04 21:00:00,21
13,30,43,87,4.4,3,Cloudy,5.1,2021-01-04 22:00:00,22
22,19,41,88,4.2,3,Cloudy,4.6,2021-01-04 23:00:00,23
8,6,14,90,3.6,3,Cloudy,4.5,2021-01-05 00:00:00,0
4,3,7,91,3.3,3,Cloudy,4.7,2021-01-05 01:00:00,1
3,0,3,91,3.1,3,Cloudy,3.2,2021-01-05 02:00:00,2
3,1,4,86,3.5,3,Cloudy,4.0,2021-01-05 03:00:00,3
5,9,14,88,3.1,3,Cloudy,3.6,2021-01-05 04:00:00,4
2,25,27,91,2.6,3,Cloudy,3.8,2021-01-05 05:00:00,5
7,67,74,91,2.7,3,Cloudy,3.3,2021-01-05 06:00:00,6
15,108,123,91,2.8,3,Cloudy,4.2,2021-01-05 07:00:00,7
36,170,206,91,2.8,3,Cloudy,3.7,2021-01-05 08:00:00,8
44,92,136,91,2.9,3,Cloudy,2.3,2021-01-05 09:00:00,9
48,87,135,88,3.8,3,Cloudy,2.9,2021-01-05 10:00:00,10
80,126,206,82,5.0,3,Cloudy,3.1,2021-01-05 11:00:00,11
95,129,224,73,5.9,3,Cloudy,4.2,2021-01-05 12:00:00,12
79,159,238,72,6.2,51,Light Drizzle,4.6,2021-01-05 13:00:00,13
104,146,250,71,6.2,51,Light Drizzle,5.5,2021-01-05 14:00:00,14
118,146,264,76,5.9,51,Light Drizzle,6.0,2021-01-05 15:00:00,15
78,131,209,77,5.7,51,Light Drizzle,6.0,2021-01-05 16:00:00,16
73,181,254,79,5.4,3,Cloudy,6.0,2021-01-05 17:00:00,17
54,149,203,81,4.9,51,Light Drizzle,7.4,2021-01-05 18:00:00,18
56,103,159,85,4.2,3,Cloudy,7.5,2021-01-05 19:00:00,19
50,64,114,87,3.8,3,Cloudy,8.2,2021-01-05 20:00:00,20
31,49,80,88,3.4,3,Cloudy,8.2,2021-01-05 21:00:00,21
43,35,78,89,2.9,2,Partly Cloudy,8.9,2021-01-05 22:00:00,22
21,18,39,90,2.4,1,Mostly Clear,9.2,2021-01-05 23:00:00,23
18,20,38,91,1.9,2,Partly Cloudy,9.8,2021-01-06 00:00:00,0
5,7,12,91,1.5,1,Mostly Clear,11.6,2021-01-06 01:00:00,1
3,7,10,90,1.4,1,Mostly Clear,12.5,2021-01-06 02:00:00,2
7,2,9,87,2.0,1,Mostly Clear,13.2,2021-01-06 03:00:00,3
3,7,10,87,2.0,0,Clear,13.0,2021-01-06 04:00:00,4
19,19,38,88,1.7,0,Clear,13.0,2021-01-06 05:00:00,5
30,51,81,87,1.3,3,Cloudy,10.5,2021-01-06 06:00:00,6
65,115,180,87,1.1,3,Cloudy,11.5,2021-01-06 07:00:00,7
73,126,199,86,1.1,3,Cloudy,10.7,2021-01-06 08:00:00,8
56,97,153,83,1.3,3,Cloudy,11.0,2021-01-06 09:00:00,9
111,119,230,79,2.7,2,Partly Cloudy,10.7,2021-01-06 10:00:00,10
86,123,209,68,4.2,3,Cloudy,17.4,2021-01-06 11:00:00,11
101,141,242,57,5.3,3,Cloudy,20.8,2021-01-06 12:00:00,12
111,130,241,52,6.1,3,Cloudy,20.5,2021-01-06 13:00:00,13
137,157,294,52,6.3,3,Cloudy,20.3,2021-01-06 14:00:00,14
164,206,370,52,6.3,3,Cloudy,20.5,2021-01-06 15:00:00,15
131,175,306,51,6.3,3,Cloudy,20.0,2021-01-06 16:00:00,16
113,144,257,50,5.9,3,Cloudy,18.7,2021-01-06 17:00:00,17
44,49,93,52,5.1,3,Cloudy,13.8,2021-01-06 18:00:00,18
17,17,34,54,4.4,3,Cloudy,12.9,2021-01-06 19:00:00,19
26,14,40,56,3.7,2,Partly Cloudy,11.8,2021-01-06 20:00:00,20
15,12,27,57,3.3,2,Partly Cloudy,11.5,2021-01-06 21:00:00,21
9,6,15,59,3.0,2,Partly Cloudy,11.8,2021-01-06 22:00:00,22
15,9,24,60,2.6,2,Partly Cloudy,12.5,2021-01-06 23:00:00,23
10,2,12,62,2.3,3,Cloudy,13.5,2021-01-07 00:00:00,0
4,3,7,63,1.8,2,Partly Cloudy,14.1,2021-01-07 01:00:00,1
0,3,3,64,1.4,1,Mostly Clear,14.3,2021-01-07 02:00:00,2
4,1,5,65,2.0,1,Mostly Clear,14.4,2021-01-07 03:00:00,3
5,2,7,67,1.6,0,Clear,14.2,2021-01-07 04:00:00,4
13,11,24,69,1.2,0,Clear,13.6,2021-01-07 05:00:00,5
16,39,55,71,0.9,0,Clear,11.1,2021-01-07 06:00:00,6
16,80,96,72,0.7,0,Clear,10.5,2021-01-07 07:00:00,7
27,120,147,72,0.5,0,Clear,10.3,2021-01-07 08:00:00,8
39,111,150,75,0.3,0,Clear,10.2,2021-01-07 09:00:00,9
42,88,130,72,1.6,0,Clear,10.2,2021-01-07 10:00:00,10
115,108,223,63,3.1,0,Clear,14.0,2021-01-07 11:00:00,11
117,152,269,60,4.1,0,Clear,12.6,2021-01-07 12:00:00,12
120,120,240,57,5.2,0,Clear,11.3,2021-01-07 13:00:00,13
128,157,285,54,6.1,0,Clear,12.0,2021-01-07 14:00:00,14
119,175,294,50,7.1,0,Clear,11.9,2021-01-07 15:00:00,15
85,225,310,49,7.3,1,Mostly Clear,11.8,2021-01-07 16:00:00,16
81,222,303,50,6.9,1,Mostly Clear,8.9,2021-01-07 17:00:00,17
63,208,271,55,5.6,1,Mostly Clear,6.1,2021-01-07 18:00:00,18
47,127,174,62,4.1,1,Mostly Clear,6.6,2021-01-07 19:00:00,19
36,79,115,69,2.8,1,Mostly Clear,6.4,2021-01-07 20:00:00,20
39,49,88,72,1.7,1,Mostly Clear,6.7,2021-01-07 21:00:00,21
28,44,72,75,0.8,1,Mostly Clear,8.8,2021-01-07 22:00:00,22
13,17,30,78,0.0,1,Mostly Clear,10.1,2021-01-07 23:00:00,23
4,11,15,82,-0.7,1,Mostly Clear,7.7,2021-01-08 00:00:00,0
1,9,10,84,-1.2,1,Mostly Clear,7.3,2021-01-08 01:00:00,1
1,5,6,83,-1.1,1,Mostly Clear,8.1,2021-01-08 02:00:00,2
1,1,2,82,-1.5,1,Mostly Clear,7.9,2021-01-08 03:00:00,3
3,6,9,78,-1.0,1,Mostly Clear,11.2,2021-01-08 04:00:00,4
2,16,18,81,-1.0,2,Partly Cloudy,6.3,2021-01-08 05:00:00,5
15,56,71,79,-1.1,2,Partly Cloudy,5.0,2021-01-08 06:00:00,6
17,122,139,80,-1.4,2,Partly Cloudy,4.8,2021-01-08 07:00:00,7
39,135,174,80,-1.1,3,Cloudy,3.7,2021-01-08 08:00:00,8
45,85,130,80,-1.1,3,Cloudy,7.0,2021-01-08 09:00:00,9
45,90,135,70,0.4,3,Cloudy,7.9,2021-01-08 10:00:00,10
42,130,172,65,1.4,3,Cloudy,7.9,2021-01-08 11:00:00,11
61,134,195,63,2.1,2,Partly Cloudy,5.1,2021-01-08 12:00:00,12
48,164,212,62,2.2,2,Partly Cloudy,5.1,2021-01-08 13:00:00,13
64,144,208,60,2.7,2,Partly Cloudy,6.9,2021-01-08 14:00:00,14
65,196,261,55,3.5,2,Partly Cloudy,8.4,2021-01-08 15:00:00,15
94,219,313,54,4.0,2,Partly Cloudy,9.0,2021-01-08 16:00:00,16
57,210,267,54,3.7,2,Partly Cloudy,8.7,2021-01-08 17:00:00,17
45,172,217,58,2.8,2,Partly Cloudy,4.4,2021-01-08 18:00:00,18
47,93,140,61,1.9,2,Partly Cloudy,7.7,2021-01-08 19:00:00,19
27,87,114,62,1.4,0,Clear,8.9,2021-01-08 20:00:00,20
17,35,52,63,1.0,0,Clear,9.4,2021-01-08 21:00:00,21
27,50,77,64,0.7,1,Mostly Clear,11.4,2021-01-08 22:00:00,22
17,33,50,62,0.8,1,Mostly Clear,12.9,2021-01-08 23:00:00,23
13,9,22,62,0.3,1,Mostly Clear,13.7,2021-01-09 00:00:00,0
6,4,10,63,-0.2,1,Mostly Clear,14.6,2021-01-09 01:00:00,1
9,5,14,62,-0.6,2,Partly Cloudy,15.7,2021-01-09 02:00:00,2
11,2,13,58,-0.4,2,Partly Cloudy,16.7,2021-01-09 03:00:00,3
2,4,6,54,-0.5,2,Partly Cloudy,17.3,2021-01-09 04:00:00,4
5,8,13,51,-0.9,2,Partly Cloudy,17.4,2021-01-09 05:00:00,5
8,23,31,49,-1.2,1,Mostly Clear,16.2,2021-01-09 06:00:00,6
15,43,58,48,-1.4,1,Mostly Clear,16.0,2021-01-09 07:00:00,7
26,54,80,48,-1.6,1,Mostly Clear,16.0,2021-01-09 08:00:00,8
47,109,156,50,-1.6,1,Mostly Clear,15.8,2021-01-09 09:00:00,9
66,148,214,48,-0.7,1,Mostly Clear,15.5,2021-01-09 10:00:00,10
104,175,279,43,0.7,1,Mostly Clear,16.4,2021-01-09 11:00:00,11
144,231,375,39,2.2,0,Clear,16.8,2021-01-09 12:00:00,12
173,266,439,36,3.5,0,Clear,17.4,2021-01-09 13:00:00,13
196,263,459,34,4.6,0,Clear,18.2,2021-01-09 14:00:00,14
199,277,476,33,6.0,0,Clear,19.1,2021-01-09 15:00:00,15
181,258,439,34,6.5,0,Clear,18.9,2021-01-09 16:00:00,16
78,209,287,38,6.2,0,Clear,16.9,2021-01-09 17:00:00,17
67,163,230,41,5.0,0,Clear,13.3,2021-01-09 18:00:00,18
41,115,156,45,4.1,0,Clear,14.8,2021-01-09 19:00:00,19
29,69,98,47,3.6,0,Clear,16.3,2021-01-09 20:00:00,20
22,62,84,49,3.1,0,Clear,18.1,2021-01-09 21:00:00,21
27,51,78,50,2.7,0,Clear,19.4,2021-01-09 22:00:00,22
21,34,55,51,2.3,0,Clear,19.1,2021-01-09 23:00:00,23
16,25,41,52,1.9,0,Clear,18.7,2021-01-10 00:00:00,0
9,18,27,52,1.4,0,Clear,17.7,2021-01-10 01:00:00,1
3,15,18,51,1.0,0,Clear,16.4,2021-01-10 02:00:00,2
6,4,10,48,1.3,0,Clear,15.4,2021-01-10 03:00:00,3
1,3,4,49,1.0,0,Clear,14.7,2021-01-10 04:00:00,4
4,8,12,51,0.5,0,Clear,13.9,2021-01-10 05:00:00,5
6,14,20,53,0.1,0,Clear,11.2,2021-01-10 06:00:00,6
8,23,31,57,-0.3,0,Clear,10.9,2021-01-10 07:00:00,7
15,69,84,61,-0.8,0,Clear,11.2,2021-01-10 08:00:00,8
27,126,153,67,-1.0,0,Clear,11.8,2021-01-10 09:00:00,9
74,185,259,64,1.0,0,Clear,12.0,2021-01-10 10:00:00,10
116,195,311,57,3.0,0,Clear,13.8,2021-01-10 11:00:00,11
163,261,424,54,4.4,0,Clear,13.7,2021-01-10 12:00:00,12
214,282,496,53,5.5,0,Clear,11.8,2021-01-10 13:00:00,13
207,275,482,51,6.4,0,Clear,10.1,2021-01-10 14:00:00,14
199,273,472,47,7.8,0,Clear,9.1,2021-01-10 15:00:00,15
163,243,406,47,8.0,0,Clear,8.6,2021-01-10 16:00:00,16
92,172,264,49,7.5,0,Clear,6.6,2021-01-10 17:00:00,17
46,114,160,56,6.3,0,Clear,6.7,2021-01-10 18:00:00,18
47,84,131,71,3.9,0,Clear,7.1,2021-01-10 19:00:00,19
28,54,82,78,1.8,0,Clear,7.4,2021-01-10 20:00:00,20
13,35,48,82,0.4,0,Clear,7.1,2021-01-10 21:00:00,21
15,29,44,81,0.1,0,Clear,7.5,2021-01-10 22:00:00,22
7,15,22,80,0.6,1,Mostly Clear,6.8,2021-01-10 23:00:00,23
11,12,23,79,1.3,0,Clear,5.9,2021-01-11 00:00:00,0
2,6,8,82,0.6,0,Clear,6.2,2021-01-11 01:00:00,1
1,1,2,87,-0.2,0,Clear,6.5,2021-01-11 02:00:00,2
3,0,3,84,-0.5,0,Clear,5.2,2021-01-11 03:00:00,3
3,4,7,85,-0.5,0,Clear,4.5,2021-01-11 04:00:00,4
4,23,27,86,-0.6,1,Mostly Clear,2.9,2021-01-11 05:00:00,5
7,55,62,88,-1.0,2,Partly Cloudy,5.6,2021-01-11 06:00:00,6
18,108,126,89,-1.3,3,Cloudy,5.2,2021-01-11 07:00:00,7
39,164,203,89,-1.2,3,Cloudy,4.9,2021-01-11 08:00:00,8
37,124,161,89,-0.8,3,Cloudy,4.0,2021-01-11 09:00:00,9
29,99,128,85,1.1,2,Partly Cloudy,5.1,2021-01-11 10:00:00,10
33,116,149,74,3.0,3,Cloudy,5.6,2021-01-11 11:00:00,11
36,124,160,69,4.2,3,Cloudy,6.4,2021-01-11 12:00:00,12
42,122,164,66,5.1,3,Cloudy,7.9,2021-01-11 13:00:00,13
45,142,187,67,5.2,3,Cloudy,7.0,2021-01-11 14:00:00,14
54,176,230,68,5.3,3,Cloudy,6.8,2021-01-11 15:00:00,15
75,175,250,71,5.1,2,Partly Cloudy,7.2,2021-01-11 16:00:00,16
63,242,305,75,4.3,1,Mostly Clear,7.6,2021-01-11 17:00:00,17
56,195,251,80,3.1,1,Mostly Clear,9.0,2021-01-11 18:00:00,18
40,142,182,85,2.0,1,Mostly Clear,9.2,2021-01-11 19:00:00,19
33,76,109,88,1.4,1,Mostly Clear,9.8,2021-01-11 20:00:00,20
21,42,63,91,0.8,0,Clear,7.1,2021-01-11 21:00:00,21
16,24,40,92,0.0,0,Clear,8.5,2021-01-11 22:00:00,22
9,22,31,93,-0.8,0,Clear,8.3,2021-01-11 23:00:00,23
5,9,14,94,-1.7,0,Clear,7.2,2021-01-12 00:00:00,0
6,5,11,94,-2.1,0,Clear,7.1,2021-01-12 01:00:00,1
1,3,4,92,-2.4,0,Clear,7.5,2021-01-12 02:00:00,2
3,3,6,93,-2.4,0,Clear,7.9,2021-01-12 03:00:00,3
1,8,9,90,-2.5,0,Clear,9.2,2021-01-12 04:00:00,4
9,23,32,86,-2.3,0,Clear,10.2,2021-01-12 05:00:00,5
7,76,83,84,-2.2,0,Clear,7.9,2021-01-12 06:00:00,6
23,126,149,84,-2.2,0,Clear,7.5,2021-01-12 07:00:00,7
44,185,229,85,-2.6,0,Clear,6.7,2021-01-12 08:00:00,8
37,153,190,86,-2.7,0,Clear,8.2,2021-01-12 09:00:00,9
36,123,159,76,0.7,0,Clear,7.7,2021-01-12 10:00:00,10
54,153,207,65,3.1,0,Clear,8.2,2021-01-12 11:00:00,11
70,180,250,59,4.4,0,Clear,7.9,2021-01-12 12:00:00,12
59,158,217,55,5.5,0,Clear,6.9,2021-01-12 13:00:00,13
64,200,264,53,6.4,0,Clear,7.1,2021-01-12 14:00:00,14
92,180,272,50,7.5,0,Clear,6.0,2021-01-12 15:00:00,15
111,257,368,49,7.7,0,Clear,5.2,2021-01-12 16:00:00,16
95,321,416,54,7.1,0,Clear,4.9,2021-01-12 17:00:00,17
64,207,271,72,5.7,0,Clear,6.7,2021-01-12 18:00:00,18
52,154,206,61,5.2,0,Clear,2.7,2021-01-12 19:00:00,19
36,87,123,72,2.9,0,Clear,1.3,2021-01-12 20:00:00,20
27,67,94,79,1.0,0,Clear,3.2,2021-01-12 21:00:00,21
15,26,41,86,-0.7,0,Clear,5.6,2021-01-12 22:00:00,22
8,21,29,88,-1.4,0,Clear,7.6,2021-01-12 23:00:00,23
6,9,15,86,-1.5,0,Clear,6.8,2021-01-13 00:00:00,0
4,3,7,82,-1.7,0,Clear,8.5,2021-01-13 01:00:00,1
1,0,1,81,-2.0,0,Clear,9.7,2021-01-13 02:00:00,2
3,2,5,82,-1.7,0,Clear,9.5,2021-01-13 03:00:00,3
3,5,8,82,-1.8,0,Clear,9.4,2021-01-13 04:00:00,4
11,18,29,83,-2.1,0,Clear,7.9,2021-01-13 05:00:00,5
13,73,86,83,-2.2,0,Clear,7.2,2021-01-13 06:00:00,6
17,127,144,83,-2.3,0,Clear,7.6,2021-01-13 07:00:00,7
45,176,221,83,-2.3,0,Clear,6.6,2021-01-13 08:00:00,8
51,135,186,81,-1.6,0,Clear,4.9,2021-01-13 09:00:00,9
46,126,172,74,1.1,0,Clear,0.7,2021-01-13 10:00:00,10
55,159,214,62,4.1,0,Clear,1.5,2021-01-13 11:00:00,11
92,197,289,56,5.8,0,Clear,3.3,2021-01-13 12:00:00,12
85,164,249,53,7.0,0,Clear,5.2,2021-01-13 13:00:00,13
85,164,249,52,7.7,0,Clear,6.8,2021-01-13 14:00:00,14
107,221,328,51,8.6,0,Clear,7.9,2021-01-13 15:00:00,15
93,273,366,52,8.7,0,Clear,7.9,2021-01-13 16:00:00,16
104,293,397,58,8.0,0,Clear,5.2,2021-01-13 17:00:00,17
98,226,324,65,6.6,0,Clear,7.7,2021-01-13 18:00:00,18
70,158,228,74,4.7,0,Clear,7.1,2021-01-13 19:00:00,19
38,107,145,82,3.2,0,Clear,7.9,2021-01-13 20:00:00,20
23,71,94,85,2.3,0,Clear,7.7,2021-01-13 21:00:00,21
21,43,64,87,1.6,0,Clear,7.4,2021-01-13 22:00:00,22
24,38,62,87,0.9,0,Clear,6.8,2021-01-13 23:00:00,23
8,16,24,88,0.1,0,Clear,7.2,2021-01-14 00:00:00,0
8,6,14,88,-0.4,0,Clear,8.6,2021-01-14 01:00:00,1
2,2,4,86,-0.2,0,Clear,8.4,2021-01-14 02:00:00,2
5,0,5,88,-0.7,0,Clear,7.0,2021-01-14 03:00:00,3
5,4,9,88,-0.9,0,Clear,6.9,2021-01-14 04:00:00,4
9,33,42,88,-1.0,0,Clear,6.5,2021-01-14 05:00:00,5
9,69,78,89,-1.2,0,Clear,4.5,2021-01-14 06:00:00,6
28,143,171,90,-1.4,1,Mostly Clear,5.8,2021-01-14 07:00:00,7
48,180,228,89,-1.4,2,Partly Cloudy,7.1,2021-01-14 08:00:00,8
60,140,200,87,-0.8,1,Mostly Clear,7.9,2021-01-14 09:00:00,9
49,133,182,86,1.6,1,Mostly Clear,9.2,2021-01-14 10:00:00,10
67,129,196,67,5.4,1,Mostly Clear,8.4,2021-01-14 11:00:00,11
64,158,222,57,7.6,0,Clear,7.1,2021-01-14 12:00:00,12
95,162,257,52,9.1,0,Clear,7.1,2021-01-14 13:00:00,13
75,201,276,50,9.9,0,Clear,4.7,2021-01-14 14:00:00,14
111,200,311,47,10.9,0,Clear,1.8,2021-01-14 15:00:00,15
93,280,373,46,11.0,0,Clear,0.4,2021-01-14 16:00:00,16
103,272,375,51,10.3,0,Clear,1.8,2021-01-14 17:00:00,17
81,223,304,59,8.7,1,Mostly Clear,6.9,2021-01-14 18:00:00,18
65,136,201,72,6.0,1,Mostly Clear,6.9,2021-01-14 19:00:00,19
38,94,132,81,4.1,1,Mostly Clear,7.4,2021-01-14 20:00:00,20
38,59,97,85,2.9,1,Mostly Clear,7.2,2021-01-14 21:00:00,21
21,35,56,87,2.3,2,Partly Cloudy,7.4,2021-01-14 22:00:00,22
13,27,40,88,1.6,1,Mostly Clear,7.7,2021-01-14 23:00:00,23
5,11,16,89,0.8,1,Mostly Clear,8.2,2021-01-15 00:00:00,0
5,5,10,89,0.3,1,Mostly Clear,7.4,2021-01-15 01:00:00,1
3,2,5,88,0.1,1,Mostly Clear,7.4,2021-01-15 02:00:00,2
3,1,4,85,0.2,1,Mostly Clear,6.9,2021-01-15 03:00:00,3
2,7,9,87,-0.3,1,Mostly Clear,7.8,2021-01-15 04:00:00,4
9,14,23,88,-0.5,1,Mostly Clear,10.4,2021-01-15 05:00:00,5
15,53,68,89,-0.3,1,Mostly Clear,10.9,2021-01-15 06:00:00,6
27,118,145,89,0.0,1,Mostly Clear,11.5,2021-01-15 07:00:00,7
48,159,207,90,0.1,1,Mostly Clear,11.6,2021-01-15 08:00:00,8
38,131,169,91,0.4,1,Mostly Clear,11.1,2021-01-15 09:00:00,9
38,138,176,87,2.5,0,Clear,11.2,2021-01-15 10:00:00,10
70,153,223,77,5.4,1,Mostly Clear,12.6,2021-01-15 11:00:00,11
80,187,267,71,7.6,0,Clear,14.9,2021-01-15 12:00:00,12
68,187,255,70,9.0,0,Clear,15.8,2021-01-15 13:00:00,13
115,219,334,68,9.9,2,Partly Cloudy,18.9,2021-01-15 14:00:00,14
96,241,337,64,10.4,3,Cloudy,18.1,2021-01-15 15:00:00,15
94,254,348,69,9.9,3,Cloudy,14.6,2021-01-15 16:00:00,16
68,226,294,75,9.0,3,Cloudy,14.7,2021-01-15 17:00:00,17
48,102,150,81,8.2,3,Cloudy,14.7,2021-01-15 18:00:00,18
23,71,94,86,7.5,51,Light Drizzle,12.5,2021-01-15 19:00:00,19
20,39,59,92,6.8,53,Heavy Drizzle,11.2,2021-01-15 20:00:00,20
12,36,48,94,6.7,53,Heavy Drizzle,11.5,2021-01-15 21:00:00,21
19,31,50,95,6.5,53,Heavy Drizzle,8.9,2021-01-15 22:00:00,22
18,25,43,96,6.5,53,Heavy Drizzle,8.2,2021-01-15 23:00:00,23
9,26,35,97,6.5,51,Light Drizzle,8.1,2021-01-16 00:00:00,0
14,12,26,97,6.3,53,Heavy Drizzle,6.8,2021-01-16 01:00:00,1
4,13,17,97,5.9,51,Light Drizzle,5.7,2021-01-16 02:00:00,2
4,13,17,99,5.1,2,Partly Cloudy,10.2,2021-01-16 03:00:00,3
1,8,9,96,4.6,0,Clear,12.0,2021-01-16 04:00:00,4
6,9,15,95,3.7,0,Clear,11.7,2021-01-16 05:00:00,5
13,20,33,95,2.7,0,Clear,11.1,2021-01-16 06:00:00,6
19,39,58,95,1.7,0,Clear,11.3,2021-01-16 07:00:00,7
40,72,112,94,0.8,1,Mostly Clear,11.2,2021-01-16 08:00:00,8
76,135,211,94,0.3,1,Mostly Clear,11.4,2021-01-16 09:00:00,9
121,197,318,90,1.3,1,Mostly Clear,11.2,2021-01-16 10:00:00,10
150,221,371,84,2.7,2,Partly Cloudy,12.2,2021-01-16 11:00:00,11
179,262,441,77,4.2,2,Partly Cloudy,10.9,2021-01-16 12:00:00,12
228,302,530,66,5.9,0,Clear,10.8,2021-01-16 13:00:00,13
240,310,550,56,7.1,0,Clear,11.3,2021-01-16 14:00:00,14
217,259,476,46,8.1,2,Partly Cloudy,13.3,2021-01-16 15:00:00,15
161,262,423,44,7.7,2,Partly Cloudy,14.1,2021-01-16 16:00:00,16
114,209,323,52,6.6,2,Partly Cloudy,14.1,2021-01-16 17:00:00,17
60,144,204,61,5.4,2,Partly Cloudy,10.4,2021-01-16 18:00:00,18
63,101,164,66,4.4,3,Cloudy,10.9,2021-01-16 19:00:00,19
28,66,94,65,4.0,3,Cloudy,12.1,2021-01-16 20:00:00,20
39,63,102,65,3.4,2,Partly Cloudy,13.0,2021-01-16 21:00:00,21
37,56,93,63,2.7,1,Mostly Clear,14.4,2021-01-16 22:00:00,22
27,42,69,62,2.1,0,Clear,16.2,2021-01-16 23:00:00,23
18,15,33,61,1.7,0,Clear,15.1,2021-01-17 00:00:00,0
10,13,23,62,1.4,0,Clear,14.1,2021-01-17 01:00:00,1
6,7,13,64,1.0,0,Clear,13.7,2021-01-17 02:00:00,2
2,2,4,66,0.5,0,Clear,13.4,2021-01-17 03:00:00,3
2,6,8,69,-0.0,0,Clear,12.1,2021-01-17 04:00:00,4
4,7,11,71,-0.4,0,Clear,12.8,2021-01-17 05:00:00,5
7,16,23,70,-0.2,2,Partly Cloudy,11.2,2021-01-17 06:00:00,6
12,30,42,70,-0.1,2,Partly Cloudy,11.2,2021-01-17 07:00:00,7
16,60,76,73,-0.2,2,Partly Cloudy,11.7,2021-01-17 08:00:00,8
36,105,141,76,-0.1,1,Mostly Clear,12.3,2021-01-17 09:00:00,9
88,164,252,73,1.8,0,Clear,12.3,2021-01-17 10:00:00,10
93,196,289,65,4.3,1,Mostly Clear,13.3,2021-01-17 11:00:00,11
165,226,391,58,6.2,2,Partly Cloudy,14.0,2021-01-17 12:00:00,12
178,256,434,50,7.3,3,Cloudy,19.6,2021-01-17 13:00:00,13
201,227,428,47,7.6,3,Cloudy,18.0,2021-01-17 14:00:00,14
207,255,462,47,7.8,3,Cloudy,16.3,2021-01-17 15:00:00,15
133,200,333,46,7.8,3,Cloudy,14.2,2021-01-17 16:00:00,16
74,171,245,48,7.5,3,Cloudy,10.8,2021-01-17 17:00:00,17
62,118,180,51,6.6,2,Partly Cloudy,8.9,2021-01-17 18:00:00,18
28,69,97,55,5.7,2,Partly Cloudy,8.9,2021-01-17 19:00:00,19
32,60,92,59,4.9,1,Mostly Clear,9.6,2021-01-17 20:00:00,20
27,49,76,62,4.2,1,Mostly Clear,10.7,2021-01-17 21:00:00,21
22,32,54,64,3.9,2,Partly Cloudy,10.7,2021-01-17 22:00:00,22
14,24,38,67,3.2,0,Clear,10.2,2021-01-17 23:00:00,23
11,20,31,70,2.6,0,Clear,9.7,2021-01-18 00:00:00,0
4,4,8,74,1.7,0,Clear,10.2,2021-01-18 01:00:00,1
3,5,8,75,1.5,0,Clear,11.9,2021-01-18 02:00:00,2
3,0,3,74,1.4,0,Clear,11.6,2021-01-18 03:00:00,3
2,4,6,76,0.8,0,Clear,10.8,2021-01-18 04:00:00,4
5,9,14,80,-0.1,0,Clear,10.0,2021-01-18 05:00:00,5
9,34,43,82,-0.7,1,Mostly Clear,8.9,2021-01-18 06:00:00,6
17,55,72,83,-0.9,1,Mostly Clear,9.2,2021-01-18 07:00:00,7
23,75,98,83,-0.8,0,Clear,9.1,2021-01-18 08:00:00,8
49,115,164,83,-0.8,1,Mostly Clear,9.0,2021-01-18 09:00:00,9
64,124,188,76,1.9,1,Mostly Clear,10.4,2021-01-18 10:00:00,10
112,177,289,64,4.4,1,Mostly Clear,12.8,2021-01-18 11:00:00,11
127,207,334,51,5.4,1,Mostly Clear,18.5,2021-01-18 12:00:00,12
152,193,345,48,5.7,1,Mostly Clear,19.8,2021-01-18 13:00:00,13
147,215,362,44,6.2,2,Partly Cloudy,20.8,2021-01-18 14:00:00,14
134,213,347,37,6.9,2,Partly Cloudy,20.8,2021-01-18 15:00:00,15
123,244,367,37,6.8,2,Partly Cloudy,19.9,2021-01-18 16:00:00,16
63,185,248,38,6.3,0,Clear,16.7,2021-01-18 17:00:00,17
40,109,149,41,5.1,0,Clear,10.8,2021-01-18 18:00:00,18
44,84,128,45,3.8,0,Clear,10.8,2021-01-18 19:00:00,19
32,66,98,49,2.6,0,Clear,10.4,2021-01-18 20:00:00,20
20,32,52,53,1.7,0,Clear,10.5,2021-01-18 21:00:00,21
36,22,58,55,1.1,0,Clear,10.8,2021-01-18 22:00:00,22
9,20,29,57,0.8,0,Clear,12.0,2021-01-18 23:00:00,23
7,12,19,60,0.4,0,Clear,11.9,2021-01-19 00:00:00,0
5,3,8,64,-0.1,0,Clear,10.8,2021-01-19 01:00:00,1
1,3,4,69,-0.8,0,Clear,9.8,2021-01-19 02:00:00,2
2,1,3,74,-1.3,0,Clear,9.0,2021-01-19 03:00:00,3
4,5,9,77,-2.0,0,Clear,9.5,2021-01-19 04:00:00,4
7,10,17,78,-2.2,0,Clear,10.8,2021-01-19 05:00:00,5
11,60,71,78,-2.3,3,Cloudy,11.1,2021-01-19 06:00:00,6
21,82,103,78,-2.1,3,Cloudy,7.4,2021-01-19 07:00:00,7
44,116,160,78,-2.0,2,Partly Cloudy,7.7,2021-01-19 08:00:00,8
59,100,159,79,-1.7,2,Partly Cloudy,10.0,2021-01-19 09:00:00,9
54,105,159,70,1.4,2,Partly Cloudy,10.9,2021-01-19 10:00:00,10
78,92,170,62,3.7,3,Cloudy,11.2,2021-01-19 11:00:00,11
89,133,222,56,5.6,2,Partly Cloudy,11.5,2021-01-19 12:00:00,12
104,146,250,51,7.1,2,Partly Cloudy,13.0,2021-01-19 13:00:00,13
96,162,258,49,7.9,3,Cloudy,20.5,2021-01-19 14:00:00,14
108,179,287,41,8.9,1,Mostly Clear,18.9,2021-01-19 15:00:00,15
116,241,357,36,9.2,0,Clear,16.8,2021-01-19 16:00:00,16
123,231,354,37,8.8,0,Clear,11.9,2021-01-19 17:00:00,17
96,174,270,42,7.0,0,Clear,7.8,2021-01-19 18:00:00,18
59,129,188,49,5.0,0,Clear,8.0,2021-01-19 19:00:00,19
29,78,107,59,3.0,0,Clear,9.1,2021-01-19 20:00:00,20
28,53,81,66,1.3,0,Clear,10.1,2021-01-19 21:00:00,21
26,39,65,68,0.1,0,Clear,10.5,2021-01-19 22:00:00,22
18,31,49,68,-0.2,1,Mostly Clear,9.5,2021-01-19 23:00:00,23
6,9,15,67,0.0,1,Mostly Clear,8.7,2021-01-20 00:00:00,0
1,2,3,70,-0.3,0,Clear,6.5,2021-01-20 01:00:00,1
3,1,4,75,-0.9,0,Clear,4.2,2021-01-20 02:00:00,2
1,1,2,72,-0.0,1,Mostly Clear,6.5,2021-01-20 03:00:00,3
3,6,9,80,-1.0,53,Heavy Drizzle,6.3,2021-01-20 04:00:00,4
9,10,19,83,-0.6,51,Light Drizzle,8.9,2021-01-20 05:00:00,5
16,29,45,85,-0.6,53,Heavy Drizzle,11.5,2021-01-20 06:00:00,6
32,69,101,87,-0.0,51,Light Drizzle,13.2,2021-01-20 07:00:00,7
56,90,146,87,0.5,0,Clear,12.2,2021-01-20 08:00:00,8
53,100,153,85,0.7,0,Clear,15.5,2021-01-20 09:00:00,9
88,123,211,81,1.9,0,Clear,15.5,2021-01-20 10:00:00,10
83,92,175,65,3.6,0,Clear,19.5,2021-01-20 11:00:00,11
92,72,164,49,4.7,0,Clear,24.1,2021-01-20 12:00:00,12
75,144,219,44,5.3,0,Clear,22.8,2021-01-20 13:00:00,13
103,132,235,40,5.5,1,Mostly Clear,23.2,2021-01-20 14:00:00,14
79,143,222,42,5.7,3,Cloudy,24.7,2021-01-20 15:00:00,15
85,139,224,41,4.9,3,Cloudy,23.5,2021-01-20 16:00:00,16
64,138,202,39,4.3,0,Clear,19.9,2021-01-20 17:00:00,17
40,109,149,40,3.1,0,Clear,12.3,2021-01-20 18:00:00,18
29,75,104,43,1.7,0,Clear,7.6,2021-01-20 19:00:00,19
26,47,73,48,0.4,0,Clear,6.9,2021-01-20 20:00:00,20
16,40,56,63,-1.3,0,Clear,6.2,2021-01-20 21:00:00,21
24,35,59,63,-2.2,0,Clear,5.4,2021-01-20 22:00:00,22
11,21,32,60,-2.1,0,Clear,6.3,2021-01-20 23:00:00,23
9,10,19,56,-1.5,0,Clear,5.6,2021-01-21 00:00:00,0
2,2,4,56,-1.1,0,Clear,5.1,2021-01-21 01:00:00,1
1,1,2,59,-1.4,0,Clear,4.0,2021-01-21 02:00:00,2
3,2,5,78,-3.8,0,Clear,7.1,2021-01-21 04:00:00,4
7,19,26,79,-3.8,1,Mostly Clear,8.7,2021-01-21 05:00:00,5
13,56,69,80,-3.3,1,Mostly Clear,9.0,2021-01-21 06:00:00,6
31,125,156,81,-2.2,1,Mostly Clear,10.2,2021-01-21 07:00:00,7
32,152,184,82,-1.5,1,Mostly Clear,10.1,2021-01-21 08:00:00,8
49,122,171,78,-0.6,0,Clear,9.7,2021-01-21 09:00:00,9
49,89,138,69,0.9,0,Clear,9.0,2021-01-21 10:00:00,10
52,118,170,58,3.1,0,Clear,10.1,2021-01-21 11:00:00,11
88,156,244,52,5.4,0,Clear,9.7,2021-01-21 12:00:00,12
71,161,232,48,7.2,0,Clear,9.9,2021-01-21 13:00:00,13
102,182,284,45,8.5,0,Clear,10.3,2021-01-21 14:00:00,14
104,195,299,43,9.4,0,Clear,11.5,2021-01-21 15:00:00,15
105,276,381,43,9.8,0,Clear,11.0,2021-01-21 16:00:00,16
142,232,374,49,9.3,0,Clear,7.4,2021-01-21 17:00:00,17
90,197,287,56,7.2,0,Clear,8.4,2021-01-21 18:00:00,18
48,128,176,65,5.2,0,Clear,9.5,2021-01-21 19:00:00,19
42,93,135,71,3.8,0,Clear,11.2,2021-01-21 20:00:00,20
19,46,65,74,2.9,0,Clear,12.3,2021-01-21 21:00:00,21
29,51,80,73,2.4,0,Clear,12.2,2021-01-21 22:00:00,22
18,10,28,72,1.7,0,Clear,11.6,2021-01-21 23:00:00,23
7,10,17,74,1.2,0,Clear,12.1,2021-01-22 00:00:00,0
8,2,10,76,0.7,0,Clear,11.8,2021-01-22 01:00:00,1
3,2,5,78,0.3,0,Clear,11.3,2021-01-22 02:00:00,2
7,4,11,76,-0.3,0,Clear,11.0,2021-01-22 04:00:00,4
5,16,21,80,-0.9,0,Clear,10.3,2021-01-22 05:00:00,5
15,60,75,82,-1.4,0,Clear,9.5,2021-01-22 06:00:00,6
26,108,134,84,-1.7,0,Clear,8.9,2021-01-22 07:00:00,7
41,150,191,86,-2.0,0,Clear,8.4,2021-01-22 08:00:00,8
46,139,185,86,-1.7,0,Clear,7.9,2021-01-22 09:00:00,9
62,116,178,77,2.2,0,Clear,7.2,2021-01-22 10:00:00,10
96,133,229,62,5.4,0,Clear,5.9,2021-01-22 11:00:00,11
85,159,244,49,6.6,0,Clear,13.9,2021-01-22 12:00:00,12
122,184,306,45,6.9,3,Cloudy,19.9,2021-01-22 13:00:00,13
124,203,327,44,6.8,2,Partly Cloudy,20.4,2021-01-22 14:00:00,14
138,213,351,40,8.0,2,Partly Cloudy,19.6,2021-01-22 15:00:00,15
113,265,378,40,8.0,1,Mostly Clear,18.8,2021-01-22 16:00:00,16
148,309,457,41,7.6,1,Mostly Clear,16.6,2021-01-22 17:00:00,17
80,246,326,44,6.2,0,Clear,13.0,2021-01-22 18:00:00,18
56,163,219,47,4.8,0,Clear,12.2,2021-01-22 19:00:00,19
41,97,138,50,3.8,0,Clear,11.0,2021-01-22 20:00:00,20
28,64,92,52,3.1,0,Clear,9.2,2021-01-22 21:00:00,21
32,58,90,55,2.2,0,Clear,9.5,2021-01-22 22:00:00,22
19,33,52,57,1.4,0,Clear,9.4,2021-01-22 23:00:00,23
20,13,33,60,0.6,0,Clear,9.5,2021-01-23 00:00:00,0
6,17,23,63,-0.1,1,Mostly Clear,9.8,2021-01-23 01:00:00,1
3,9,12,65,-0.7,1,Mostly Clear,10.7,2021-01-23 02:00:00,2
2,4,6,57,0.3,2,Partly Cloudy,11.3,2021-01-23 03:00:00,3
4,2,6,55,0.1,2,Partly Cloudy,11.8,2021-01-23 04:00:00,4
3,6,9,54,-0.3,2,Partly Cloudy,12.2,2021-01-23 05:00:00,5
8,25,33,54,-0.7,2,Partly Cloudy,10.7,2021-01-23 06:00:00,6
10,42,52,52,-0.9,2,Partly Cloudy,12.8,2021-01-23 07:00:00,7
27,84,111,50,-1.2,3,Cloudy,14.8,2021-01-23 08:00:00,8
32,121,153,49,-1.3,2,Partly Cloudy,17.3,2021-01-23 09:00:00,9
77,173,250,41,-0.8,2,Partly Cloudy,21.8,2021-01-23 10:00:00,10
81,178,259,37,-0.3,3,Cloudy,23.6,2021-01-23 11:00:00,11
140,196,336,35,0.3,1,Mostly Clear,22.6,2021-01-23 12:00:00,12
126,216,342,34,0.8,0,Clear,22.5,2021-01-23 13:00:00,13
141,245,386,33,1.3,0,Clear,22.0,2021-01-23 14:00:00,14
117,225,342,33,1.3,0,Clear,20.9,2021-01-23 15:00:00,15
117,204,321,33,1.4,0,Clear,20.4,2021-01-23 16:00:00,16
75,190,265,32,1.1,0,Clear,19.1,2021-01-23 17:00:00,17
40,125,165,33,0.3,0,Clear,13.2,2021-01-23 18:00:00,18
28,99,127,35,-0.7,0,Clear,14.5,2021-01-23 19:00:00,19
26,68,94,37,-1.2,0,Clear,15.5,2021-01-23 20:00:00,20
22,39,61,38,-1.6,0,Clear,15.5,2021-01-23 21:00:00,21
17,26,43,39,-1.9,0,Clear,15.3,2021-01-23 22:00:00,22
23,30,53,40,-2.1,0,Clear,14.3,2021-01-23 23:00:00,23
14,15,29,41,-2.3,0,Clear,14.0,2021-01-24 00:00:00,0
8,13,21,42,-2.5,0,Clear,14.0,2021-01-24 01:00:00,1
2,6,8,43,-2.7,0,Clear,13.8,2021-01-24 02:00:00,2
0,1,1,45,-3.1,1,Mostly Clear,13.8,2021-01-24 03:00:00,3
4,5,9,45,-3.1,2,Partly Cloudy,12.4,2021-01-24 04:00:00,4
4,2,6,46,-3.1,1,Mostly Clear,13.0,2021-01-24 05:00:00,5
7,12,19,47,-3.3,1,Mostly Clear,13.8,2021-01-24 06:00:00,6
12,35,47,48,-3.5,1,Mostly Clear,11.8,2021-01-24 07:00:00,7
20,65,85,50,-3.6,0,Clear,11.2,2021-01-24 08:00:00,8
24,125,149,50,-3.5,0,Clear,11.5,2021-01-24 09:00:00,9
75,136,211,47,-2.4,1,Mostly Clear,11.3,2021-01-24 10:00:00,10
93,168,261,46,-1.1,0,Clear,9.3,2021-01-24 11:00:00,11
119,234,353,43,0.2,0,Clear,8.9,2021-01-24 12:00:00,12
140,231,371,42,1.4,1,Mostly Clear,8.8,2021-01-24 13:00:00,13
153,233,386,40,2.3,1,Mostly Clear,8.0,2021-01-24 14:00:00,14
124,182,306,41,2.5,1,Mostly Clear,6.0,2021-01-24 15:00:00,15
99,196,295,41,2.6,2,Partly Cloudy,3.8,2021-01-24 16:00:00,16
77,168,245,42,2.3,2,Partly Cloudy,4.0,2021-01-24 17:00:00,17
57,110,167,47,1.7,2,Partly Cloudy,5.4,2021-01-24 18:00:00,18
31,68,99,58,0.7,2,Partly Cloudy,6.6,2021-01-24 19:00:00,19
19,51,70,68,0.0,2,Partly Cloudy,2.7,2021-01-24 20:00:00,20
21,39,60,69,-0.1,2,Partly Cloudy,1.8,2021-01-24 21:00:00,21
27,44,71,69,-0.1,2,Partly Cloudy,3.3,2021-01-24 22:00:00,22
13,27,40,68,-0.4,3,Cloudy,3.5,2021-01-24 23:00:00,23
4,4,8,64,-0.1,3,Cloudy,3.6,2021-01-25 00:00:00,0
2,4,6,63,0.0,3,Cloudy,4.4,2021-01-25 01:00:00,1
3,2,5,63,0.1,3,Cloudy,5.2,2021-01-25 02:00:00,2
1,3,4,70,0.2,3,Cloudy,4.1,2021-01-25 03:00:00,3
3,2,5,66,0.4,71,Light Snow,5.9,2021-01-25 04:00:00,4
5,21,26,66,0.4,3,Cloudy,5.8,2021-01-25 05:00:00,5
8,60,68,67,0.5,3,Cloudy,5.9,2021-01-25 06:00:00,6
16,114,130,68,0.6,3,Cloudy,6.2,2021-01-25 07:00:00,7
37,172,209,70,0.6,3,Cloudy,6.1,2021-01-25 08:00:00,8
30,136,166,74,0.6,3,Cloudy,6.5,2021-01-25 09:00:00,9
29,93,122,73,1.2,3,Cloudy,9.1,2021-01-25 10:00:00,10
49,112,161,68,2.4,3,Cloudy,8.4,2021-01-25 11:00:00,11
43,151,194,63,3.4,3,Cloudy,7.6,2021-01-25 12:00:00,12
46,121,167,59,4.8,3,Cloudy,7.2,2021-01-25 13:00:00,13
53,132,185,59,4.9,3,Cloudy,7.1,2021-01-25 14:00:00,14
72,138,210,54,3.9,3,Cloudy,6.5,2021-01-25 15:00:00,15
52,205,257,54,3.7,3,Cloudy,7.0,2021-01-25 16:00:00,16
30,163,193,57,3.0,3,Cloudy,8.0,2021-01-25 17:00:00,17
11,80,91,62,2.2,71,Light Snow,8.4,2021-01-25 18:00:00,18
12,53,65,67,1.6,73,Snow,8.0,2021-01-25 19:00:00,19
9,38,47,72,1.1,73,Snow,3.6,2021-01-25 20:00:00,20
8,18,26,78,0.8,73,Snow,8.3,2021-01-25 21:00:00,21
10,16,26,85,0.5,73,Snow,8.4,2021-01-25 22:00:00,22
10,9,19,89,0.4,73,Snow,10.0,2021-01-25 23:00:00,23
2,2,4,91,0.2,73,Snow,11.2,2021-01-26 00:00:00,0
2,1,3,91,0.2,73,Snow,9.4,2021-01-26 01:00:00,1
1,1,2,92,0.2,71,Light Snow,10.8,2021-01-26 02:00:00,2
1,2,3,90,-0.1,71,Light Snow,11.6,2021-01-26 03:00:00,3
4,4,8,91,-0.1,3,Cloudy,11.9,2021-01-26 04:00:00,4
1,9,10,94,-0.1,53,Heavy Drizzle,9.7,2021-01-26 05:00:00,5
6,39,45,95,-0.2,61,Light Rain,9.0,2021-01-26 06:00:00,6
6,55,61,95,-0.0,55,Heavy Drizzle,7.3,2021-01-26 07:00:00,7
13,84,97,96,0.1,71,Light Snow,5.8,2021-01-26 08:00:00,8
19,69,88,95,0.4,51,Light Drizzle,8.6,2021-01-26 09:00:00,9
19,43,62,96,0.9,51,Light Drizzle,6.9,2021-01-26 10:00:00,10
30,59,89,95,1.6,51,Light Drizzle,7.5,2021-01-26 11:00:00,11
37,84,121,95,2.1,51,Light Drizzle,5.2,2021-01-26 12:00:00,12
30,95,125,95,3.0,51,Light Drizzle,6.7,2021-01-26 13:00:00,13
22,97,119,95,3.9,51,Light Drizzle,2.9,2021-01-26 14:00:00,14
50,101,151,93,2.6,3,Cloudy,5.5,2021-01-26 15:00:00,15
45,166,211,94,2.7,3,Cloudy,4.1,2021-01-26 16:00:00,16
52,191,243,95,2.9,3,Cloudy,2.0,2021-01-26 17:00:00,17
46,159,205,95,2.9,3,Cloudy,3.2,2021-01-26 18:00:00,18
32,98,130,96,2.8,3,Cloudy,3.9,2021-01-26 19:00:00,19
28,54,82,97,2.6,3,Cloudy,3.3,2021-01-26 20:00:00,20
14,36,50,98,2.5,3,Cloudy,4.4,2021-01-26 21:00:00,21
20,35,55,98,2.6,3,Cloudy,3.5,2021-01-26 22:00:00,22
12,21,33,96,2.3,1,Mostly Clear,2.0,2021-01-26 23:00:00,23
7,12,19,95,2.3,1,Mostly Clear,4.6,2021-01-27 00:00:00,0
4,5,9,94,2.1,2,Partly Cloudy,7.3,2021-01-27 01:00:00,1
2,1,3,93,2.2,3,Cloudy,8.4,2021-01-27 02:00:00,2
1,1,2,99,1.0,3,Cloudy,9.4,2021-01-27 03:00:00,3
4,7,11,98,1.8,3,Cloudy,9.1,2021-01-27 04:00:00,4
8,17,25,96,2.7,3,Cloudy,9.8,2021-01-27 05:00:00,5
17,80,97,94,3.1,3,Cloudy,12.7,2021-01-27 06:00:00,6
24,135,159,92,3.4,3,Cloudy,13.3,2021-01-27 07:00:00,7
52,158,210,90,2.5,2,Partly Cloudy,10.6,2021-01-27 08:00:00,8
56,147,203,89,1.3,1,Mostly Clear,13.0,2021-01-27 09:00:00,9
36,114,150,81,1.8,1,Mostly Clear,13.0,2021-01-27 10:00:00,10
55,135,190,68,2.6,3,Cloudy,16.5,2021-01-27 11:00:00,11
50,170,220,64,3.0,3,Cloudy,15.6,2021-01-27 12:00:00,12
67,164,231,59,3.7,3,Cloudy,15.9,2021-01-27 13:00:00,13
82,154,236,55,4.4,3,Cloudy,16.9,2021-01-27 14:00:00,14
86,158,244,53,6.0,1,Mostly Clear,17.2,2021-01-27 15:00:00,15
91,222,313,51,6.2,0,Clear,13.8,2021-01-27 16:00:00,16
105,265,370,51,5.8,0,Clear,11.6,2021-01-27 17:00:00,17
95,226,321,54,4.8,1,Mostly Clear,7.2,2021-01-27 18:00:00,18
50,160,210,59,3.2,1,Mostly Clear,6.8,2021-01-27 19:00:00,19
27,91,118,64,1.9,2,Partly Cloudy,7.3,2021-01-27 20:00:00,20
21,62,83,67,1.1,3,Cloudy,8.0,2021-01-27 21:00:00,21
18,45,63,67,0.7,3,Cloudy,9.3,2021-01-27 22:00:00,22
10,31,41,69,0.2,3,Cloudy,9.7,2021-01-27 23:00:00,23
1,9,10,71,-0.3,3,Cloudy,11.4,2021-01-28 00:00:00,0
5,6,11,70,-0.3,3,Cloudy,10.0,2021-01-28 01:00:00,1
2,3,5,66,-0.1,3,Cloudy,10.6,2021-01-28 02:00:00,2
1,0,1,65,0.6,3,Cloudy,11.9,2021-01-28 03:00:00,3
3,5,8,66,0.3,71,Light Snow,13.1,2021-01-28 04:00:00,4
3,20,23,67,0.1,71,Light Snow,13.1,2021-01-28 05:00:00,5
11,62,73,65,-0.1,71,Light Snow,15.6,2021-01-28 06:00:00,6
22,122,144,58,-0.3,3,Cloudy,18.0,2021-01-28 07:00:00,7
31,140,171,49,-0.5,3,Cloudy,20.1,2021-01-28 08:00:00,8
28,114,142,47,-0.8,3,Cloudy,22.1,2021-01-28 09:00:00,9
25,80,105,46,-0.9,3,Cloudy,23.5,2021-01-28 10:00:00,10
44,106,150,44,-0.6,2,Partly Cloudy,25.6,2021-01-28 11:00:00,11
62,112,174,40,0.3,0,Clear,27.3,2021-01-28 12:00:00,12
50,100,150,39,1.0,0,Clear,27.0,2021-01-28 13:00:00,13
49,114,163,38,1.5,0,Clear,25.7,2021-01-28 14:00:00,14
60,139,199,37,1.8,0,Clear,27.6,2021-01-28 15:00:00,15
62,193,255,35,2.0,0,Clear,26.6,2021-01-28 16:00:00,16
70,196,266,34,1.7,0,Clear,26.0,2021-01-28 17:00:00,17
61,169,230,35,0.8,0,Clear,21.1,2021-01-28 18:00:00,18
28,114,142,36,-0.3,0,Clear,21.7,2021-01-28 19:00:00,19
17,75,92,38,-1.1,0,Clear,21.4,2021-01-28 20:00:00,20
15,41,56,39,-1.6,0,Clear,20.6,2021-01-28 21:00:00,21
23,42,65,40,-2.1,0,Clear,20.4,2021-01-28 22:00:00,22
10,22,32,41,-2.4,0,Clear,20.9,2021-01-28 23:00:00,23
4,7,11,41,-2.7,1,Mostly Clear,20.2,2021-01-29 00:00:00,0
2,8,10,40,-2.9,3,Cloudy,21.3,2021-01-29 01:00:00,1
3,1,4,40,-3.1,3,Cloudy,22.7,2021-01-29 02:00:00,2
1,0,1,39,-3.4,2,Partly Cloudy,22.9,2021-01-29 03:00:00,3
3,4,7,39,-3.6,0,Clear,22.1,2021-01-29 04:00:00,4
5,10,15,38,-3.7,0,Clear,21.5,2021-01-29 05:00:00,5
10,49,59,39,-3.7,1,Mostly Clear,23.7,2021-01-29 06:00:00,6
25,104,129,40,-3.8,2,Partly Cloudy,27.2,2021-01-29 07:00:00,7
35,120,155,41,-3.9,1,Mostly Clear,25.7,2021-01-29 08:00:00,8
32,116,148,41,-3.6,2,Partly Cloudy,27.1,2021-01-29 09:00:00,9
35,101,136,37,-2.6,3,Cloudy,25.0,2021-01-29 10:00:00,10
42,116,158,36,-1.7,3,Cloudy,24.2,2021-01-29 11:00:00,11
37,136,173,36,-0.7,3,Cloudy,24.3,2021-01-29 12:00:00,12
72,124,196,34,0.0,3,Cloudy,24.0,2021-01-29 13:00:00,13
58,124,182,36,0.6,3,Cloudy,23.4,2021-01-29 14:00:00,14
72,137,209,35,0.6,3,Cloudy,22.7,2021-01-29 15:00:00,15
62,173,235,34,0.9,2,Partly Cloudy,21.7,2021-01-29 16:00:00,16
82,229,311,34,0.7,2,Partly Cloudy,20.5,2021-01-29 17:00:00,17
82,169,251,36,0.0,3,Cloudy,15.5,2021-01-29 18:00:00,18
63,148,211,38,-0.9,1,Mostly Clear,14.1,2021-01-29 19:00:00,19
36,68,104,40,-1.4,0,Clear,15.5,2021-01-29 20:00:00,20
33,27,60,41,-1.7,0,Clear,15.8,2021-01-29 21:00:00,21
16,51,67,41,-1.9,0,Clear,15.8,2021-01-29 22:00:00,22
14,24,38,42,-2.2,0,Clear,15.4,2021-01-29 23:00:00,23
13,20,33,43,-2.4,0,Clear,14.2,2021-01-30 00:00:00,0
8,9,17,45,-2.7,0,Clear,13.7,2021-01-30 01:00:00,1
5,10,15,45,-2.8,0,Clear,13.7,2021-01-30 02:00:00,2
5,5,10,47,-3.2,0,Clear,13.0,2021-01-30 03:00:00,3
5,8,13,48,-3.4,0,Clear,12.8,2021-01-30 04:00:00,4
2,7,9,49,-3.5,0,Clear,12.6,2021-01-30 05:00:00,5
11,13,24,50,-3.7,0,Clear,12.6,2021-01-30 06:00:00,6
18,35,53,51,-3.8,0,Clear,11.3,2021-01-30 07:00:00,7
25,77,102,52,-3.9,0,Clear,10.6,2021-01-30 08:00:00,8
30,96,126,52,-3.6,0,Clear,11.6,2021-01-30 09:00:00,9
38,159,197,46,-2.2,0,Clear,12.8,2021-01-30 10:00:00,10
91,195,286,43,-1.0,0,Clear,11.1,2021-01-30 11:00:00,11
136,222,358,41,0.1,0,Clear,9.9,2021-01-30 12:00:00,12
166,231,397,39,1.2,1,Mostly Clear,9.2,2021-01-30 13:00:00,13
206,242,448,42,2.1,0,Clear,8.4,2021-01-30 14:00:00,14
178,258,436,41,2.6,0,Clear,6.1,2021-01-30 15:00:00,15
168,240,408,40,2.8,0,Clear,5.5,2021-01-30 16:00:00,16
113,218,331,40,2.6,0,Clear,4.2,2021-01-30 17:00:00,17
74,176,250,45,1.9,0,Clear,5.0,2021-01-30 18:00:00,18
45,103,148,60,-0.0,0,Clear,6.2,2021-01-30 19:00:00,19
38,86,124,65,-1.8,0,Clear,6.5,2021-01-30 20:00:00,20
33,49,82,68,-2.8,1,Mostly Clear,6.4,2021-01-30 21:00:00,21
30,51,81,67,-2.9,2,Partly Cloudy,5.1,2021-01-30 22:00:00,22
25,25,50,63,-2.1,3,Cloudy,5.6,2021-01-30 23:00:00,23
22,31,53,65,-2.2,3,Cloudy,6.8,2021-01-31 00:00:00,0
7,6,13,64,-1.7,2,Partly Cloudy,6.3,2021-01-31 01:00:00,1
6,4,10,62,-1.3,3,Cloudy,6.3,2021-01-31 02:00:00,2
2,3,5,61,-1.0,3,Cloudy,6.9,2021-01-31 03:00:00,3
1,3,4,62,-0.8,71,Light Snow,6.6,2021-01-31 04:00:00,4
2,8,10,67,-0.7,73,Snow,8.0,2021-01-31 05:00:00,5
8,13,21,74,-1.0,73,Snow,8.4,2021-01-31 06:00:00,6
8,22,30,79,-1.1,73,Snow,8.2,2021-01-31 07:00:00,7
9,30,39,81,-1.2,71,Light Snow,9.2,2021-01-31 08:00:00,8
6,31,37,83,-1.0,71,Light Snow,9.2,2021-01-31 09:00:00,9
18,37,55,78,-0.1,73,Snow,14.3,2021-01-31 10:00:00,10
21,63,84,79,0.1,73,Snow,12.5,2021-01-31 11:00:00,11
17,61,78,85,-0.1,73,Snow,13.3,2021-01-31 12:00:00,12
30,82,112,88,-0.2,75,Heavy Snow,15.0,2021-01-31 13:00:00,13
26,63,89,86,0.0,73,Snow,15.9,2021-01-31 14:00:00,14
32,50,82,88,-0.1,73,Snow,15.8,2021-01-31 15:00:00,15
38,73,111,90,-0.2,73,Snow,15.2,2021-01-31 16:00:00,16
22,43,65,92,-0.2,73,Snow,15.5,2021-01-31 17:00:00,17
13,16,29,94,-0.2,73,Snow,13.7,2021-01-31 18:00:00,18
9,17,26,95,-0.1,73,Snow,14.6,2021-01-31 19:00:00,19
11,16,27,94,0.1,73,Snow,13.5,2021-01-31 20:00:00,20
9,15,24,94,0.1,73,Snow,15.0,2021-01-31 21:00:00,21
9,12,21,94,0.2,73,Snow,16.9,2021-01-31 22:00:00,22
3,7,10,94,0.4,73,Snow,17.9,2021-01-31 23:00:00,23
8,4,12,94,0.6,71,Light Snow,17.6,2021-02-01 00:00:00,0
0,3,3,95,0.8,3,Cloudy,17.7,2021-02-01 01:00:00,1
2,1,3,94,0.9,3,Cloudy,18.3,2021-02-01 02:00:00,2
3,2,5,91,-0.9,3,Cloudy,18.4,2021-02-01 03:00:00,3
3,5,8,90,-1.0,3,Cloudy,18.0,2021-02-01 04:00:00,4
1,2,3,90,-0.9,3,Cloudy,17.3,2021-02-01 05:00:00,5
5,25,30,90,-0.7,3,Cloudy,13.5,2021-02-01 06:00:00,6
6,47,53,90,-0.4,3,Cloudy,15.4,2021-02-01 07:00:00,7
13,37,50,90,-0.2,3,Cloudy,16.8,2021-02-01 08:00:00,8
9,32,41,89,0.1,3,Cloudy,16.7,2021-02-01 09:00:00,9
11,24,35,88,0.3,3,Cloudy,15.7,2021-02-01 10:00:00,10
6,27,33,88,0.5,3,Cloudy,16.2,2021-02-01 11:00:00,11
11,45,56,86,0.7,3,Cloudy,17.7,2021-02-01 12:00:00,12
16,48,64,86,0.6,3,Cloudy,17.9,2021-02-01 13:00:00,13
21,50,71,86,0.3,71,Light Snow,18.9,2021-02-01 14:00:00,14
30,68,98,88,-0.7,73,Snow,18.2,2021-02-01 15:00:00,15
17,64,81,88,-0.6,73,Snow,17.6,2021-02-01 16:00:00,16
15,75,90,89,-0.5,73,Snow,15.1,2021-02-01 17:00:00,17
13,52,65,89,-0.4,73,Snow,14.7,2021-02-01 18:00:00,18
9,44,53,90,-0.3,73,Snow,15.5,2021-02-01 19:00:00,19
6,44,50,89,-0.2,71,Light Snow,16.1,2021-02-01 20:00:00,20
8,20,28,89,-0.1,71,Light Snow,16.5,2021-02-01 21:00:00,21
11,19,30,88,0.0,71,Light Snow,16.6,2021-02-01 22:00:00,22
3,8,11,88,0.2,3,Cloudy,16.3,2021-02-01 23:00:00,23
2,3,5,87,0.2,3,Cloudy,16.9,2021-02-02 00:00:00,0
2,0,2,85,0.1,3,Cloudy,18.0,2021-02-02 01:00:00,1
1,0,1,84,-0.1,3,Cloudy,18.8,2021-02-02 02:00:00,2
1,4,5,85,0.1,71,Light Snow,20.1,2021-02-02 04:00:00,4
0,7,7,84,-0.1,71,Light Snow,20.3,2021-02-02 05:00:00,5
7,22,29,84,-0.3,71,Light Snow,18.0,2021-02-02 06:00:00,6
3,34,37,83,-0.4,71,Light Snow,18.4,2021-02-02 07:00:00,7
15,43,58,82,-0.6,71,Light Snow,18.4,2021-02-02 08:00:00,8
16,38,54,81,-0.6,71,Light Snow,19.2,2021-02-02 09:00:00,9
22,35,57,78,-0.2,71,Light Snow,15.7,2021-02-02 10:00:00,10
14,51,65,73,0.5,3,Cloudy,18.5,2021-02-02 11:00:00,11
18,68,86,72,1.0,3,Cloudy,22.9,2021-02-02 12:00:00,12
25,45,70,70,1.7,3,Cloudy,22.0,2021-02-02 13:00:00,13
31,62,93,68,2.3,3,Cloudy,21.9,2021-02-02 14:00:00,14
21,89,110,70,2.1,71,Light Snow,23.7,2021-02-02 15:00:00,15
29,112,141,69,2.1,71,Light Snow,23.4,2021-02-02 16:00:00,16
38,119,157,70,1.8,3,Cloudy,21.1,2021-02-02 17:00:00,17
43,120,163,70,1.5,3,Cloudy,20.1,2021-02-02 18:00:00,18
31,82,113,69,0.9,3,Cloudy,20.9,2021-02-02 19:00:00,19
15,68,83,69,0.5,3,Cloudy,21.1,2021-02-02 20:00:00,20
12,33,45,69,0.1,3,Cloudy,22.4,2021-02-02 21:00:00,21
27,10,37,69,-0.5,3,Cloudy,21.9,2021-02-02 22:00:00,22
9,24,33,70,-1.0,3,Cloudy,21.9,2021-02-02 23:00:00,23
3,11,14,70,-1.3,3,Cloudy,21.6,2021-02-03 00:00:00,0
2,2,4,71,-1.4,3,Cloudy,21.1,2021-02-03 01:00:00,1
0,3,3,72,-0.7,3,Cloudy,20.1,2021-02-03 03:00:00,3
5,4,9,72,-0.3,3,Cloudy,20.1,2021-02-03 04:00:00,4
2,10,12,73,-0.0,3,Cloudy,20.4,2021-02-03 05:00:00,5
5,47,52,73,0.0,3,Cloudy,19.5,2021-02-03 06:00:00,6
20,93,113,72,-0.1,1,Mostly Clear,19.7,2021-02-03 07:00:00,7
26,113,139,71,-0.5,1,Mostly Clear,19.2,2021-02-03 08:00:00,8
27,100,127,69,-0.6,1,Mostly Clear,19.3,2021-02-03 09:00:00,9
39,74,113,67,-0.4,1,Mostly Clear,19.2,2021-02-03 10:00:00,10
34,88,122,61,0.3,3,Cloudy,26.0,2021-02-03 11:00:00,11
36,109,145,60,0.9,3,Cloudy,25.7,2021-02-03 12:00:00,12
49,125,174,58,1.6,3,Cloudy,26.3,2021-02-03 13:00:00,13
57,99,156,56,2.4,3,Cloudy,25.0,2021-02-03 14:00:00,14
68,122,190,58,3.5,2,Partly Cloudy,24.8,2021-02-03 15:00:00,15
70,162,232,57,3.8,2,Partly Cloudy,23.2,2021-02-03 16:00:00,16
81,215,296,58,3.9,3,Cloudy,21.1,2021-02-03 17:00:00,17
55,159,214,60,3.5,2,Partly Cloudy,13.3,2021-02-03 18:00:00,18
38,112,150,62,2.8,1,Mostly Clear,13.8,2021-02-03 19:00:00,19
21,68,89,63,2.2,1,Mostly Clear,17.6,2021-02-03 20:00:00,20
16,34,50,65,1.3,0,Clear,22.1,2021-02-03 21:00:00,21
17,22,39,67,0.7,0,Clear,22.3,2021-02-03 22:00:00,22
13,20,33,69,0.1,0,Clear,21.3,2021-02-03 23:00:00,23
5,6,11,70,-0.4,0,Clear,20.8,2021-02-04 00:00:00,0
1,1,2,71,-0.9,0,Clear,20.4,2021-02-04 01:00:00,1
0,2,2,72,-1.4,0,Clear,19.9,2021-02-04 02:00:00,2
1,0,1,71,-1.7,0,Clear,19.6,2021-02-04 03:00:00,3
2,5,7,70,-2.1,0,Clear,18.5,2021-02-04 04:00:00,4
6,15,21,70,-2.5,0,Clear,18.1,2021-02-04 05:00:00,5
7,59,66,70,-2.8,0,Clear,17.1,2021-02-04 06:00:00,6
21,131,152,69,-3.2,0,Clear,16.1,2021-02-04 07:00:00,7
43,135,178,69,-3.5,0,Clear,14.7,2021-02-04 08:00:00,8
31,108,139,72,-3.9,0,Clear,14.2,2021-02-04 09:00:00,9
25,93,118,65,-2.5,0,Clear,14.3,2021-02-04 10:00:00,10
48,89,137,59,-0.4,0,Clear,15.8,2021-02-04 11:00:00,11
62,160,222,54,1.5,0,Clear,14.6,2021-02-04 12:00:00,12
56,148,204,51,3.2,0,Clear,12.2,2021-02-04 13:00:00,13
75,138,213,54,4.0,0,Clear,9.3,2021-02-04 14:00:00,14
70,179,249,52,5.2,0,Clear,9.1,2021-02-04 15:00:00,15
75,215,290,50,5.6,0,Clear,10.1,2021-02-04 16:00:00,16
96,255,351,51,5.3,1,Mostly Clear,6.9,2021-02-04 17:00:00,17
73,204,277,63,3.7,1,Mostly Clear,0.5,2021-02-04 18:00:00,18
55,147,202,63,2.7,1,Mostly Clear,7.9,2021-02-04 19:00:00,19
36,86,122,67,0.5,1,Mostly Clear,7.1,2021-02-04 20:00:00,20
20,60,80,66,-0.3,3,Cloudy,9.0,2021-02-04 21:00:00,21
35,38,73,65,-0.2,3,Cloudy,10.8,2021-02-04 22:00:00,22
20,37,57,64,0.5,3,Cloudy,12.5,2021-02-04 23:00:00,23
12,15,27,62,1.4,3,Cloudy,13.0,2021-02-05 00:00:00,0
7,3,10,59,2.6,3,Cloudy,12.0,2021-02-05 01:00:00,1
2,0,2,59,3.2,3,Cloudy,12.1,2021-02-05 02:00:00,2
2,2,4,62,3.4,51,Light Drizzle,14.6,2021-02-05 03:00:00,3
4,4,8,64,3.5,2,Partly Cloudy,15.1,2021-02-05 04:00:00,4
3,8,11,67,3.4,2,Partly Cloudy,16.9,2021-02-05 05:00:00,5
12,52,64,76,3.2,53,Heavy Drizzle,18.4,2021-02-05 06:00:00,6
20,101,121,85,3.0,55,Heavy Drizzle,18.6,2021-02-05 07:00:00,7
38,152,190,91,3.0,51,Light Drizzle,17.9,2021-02-05 08:00:00,8
62,114,176,93,3.4,2,Partly Cloudy,16.1,2021-02-05 09:00:00,9
43,93,136,93,4.1,1,Mostly Clear,13.5,2021-02-05 10:00:00,10
65,135,200,86,5.4,0,Clear,13.7,2021-02-05 11:00:00,11
94,172,266,76,7.3,0,Clear,14.5,2021-02-05 12:00:00,12
86,199,285,66,8.7,0,Clear,13.6,2021-02-05 13:00:00,13
113,192,305,60,9.3,0,Clear,14.5,2021-02-05 14:00:00,14
157,244,401,56,10.1,2,Partly Cloudy,17.8,2021-02-05 15:00:00,15
166,292,458,53,10.0,1,Mostly Clear,17.2,2021-02-05 16:00:00,16
178,327,505,58,8.9,0,Clear,13.4,2021-02-05 17:00:00,17
113,266,379,54,9.1,1,Mostly Clear,11.6,2021-02-05 18:00:00,18
66,183,249,55,7.4,0,Clear,14.3,2021-02-05 19:00:00,19
53,132,185,52,5.8,0,Clear,14.9,2021-02-05 20:00:00,20
41,59,100,51,4.5,0,Clear,15.3,2021-02-05 21:00:00,21
32,57,89,53,3.4,1,Mostly Clear,15.8,2021-02-05 22:00:00,22
31,47,78,60,1.9,0,Clear,13.9,2021-02-05 23:00:00,23
15,28,43,67,0.5,0,Clear,8.4,2021-02-06 00:00:00,0
12,18,30,67,-0.2,0,Clear,8.7,2021-02-06 01:00:00,1
14,9,23,73,-1.7,0,Clear,6.3,2021-02-06 02:00:00,2
5,2,7,68,-0.4,0,Clear,8.2,2021-02-06 03:00:00,3
3,4,7,74,-2.0,0,Clear,10.2,2021-02-06 04:00:00,4
2,3,5,74,-2.3,0,Clear,10.5,2021-02-06 05:00:00,5
11,24,35,74,-2.1,1,Mostly Clear,11.3,2021-02-06 06:00:00,6
20,43,63,73,-1.9,1,Mostly Clear,9.7,2021-02-06 07:00:00,7
36,95,131,74,-2.4,0,Clear,10.8,2021-02-06 08:00:00,8
68,142,210,73,-1.8,0,Clear,12.7,2021-02-06 09:00:00,9
93,217,310,66,1.2,0,Clear,13.3,2021-02-06 10:00:00,10
159,237,396,57,5.0,0,Clear,15.5,2021-02-06 11:00:00,11
205,317,522,48,7.3,1,Mostly Clear,17.8,2021-02-06 12:00:00,12
217,303,520,44,8.4,3,Cloudy,22.1,2021-02-06 13:00:00,13
300,308,608,43,8.7,2,Partly Cloudy,22.3,2021-02-06 14:00:00,14
263,328,591,39,9.2,2,Partly Cloudy,18.4,2021-02-06 15:00:00,15
219,317,536,38,9.5,2,Partly Cloudy,15.7,2021-02-06 16:00:00,16
159,294,453,38,9.6,3,Cloudy,11.9,2021-02-06 17:00:00,17
110,188,298,46,8.5,2,Partly Cloudy,6.2,2021-02-06 18:00:00,18
67,131,198,60,6.4,1,Mostly Clear,1.0,2021-02-06 19:00:00,19
58,81,139,63,4.3,2,Partly Cloudy,3.7,2021-02-06 20:00:00,20
46,62,108,66,3.3,3,Cloudy,6.0,2021-02-06 21:00:00,21
33,72,105,68,2.7,3,Cloudy,8.4,2021-02-06 22:00:00,22
34,40,74,69,2.5,3,Cloudy,7.4,2021-02-06 23:00:00,23
24,24,48,72,2.4,3,Cloudy,9.0,2021-02-07 00:00:00,0
14,19,33,76,2.4,3,Cloudy,9.4,2021-02-07 01:00:00,1
9,11,20,79,2.3,3,Cloudy,11.3,2021-02-07 02:00:00,2
4,2,6,69,3.4,3,Cloudy,10.5,2021-02-07 03:00:00,3
1,2,3,73,3.0,3,Cloudy,9.1,2021-02-07 04:00:00,4
3,5,8,77,2.9,51,Light Drizzle,8.7,2021-02-07 05:00:00,5
6,8,14,87,2.4,51,Light Drizzle,3.3,2021-02-07 06:00:00,6
1,7,8,92,1.8,71,Light Snow,5.9,2021-02-07 07:00:00,7
7,25,32,99,0.8,75,Heavy Snow,7.0,2021-02-07 08:00:00,8
10,42,52,99,0.9,73,Snow,7.8,2021-02-07 09:00:00,9
12,46,58,99,1.2,75,Heavy Snow,7.9,2021-02-07 10:00:00,10
18,51,69,100,1.7,73,Snow,6.5,2021-02-07 11:00:00,11
23,47,70,98,2.3,53,Heavy Drizzle,6.2,2021-02-07 12:00:00,12
32,118,150,96,3.3,51,Light Drizzle,7.8,2021-02-07 13:00:00,13
70,154,224,91,4.5,51,Light Drizzle,9.7,2021-02-07 14:00:00,14
85,183,268,94,3.6,51,Light Drizzle,12.0,2021-02-07 15:00:00,15
75,196,271,83,4.6,3,Cloudy,17.1,2021-02-07 16:00:00,16
114,222,336,78,5.1,1,Mostly Clear,16.8,2021-02-07 17:00:00,17
71,130,201,68,4.7,0,Clear,15.9,2021-02-07 18:00:00,18
32,60,92,62,2.6,0,Clear,17.4,2021-02-07 19:00:00,19
14,42,56,59,0.8,0,Clear,16.3,2021-02-07 20:00:00,20
38,33,71,60,-0.8,0,Clear,13.2,2021-02-07 21:00:00,21
54,70,124,61,-2.0,0,Clear,12.0,2021-02-07 22:00:00,22
40,35,75,62,-3.1,0,Clear,11.5,2021-02-07 23:00:00,23
7,10,17,64,-4.3,0,Clear,9.7,2021-02-08 00:00:00,0
5,5,10,64,-5.6,0,Clear,9.2,2021-02-08 01:00:00,1
3,3,6,64,-7.0,0,Clear,11.4,2021-02-08 02:00:00,2
4,0,4,59,-7.5,0,Clear,10.8,2021-02-08 03:00:00,3
8,4,12,59,-8.3,1,Mostly Clear,11.0,2021-02-08 04:00:00,4
2,10,12,58,-8.6,0,Clear,11.2,2021-02-08 05:00:00,5
5,41,46,56,-8.7,1,Mostly Clear,9.4,2021-02-08 06:00:00,6
25,103,128,55,-8.6,1,Mostly Clear,11.2,2021-02-08 07:00:00,7
36,160,196,56,-9.0,0,Clear,10.5,2021-02-08 08:00:00,8
42,134,176,56,-8.9,0,Clear,8.5,2021-02-08 09:00:00,9
24,78,102,46,-5.8,0,Clear,4.6,2021-02-08 10:00:00,10
56,86,142,61,-4.1,0,Clear,4.1,2021-02-08 11:00:00,11
58,108,166,41,-1.4,0,Clear,1.8,2021-02-08 12:00:00,12
79,121,200,41,-0.3,0,Clear,4.7,2021-02-08 13:00:00,13
61,118,179,43,0.6,0,Clear,6.1,2021-02-08 14:00:00,14
91,142,233,49,1.9,0,Clear,8.4,2021-02-08 15:00:00,15
68,207,275,50,2.1,0,Clear,10.8,2021-02-08 16:00:00,16
95,241,336,53,1.9,0,Clear,11.4,2021-02-08 17:00:00,17
52,208,260,61,0.9,0,Clear,8.1,2021-02-08 18:00:00,18
40,118,158,66,-1.0,1,Mostly Clear,9.9,2021-02-08 19:00:00,19
26,68,94,68,-2.2,1,Mostly Clear,11.2,2021-02-08 20:00:00,20
27,45,72,70,-3.0,1,Mostly Clear,11.2,2021-02-08 21:00:00,21
18,24,42,72,-3.6,0,Clear,10.5,2021-02-08 22:00:00,22
12,14,26,75,-3.8,1,Mostly Clear,10.3,2021-02-08 23:00:00,23
5,4,9,79,-3.9,0,Clear,10.4,2021-02-09 00:00:00,0
2,3,5,83,-3.3,1,Mostly Clear,6.4,2021-02-09 02:00:00,2
1,3,4,82,-2.3,2,Partly Cloudy,6.9,2021-02-09 03:00:00,3
2,5,7,82,-1.1,3,Cloudy,5.9,2021-02-09 04:00:00,4
7,21,28,82,-0.2,3,Cloudy,5.4,2021-02-09 05:00:00,5
9,63,72,85,-0.9,3,Cloudy,6.0,2021-02-09 06:00:00,6
26,132,158,89,-1.0,3,Cloudy,7.7,2021-02-09 07:00:00,7
45,168,213,88,0.3,3,Cloudy,7.9,2021-02-09 08:00:00,8
40,141,181,87,1.1,3,Cloudy,6.9,2021-02-09 09:00:00,9
27,88,115,87,1.9,3,Cloudy,5.5,2021-02-09 10:00:00,10
39,116,155,86,2.8,2,Partly Cloudy,5.6,2021-02-09 11:00:00,11
68,154,222,83,4.1,1,Mostly Clear,5.9,2021-02-09 12:00:00,12
74,158,232,76,6.8,1,Mostly Clear,6.0,2021-02-09 13:00:00,13
74,160,234,70,8.7,0,Clear,7.0,2021-02-09 14:00:00,14
95,184,279,64,9.6,1,Mostly Clear,8.1,2021-02-09 15:00:00,15
100,273,373,61,9.8,1,Mostly Clear,9.6,2021-02-09 16:00:00,16
105,349,454,60,9.1,2,Partly Cloudy,11.4,2021-02-09 17:00:00,17
84,244,328,64,7.4,2,Partly Cloudy,8.6,2021-02-09 18:00:00,18
39,134,173,67,5.7,3,Cloudy,8.4,2021-02-09 19:00:00,19
30,111,141,70,4.6,3,Cloudy,8.0,2021-02-09 20:00:00,20
22,72,94,72,4.1,3,Cloudy,8.6,2021-02-09 21:00:00,21
17,34,51,74,3.5,3,Cloudy,8.6,2021-02-09 22:00:00,22
9,25,34,75,3.3,3,Cloudy,8.0,2021-02-09 23:00:00,23
3,8,11,77,2.4,3,Cloudy,9.5,2021-02-10 00:00:00,0
1,7,8,80,1.3,1,Mostly Clear,10.8,2021-02-10 01:00:00,1
2,4,6,79,0.5,1,Mostly Clear,10.6,2021-02-10 02:00:00,2
1,2,3,78,0.8,0,Clear,10.8,2021-02-10 03:00:00,3
6,10,16,80,-0.1,1,Mostly Clear,10.6,2021-02-10 04:00:00,4
6,19,25,80,-0.8,1,Mostly Clear,10.8,2021-02-10 05:00:00,5
8,64,72,80,-1.4,2,Partly Cloudy,6.5,2021-02-10 06:00:00,6
22,136,158,77,-1.6,3,Cloudy,5.1,2021-02-10 07:00:00,7
28,137,165,76,-1.6,3,Cloudy,4.7,2021-02-10 08:00:00,8
17,17,34,75,-1.2,2,Partly Cloudy,5.8,2021-02-10 09:00:00,9
28,68,96,63,0.7,0,Clear,6.1,2021-02-10 10:00:00,10
63,134,197,59,1.7,1,Mostly Clear,7.5,2021-02-10 11:00:00,11
52,159,211,56,2.8,1,Mostly Clear,6.4,2021-02-10 12:00:00,12
54,160,214,54,4.0,1,Mostly Clear,3.3,2021-02-10 13:00:00,13
55,141,196,53,4.6,3,Cloudy,1.1,2021-02-10 14:00:00,14
59,185,244,56,5.4,3,Cloudy,2.3,2021-02-10 15:00:00,15
57,179,236,56,5.3,3,Cloudy,3.8,2021-02-10 16:00:00,16
26,128,154,61,4.5,2,Partly Cloudy,7.2,2021-02-10 17:00:00,17
20,94,114,68,3.6,51,Light Drizzle,7.2,2021-02-10 18:00:00,18
24,58,82,78,2.5,71,Light Snow,7.9,2021-02-10 19:00:00,19
12,38,50,86,1.8,71,Light Snow,7.4,2021-02-10 20:00:00,20
11,17,28,88,1.4,71,Light Snow,7.7,2021-02-10 21:00:00,21
9,20,29,90,1.2,73,Snow,8.2,2021-02-10 22:00:00,22
5,8,13,93,1.0,75,Heavy Snow,8.4,2021-02-10 23:00:00,23
5,3,8,96,0.8,75,Heavy Snow,8.9,2021-02-11 00:00:00,0
1,1,2,96,0.7,75,Heavy Snow,9.2,2021-02-11 01:00:00,1
3,2,5,98,0.6,75,Heavy Snow,9.5,2021-02-11 02:00:00,2
0,1,1,98,0.5,75,Heavy Snow,9.4,2021-02-11 03:00:00,3
3,4,7,98,0.5,73,Snow,8.4,2021-02-11 04:00:00,4
2,10,12,98,0.4,73,Snow,7.6,2021-02-11 05:00:00,5
8,30,38,98,0.3,73,Snow,7.7,2021-02-11 06:00:00,6
14,67,81,98,0.3,71,Light Snow,7.6,2021-02-11 07:00:00,7
26,87,113,98,0.2,73,Snow,8.5,2021-02-11 08:00:00,8
22,64,86,97,0.3,73,Snow,9.4,2021-02-11 09:00:00,9
15,66,81,94,0.6,71,Light Snow,9.9,2021-02-11 10:00:00,10
20,73,93,92,0.7,73,Snow,9.3,2021-02-11 11:00:00,11
32,93,125,90,0.9,73,Snow,9.6,2021-02-11 12:00:00,12
46,88,134,87,1.2,71,Light Snow,10.0,2021-02-11 13:00:00,13
30,92,122,83,1.7,3,Cloudy,10.5,2021-02-11 14:00:00,14
41,151,192,79,1.8,3,Cloudy,11.7,2021-02-11 15:00:00,15
60,134,194,77,1.9,71,Light Snow,12.0,2021-02-11 16:00:00,16
64,218,282,76,1.7,3,Cloudy,10.8,2021-02-11 17:00:00,17
52,168,220,78,1.4,3,Cloudy,10.1,2021-02-11 18:00:00,18
30,150,180,81,0.9,3,Cloudy,8.3,2021-02-11 19:00:00,19
31,71,102,82,0.3,3,Cloudy,6.9,2021-02-11 20:00:00,20
21,59,80,82,-0.0,3,Cloudy,6.6,2021-02-11 21:00:00,21
18,30,48,81,-0.1,3,Cloudy,7.5,2021-02-11 22:00:00,22
22,13,35,80,-0.2,71,Light Snow,6.0,2021-02-11 23:00:00,23
6,7,13,79,-0.4,71,Light Snow,5.4,2021-02-12 00:00:00,0
8,6,14,78,-0.7,71,Light Snow,6.6,2021-02-12 01:00:00,1
2,1,3,76,-0.9,71,Light Snow,8.2,2021-02-12 02:00:00,2
1,0,1,76,-1.3,71,Light Snow,9.4,2021-02-12 03:00:00,3
3,6,9,74,-1.5,71,Light Snow,10.0,2021-02-12 04:00:00,4
7,8,15,72,-1.8,2,Partly Cloudy,10.7,2021-02-12 05:00:00,5
12,52,64,71,-2.2,3,Cloudy,11.0,2021-02-12 06:00:00,6
16,120,136,68,-2.3,3,Cloudy,9.7,2021-02-12 07:00:00,7
36,139,175,67,-2.5,3,Cloudy,10.1,2021-02-12 08:00:00,8
36,124,160,67,-2.7,3,Cloudy,9.4,2021-02-12 09:00:00,9
35,102,137,66,-2.7,3,Cloudy,9.0,2021-02-12 10:00:00,10
52,174,226,66,-2.5,3,Cloudy,8.7,2021-02-12 11:00:00,11
51,155,206,66,-2.4,3,Cloudy,7.3,2021-02-12 12:00:00,12
51,122,173,67,-2.2,3,Cloudy,6.8,2021-02-12 13:00:00,13
64,110,174,68,-2.1,3,Cloudy,6.8,2021-02-12 14:00:00,14
73,132,205,70,-1.6,3,Cloudy,6.3,2021-02-12 15:00:00,15
74,176,250,70,-1.5,3,Cloudy,5.7,2021-02-12 16:00:00,16
78,229,307,70,-1.4,3,Cloudy,6.5,2021-02-12 17:00:00,17
56,189,245,71,-1.5,3,Cloudy,5.0,2021-02-12 18:00:00,18
61,146,207,72,-1.7,3,Cloudy,6.2,2021-02-12 19:00:00,19
44,81,125,72,-1.8,3,Cloudy,6.3,2021-02-12 20:00:00,20
22,55,77,73,-2.0,3,Cloudy,7.4,2021-02-12 21:00:00,21
29,34,63,73,-2.1,3,Cloudy,6.6,2021-02-12 22:00:00,22
11,33,44,73,-2.0,3,Cloudy,7.4,2021-02-12 23:00:00,23
17,16,33,73,-2.0,3,Cloudy,7.7,2021-02-13 00:00:00,0
11,9,20,73,-2.0,3,Cloudy,8.1,2021-02-13 01:00:00,1
6,10,16,73,-2.1,3,Cloudy,8.7,2021-02-13 02:00:00,2
2,2,4,69,-1.7,3,Cloudy,8.4,2021-02-13 03:00:00,3
5,2,7,68,-1.6,3,Cloudy,8.4,2021-02-13 04:00:00,4
7,3,10,67,-1.5,3,Cloudy,8.9,2021-02-13 05:00:00,5
12,15,27,66,-1.4,3,Cloudy,9.2,2021-02-13 06:00:00,6
18,47,65,65,-1.4,3,Cloudy,9.7,2021-02-13 07:00:00,7
13,69,82,64,-1.4,3,Cloudy,9.5,2021-02-13 08:00:00,8
13,58,71,65,-1.5,51,Light Drizzle,10.9,2021-02-13 09:00:00,9
5,46,51,67,-1.6,51,Light Drizzle,10.9,2021-02-13 10:00:00,10
10,46,56,74,-1.8,51,Light Drizzle,10.0,2021-02-13 11:00:00,11
11,31,42,80,-1.9,53,Heavy Drizzle,10.2,2021-02-13 12:00:00,12
6,34,40,82,-1.9,53,Heavy Drizzle,9.7,2021-02-13 13:00:00,13
12,27,39,84,-2.0,53,Heavy Drizzle,12.5,2021-02-13 14:00:00,14
8,32,40,87,-2.4,73,Snow,12.3,2021-02-13 15:00:00,15
13,30,43,88,-2.3,71,Light Snow,12.0,2021-02-13 16:00:00,16
6,28,34,88,-2.1,53,Heavy Drizzle,12.3,2021-02-13 17:00:00,17
3,35,38,89,-2.1,53,Heavy Drizzle,9.6,2021-02-13 18:00:00,18
11,24,35,89,-2.2,51,Light Drizzle,9.8,2021-02-13 19:00:00,19
12,20,32,90,-2.2,51,Light Drizzle,8.8,2021-02-13 20:00:00,20
7,14,21,91,-2.3,3,Cloudy,10.8,2021-02-13 21:00:00,21
8,29,37,91,-2.3,3,Cloudy,11.3,2021-02-13 22:00:00,22
20,22,42,90,-2.3,3,Cloudy,9.4,2021-02-13 23:00:00,23
7,13,20,90,-2.2,3,Cloudy,8.4,2021-02-14 00:00:00,0
5,3,8,89,-2.2,3,Cloudy,8.4,2021-02-14 01:00:00,1
2,4,6,89,-2.1,3,Cloudy,8.3,2021-02-14 02:00:00,2
0,2,2,88,-2.1,3,Cloudy,7.3,2021-02-14 03:00:00,3
2,0,2,87,-1.9,3,Cloudy,6.1,2021-02-14 04:00:00,4
2,0,2,87,-1.7,3,Cloudy,6.6,2021-02-14 05:00:00,5
6,11,17,87,-1.5,3,Cloudy,6.8,2021-02-14 06:00:00,6
5,17,22,87,-1.4,3,Cloudy,6.5,2021-02-14 07:00:00,7
10,27,37,87,-1.2,3,Cloudy,6.5,2021-02-14 08:00:00,8
15,49,64,87,-1.0,3,Cloudy,6.5,2021-02-14 09:00:00,9
37,65,102,86,-0.6,3,Cloudy,7.3,2021-02-14 10:00:00,10
43,103,146,85,-0.1,3,Cloudy,7.1,2021-02-14 11:00:00,11
65,119,184,83,0.8,3,Cloudy,8.4,2021-02-14 12:00:00,12
106,129,235,80,1.6,3,Cloudy,8.5,2021-02-14 13:00:00,13
92,146,238,78,2.1,3,Cloudy,8.7,2021-02-14 14:00:00,14
111,182,293,78,2.1,3,Cloudy,8.6,2021-02-14 15:00:00,15
96,160,256,77,2.2,3,Cloudy,8.6,2021-02-14 16:00:00,16
79,149,228,77,2.2,3,Cloudy,8.5,2021-02-14 17:00:00,17
43,113,156,79,1.8,3,Cloudy,6.0,2021-02-14 18:00:00,18
26,62,88,80,1.4,3,Cloudy,5.9,2021-02-14 19:00:00,19
21,70,91,80,1.2,3,Cloudy,6.5,2021-02-14 20:00:00,20
18,48,66,81,1.1,3,Cloudy,8.6,2021-02-14 21:00:00,21
25,33,58,82,1.0,3,Cloudy,6.9,2021-02-14 22:00:00,22
13,30,43,83,0.9,3,Cloudy,8.0,2021-02-14 23:00:00,23
9,23,32,82,0.9,3,Cloudy,8.6,2021-02-15 00:00:00,0
6,5,11,83,0.8,3,Cloudy,8.0,2021-02-15 01:00:00,1
2,5,7,84,0.8,3,Cloudy,7.8,2021-02-15 02:00:00,2
0,4,4,84,0.9,3,Cloudy,7.7,2021-02-15 03:00:00,3
6,5,11,83,0.9,3,Cloudy,7.4,2021-02-15 04:00:00,4
6,11,17,83,0.9,3,Cloudy,8.5,2021-02-15 05:00:00,5
9,33,42,83,0.9,3,Cloudy,7.4,2021-02-15 06:00:00,6
7,61,68,83,1.0,3,Cloudy,8.0,2021-02-15 07:00:00,7
17,85,102,84,0.9,3,Cloudy,5.5,2021-02-15 08:00:00,8
26,122,148,85,1.0,3,Cloudy,5.5,2021-02-15 09:00:00,9
45,108,153,82,1.3,3,Cloudy,6.0,2021-02-15 10:00:00,10
58,159,217,81,1.7,3,Cloudy,6.1,2021-02-15 11:00:00,11
64,153,217,81,2.0,3,Cloudy,6.2,2021-02-15 12:00:00,12
101,156,257,82,2.1,3,Cloudy,6.7,2021-02-15 13:00:00,13
108,186,294,83,2.3,3,Cloudy,6.4,2021-02-15 14:00:00,14
98,221,319,83,2.3,3,Cloudy,5.8,2021-02-15 15:00:00,15
69,191,260,84,2.3,3,Cloudy,5.7,2021-02-15 16:00:00,16
56,121,177,85,2.1,3,Cloudy,6.5,2021-02-15 17:00:00,17
43,113,156,86,2.0,51,Light Drizzle,6.6,2021-02-15 18:00:00,18
26,86,112,88,1.8,3,Cloudy,7.9,2021-02-15 19:00:00,19
8,44,52,89,1.7,51,Light Drizzle,11.1,2021-02-15 20:00:00,20
6,28,34,92,1.5,51,Light Drizzle,11.6,2021-02-15 21:00:00,21
6,15,21,95,1.3,51,Light Drizzle,13.7,2021-02-15 22:00:00,22
1,8,9,97,1.4,53,Heavy Drizzle,12.6,2021-02-15 23:00:00,23
3,3,6,99,1.6,61,Light Rain,14.1,2021-02-16 00:00:00,0
0,3,3,100,1.8,61,Light Rain,2.4,2021-02-16 01:00:00,1
0,1,1,99,2.5,63,Rain,7.5,2021-02-16 02:00:00,2
1,1,2,100,2.0,61,Light Rain,5.2,2021-02-16 03:00:00,3
1,4,5,100,2.1,61,Light Rain,4.6,2021-02-16 04:00:00,4
6,12,18,100,2.3,53,Heavy Drizzle,8.2,2021-02-16 05:00:00,5
4,66,70,100,2.9,51,Light Drizzle,8.5,2021-02-16 06:00:00,6
16,110,126,100,3.4,51,Light Drizzle,10.5,2021-02-16 07:00:00,7
41,146,187,99,3.4,3,Cloudy,5.2,2021-02-16 08:00:00,8
35,121,156,98,3.7,3,Cloudy,5.7,2021-02-16 09:00:00,9
36,77,113,97,4.4,3,Cloudy,7.2,2021-02-16 10:00:00,10
43,89,132,93,6.2,3,Cloudy,6.3,2021-02-16 11:00:00,11
73,154,227,87,7.9,3,Cloudy,6.5,2021-02-16 12:00:00,12
60,124,184,83,7.9,3,Cloudy,8.4,2021-02-16 13:00:00,13
65,150,215,79,7.8,3,Cloudy,10.9,2021-02-16 14:00:00,14
72,149,221,77,7.8,3,Cloudy,14.5,2021-02-16 15:00:00,15
74,174,248,75,7.9,51,Light Drizzle,17.1,2021-02-16 16:00:00,16
77,269,346,60,6.5,2,Partly Cloudy,20.4,2021-02-16 17:00:00,17
52,231,283,52,4.5,1,Mostly Clear,18.1,2021-02-16 18:00:00,18
25,118,143,48,2.9,0,Clear,20.2,2021-02-16 19:00:00,19
20,78,98,48,1.4,0,Clear,23.5,2021-02-16 20:00:00,20
10,38,48,51,-0.0,0,Clear,23.3,2021-02-16 21:00:00,21
3,6,9,52,-1.0,0,Clear,22.1,2021-02-16 22:00:00,22
5,3,8,53,-1.6,0,Clear,21.0,2021-02-16 23:00:00,23
0,3,3,54,-2.0,0,Clear,20.5,2021-02-17 00:00:00,0
1,1,2,54,-2.4,0,Clear,19.7,2021-02-17 01:00:00,1
1,0,1,55,-2.7,0,Clear,19.4,2021-02-17 02:00:00,2
0,2,2,56,-3.6,0,Clear,18.6,2021-02-17 03:00:00,3
1,0,1,56,-3.9,0,Clear,17.6,2021-02-17 04:00:00,4
4,3,7,55,-4.2,0,Clear,16.5,2021-02-17 05:00:00,5
1,4,5,55,-4.4,0,Clear,15.8,2021-02-17 06:00:00,6
8,4,12,55,-4.7,1,Mostly Clear,16.1,2021-02-17 07:00:00,7
7,6,13,55,-5.0,1,Mostly Clear,15.5,2021-02-17 08:00:00,8
16,6,22,54,-4.7,1,Mostly Clear,14.8,2021-02-17 09:00:00,9
7,10,17,51,-3.8,1,Mostly Clear,12.9,2021-02-17 10:00:00,10
10,16,26,48,-2.2,1,Mostly Clear,10.9,2021-02-17 11:00:00,11
36,74,110,46,-1.1,1,Mostly Clear,9.7,2021-02-17 12:00:00,12
59,125,184,44,-0.1,1,Mostly Clear,8.3,2021-02-17 13:00:00,13
60,121,181,42,0.8,0,Clear,7.6,2021-02-17 14:00:00,14
53,149,202,43,1.7,0,Clear,5.4,2021-02-17 15:00:00,15
80,183,263,42,2.0,0,Clear,5.2,2021-02-17 16:00:00,16
59,187,246,42,1.9,0,Clear,5.8,2021-02-17 17:00:00,17
51,200,251,44,1.2,0,Clear,5.9,2021-02-17 18:00:00,18
41,116,157,51,0.0,0,Clear,3.9,2021-02-17 19:00:00,19
23,66,89,57,-1.2,0,Clear,5.7,2021-02-17 20:00:00,20
18,48,66,64,-2.4,1,Mostly Clear,7.0,2021-02-17 21:00:00,21
12,35,47,68,-2.9,1,Mostly Clear,6.5,2021-02-17 22:00:00,22
9,33,42,62,-2.2,1,Mostly Clear,6.8,2021-02-17 23:00:00,23
4,13,17,61,-1.9,0,Clear,4.2,2021-02-18 00:00:00,0
1,4,5,66,-2.9,1,Mostly Clear,5.6,2021-02-18 01:00:00,1
1,4,5,66,-2.7,2,Partly Cloudy,6.4,2021-02-18 02:00:00,2
4,0,4,58,-2.0,3,Cloudy,7.1,2021-02-18 03:00:00,3
3,5,8,53,-1.4,3,Cloudy,6.7,2021-02-18 04:00:00,4
4,7,11,59,-1.7,71,Light Snow,9.3,2021-02-18 05:00:00,5
3,26,29,63,-1.6,73,Snow,10.2,2021-02-18 06:00:00,6
6,26,32,69,-1.8,73,Snow,10.9,2021-02-18 07:00:00,7
8,30,38,78,-2.2,75,Heavy Snow,12.9,2021-02-18 08:00:00,8
9,26,35,85,-2.3,73,Snow,10.7,2021-02-18 09:00:00,9
2,15,17,89,-2.5,75,Heavy Snow,12.3,2021-02-18 10:00:00,10
7,10,17,90,-2.6,75,Heavy Snow,12.7,2021-02-18 11:00:00,11
14,16,30,90,-2.3,75,Heavy Snow,14.6,2021-02-18 12:00:00,12
15,33,48,89,-2.0,73,Snow,15.1,2021-02-18 13:00:00,13
14,21,35,89,-1.5,71,Light Snow,10.1,2021-02-18 14:00:00,14
15,43,58,89,-0.9,3,Cloudy,10.7,2021-02-18 15:00:00,15
20,43,63,90,-0.9,3,Cloudy,12.6,2021-02-18 16:00:00,16
21,48,69,89,-0.9,3,Cloudy,12.3,2021-02-18 17:00:00,17
19,46,65,91,-1.0,3,Cloudy,9.6,2021-02-18 18:00:00,18
13,36,49,91,-1.1,3,Cloudy,10.4,2021-02-18 19:00:00,19
9,30,39,92,-1.2,3,Cloudy,9.7,2021-02-18 20:00:00,20
7,20,27,92,-1.3,3,Cloudy,9.4,2021-02-18 21:00:00,21
8,16,24,93,-1.3,3,Cloudy,9.0,2021-02-18 22:00:00,22
10,9,19,93,-1.2,3,Cloudy,8.6,2021-02-18 23:00:00,23
4,8,12,93,-1.1,3,Cloudy,8.3,2021-02-19 00:00:00,0
3,7,10,93,-1.1,3,Cloudy,10.0,2021-02-19 01:00:00,1
0,3,3,93,-1.6,51,Light Drizzle,10.4,2021-02-19 04:00:00,4
2,7,9,94,-1.6,71,Light Snow,10.8,2021-02-19 05:00:00,5
8,19,27,94,-1.6,71,Light Snow,8.3,2021-02-19 06:00:00,6
11,40,51,92,-1.5,71,Light Snow,9.7,2021-02-19 07:00:00,7
12,68,80,93,-1.5,73,Snow,10.1,2021-02-19 08:00:00,8
20,51,71,94,-1.5,73,Snow,9.7,2021-02-19 09:00:00,9
7,47,54,93,-1.1,71,Light Snow,9.4,2021-02-19 10:00:00,10
12,65,77,92,-0.9,71,Light Snow,10.2,2021-02-19 11:00:00,11
31,93,124,91,-0.5,73,Snow,10.0,2021-02-19 12:00:00,12
16,96,112,88,0.4,71,Light Snow,10.2,2021-02-19 13:00:00,13
35,102,137,84,1.3,71,Light Snow,10.8,2021-02-19 14:00:00,14
51,100,151,82,1.7,2,Partly Cloudy,11.6,2021-02-19 15:00:00,15
67,147,214,77,2.4,2,Partly Cloudy,12.9,2021-02-19 16:00:00,16
71,193,264,72,3.3,1,Mostly Clear,12.2,2021-02-19 17:00:00,17
46,153,199,75,3.0,2,Partly Cloudy,9.9,2021-02-19 18:00:00,18
47,117,164,78,2.1,2,Partly Cloudy,8.7,2021-02-19 19:00:00,19
32,70,102,78,1.4,2,Partly Cloudy,11.7,2021-02-19 20:00:00,20
17,55,72,75,1.1,2,Partly Cloudy,15.3,2021-02-19 21:00:00,21
14,48,62,71,0.7,2,Partly Cloudy,15.5,2021-02-19 22:00:00,22
18,32,50,70,0.1,2,Partly Cloudy,15.5,2021-02-19 23:00:00,23
19,19,38,71,-0.6,1,Mostly Clear,15.5,2021-02-20 00:00:00,0
6,9,15,71,-1.3,1,Mostly Clear,16.1,2021-02-20 01:00:00,1
8,6,14,71,-1.9,0,Clear,16.8,2021-02-20 02:00:00,2
3,11,14,70,-2.1,0,Clear,16.8,2021-02-20 03:00:00,3
3,6,9,69,-2.6,0,Clear,16.3,2021-02-20 04:00:00,4
5,3,8,69,-3.1,0,Clear,15.5,2021-02-20 05:00:00,5
7,22,29,69,-3.6,3,Cloudy,15.0,2021-02-20 06:00:00,6
10,38,48,68,-4.0,0,Clear,14.6,2021-02-20 07:00:00,7
18,66,84,67,-4.5,0,Clear,14.4,2021-02-20 08:00:00,8
28,93,121,62,-4.3,0,Clear,15.1,2021-02-20 09:00:00,9
44,124,168,57,-3.6,0,Clear,22.2,2021-02-20 10:00:00,10
46,136,182,52,-2.8,1,Mostly Clear,21.6,2021-02-20 11:00:00,11
66,167,233,51,-2.1,2,Partly Cloudy,21.3,2021-02-20 12:00:00,12
82,162,244,49,-1.4,2,Partly Cloudy,21.6,2021-02-20 13:00:00,13
120,165,285,47,-0.9,3,Cloudy,22.4,2021-02-20 14:00:00,14
86,147,233,46,-0.9,3,Cloudy,23.4,2021-02-20 15:00:00,15
63,162,225,45,-0.8,3,Cloudy,23.2,2021-02-20 16:00:00,16
38,131,169,45,-1.1,3,Cloudy,23.2,2021-02-20 17:00:00,17
30,121,151,45,-1.5,3,Cloudy,21.0,2021-02-20 18:00:00,18
35,89,124,47,-2.2,0,Clear,16.8,2021-02-20 19:00:00,19
32,77,109,49,-2.8,0,Clear,16.9,2021-02-20 20:00:00,20
13,34,47,50,-3.3,0,Clear,16.6,2021-02-20 21:00:00,21
17,29,46,52,-3.7,0,Clear,16.8,2021-02-20 22:00:00,22
17,32,49,55,-4.1,0,Clear,16.8,2021-02-20 23:00:00,23
8,30,38,57,-4.4,0,Clear,15.9,2021-02-21 00:00:00,0
5,9,14,58,-4.6,0,Clear,15.6,2021-02-21 01:00:00,1
2,6,8,60,-4.9,0,Clear,12.8,2021-02-21 02:00:00,2
1,3,4,64,-5.8,0,Clear,12.5,2021-02-21 03:00:00,3
3,4,7,66,-6.6,0,Clear,12.1,2021-02-21 04:00:00,4
2,3,5,68,-7.7,0,Clear,10.7,2021-02-21 05:00:00,5
3,13,16,67,-8.2,0,Clear,10.5,2021-02-21 06:00:00,6
14,25,39,63,-7.8,0,Clear,8.8,2021-02-21 07:00:00,7
8,57,65,60,-6.7,0,Clear,7.5,2021-02-21 08:00:00,8
22,75,97,61,-7.1,0,Clear,8.4,2021-02-21 09:00:00,9
38,110,148,60,-5.3,0,Clear,8.7,2021-02-21 10:00:00,10
72,168,240,60,-1.7,0,Clear,7.0,2021-02-21 11:00:00,11
88,181,269,51,0.5,0,Clear,4.7,2021-02-21 12:00:00,12
103,206,309,51,1.5,0,Clear,2.7,2021-02-21 13:00:00,13
120,189,309,37,2.5,0,Clear,0.4,2021-02-21 14:00:00,14
139,228,367,63,2.6,0,Clear,2.1,2021-02-21 15:00:00,15
103,198,301,60,2.7,0,Clear,4.0,2021-02-21 16:00:00,16
69,181,250,56,2.6,1,Mostly Clear,5.8,2021-02-21 17:00:00,17
48,139,187,60,1.8,1,Mostly Clear,6.4,2021-02-21 18:00:00,18
16,85,101,62,0.3,1,Mostly Clear,8.5,2021-02-21 19:00:00,19
16,51,67,67,-1.1,1,Mostly Clear,9.7,2021-02-21 20:00:00,20
11,42,53,70,-2.5,1,Mostly Clear,10.6,2021-02-21 21:00:00,21
14,37,51,71,-3.4,1,Mostly Clear,11.4,2021-02-21 22:00:00,22
14,13,27,71,-3.8,2,Partly Cloudy,11.6,2021-02-21 23:00:00,23
2,2,4,71,-3.4,3,Cloudy,12.5,2021-02-22 00:00:00,0
2,2,4,71,-2.6,2,Partly Cloudy,13.3,2021-02-22 01:00:00,1
1,3,4,71,-2.4,1,Mostly Clear,13.5,2021-02-22 02:00:00,2
2,1,3,69,-2.2,1,Mostly Clear,13.3,2021-02-22 03:00:00,3
7,4,11,69,-2.2,0,Clear,14.4,2021-02-22 04:00:00,4
3,11,14,69,-1.9,1,Mostly Clear,15.9,2021-02-22 05:00:00,5
13,37,50,69,-1.4,3,Cloudy,15.8,2021-02-22 06:00:00,6
10,102,112,68,-0.8,3,Cloudy,16.2,2021-02-22 07:00:00,7
17,97,114,67,-0.3,3,Cloudy,15.1,2021-02-22 08:00:00,8
10,46,56,68,0.2,71,Light Snow,11.3,2021-02-22 09:00:00,9
6,19,25,73,0.5,73,Snow,12.4,2021-02-22 10:00:00,10
6,20,26,82,0.6,73,Snow,12.3,2021-02-22 11:00:00,11
9,24,33,90,0.9,73,Snow,11.9,2021-02-22 12:00:00,12
7,41,48,94,1.4,73,Snow,13.0,2021-02-22 13:00:00,13
19,53,72,96,2.0,73,Snow,14.6,2021-02-22 14:00:00,14
32,83,115,95,2.5,53,Heavy Drizzle,13.5,2021-02-22 15:00:00,15
33,117,150,96,3.6,51,Light Drizzle,13.0,2021-02-22 16:00:00,16
46,167,213,96,4.4,2,Partly Cloudy,14.9,2021-02-22 17:00:00,17
31,164,195,96,4.6,3,Cloudy,9.0,2021-02-22 18:00:00,18
27,93,120,98,3.6,3,Cloudy,9.2,2021-02-22 19:00:00,19
16,50,66,98,3.3,3,Cloudy,10.1,2021-02-22 20:00:00,20
13,40,53,98,2.5,3,Cloudy,9.7,2021-02-22 21:00:00,21
11,27,38,93,2.3,1,Mostly Clear,8.8,2021-02-22 22:00:00,22
11,11,22,90,1.6,1,Mostly Clear,7.9,2021-02-22 23:00:00,23
3,6,9,89,0.9,1,Mostly Clear,8.8,2021-02-23 00:00:00,0
1,1,2,89,0.2,1,Mostly Clear,10.1,2021-02-23 01:00:00,1
1,0,1,89,-0.2,1,Mostly Clear,11.0,2021-02-23 02:00:00,2
2,0,2,90,0.3,1,Mostly Clear,11.0,2021-02-23 03:00:00,3
2,5,7,90,-0.1,1,Mostly Clear,11.4,2021-02-23 04:00:00,4
4,19,23,91,-0.8,1,Mostly Clear,10.8,2021-02-23 05:00:00,5
3,52,55,91,-1.3,1,Mostly Clear,9.0,2021-02-23 06:00:00,6
12,98,110,92,-2.3,0,Clear,8.7,2021-02-23 07:00:00,7
32,146,178,93,-3.2,1,Mostly Clear,10.6,2021-02-23 08:00:00,8
37,121,158,94,-2.3,1,Mostly Clear,14.4,2021-02-23 09:00:00,9
38,104,142,92,0.1,1,Mostly Clear,16.0,2021-02-23 10:00:00,10
49,107,156,87,3.3,1,Mostly Clear,15.7,2021-02-23 11:00:00,11
71,149,220,72,6.8,51,Light Drizzle,19.7,2021-02-23 12:00:00,12
37,149,186,64,8.4,1,Mostly Clear,19.5,2021-02-23 13:00:00,13
70,143,213,54,10.1,1,Mostly Clear,23.0,2021-02-23 14:00:00,14
102,158,260,49,11.8,0,Clear,24.3,2021-02-23 15:00:00,15
106,206,312,49,11.8,0,Clear,23.8,2021-02-23 16:00:00,16
115,281,396,49,11.6,1,Mostly Clear,25.8,2021-02-23 17:00:00,17
107,225,332,49,11.3,0,Clear,18.8,2021-02-23 18:00:00,18
67,159,226,53,9.6,0,Clear,14.2,2021-02-23 19:00:00,19
43,101,144,57,8.2,0,Clear,11.2,2021-02-23 20:00:00,20
22,77,99,63,6.8,0,Clear,10.7,2021-02-23 21:00:00,21
22,37,59,69,5.3,0,Clear,10.9,2021-02-23 22:00:00,22
11,19,30,75,4.1,0,Clear,10.4,2021-02-23 23:00:00,23
6,5,11,80,3.0,0,Clear,10.5,2021-02-24 00:00:00,0
3,4,7,84,1.5,0,Clear,9.8,2021-02-24 01:00:00,1
2,5,7,86,0.1,0,Clear,8.9,2021-02-24 02:00:00,2
2,8,10,81,0.3,0,Clear,9.3,2021-02-24 03:00:00,3
5,6,11,81,0.2,1,Mostly Clear,9.7,2021-02-24 04:00:00,4
10,16,26,80,0.6,1,Mostly Clear,9.8,2021-02-24 05:00:00,5
6,68,74,77,2.3,1,Mostly Clear,6.9,2021-02-24 06:00:00,6
27,143,170,76,2.5,1,Mostly Clear,4.4,2021-02-24 07:00:00,7
55,193,248,84,-0.1,1,Mostly Clear,5.5,2021-02-24 08:00:00,8
48,143,191,82,2.1,0,Clear,9.0,2021-02-24 09:00:00,9
40,122,162,68,6.3,0,Clear,8.4,2021-02-24 10:00:00,10
76,184,260,60,9.2,0,Clear,10.1,2021-02-24 11:00:00,11
103,224,327,53,11.1,0,Clear,13.8,2021-02-24 12:00:00,12
132,215,347,48,13.0,0,Clear,17.6,2021-02-24 13:00:00,13
148,237,385,44,14.2,0,Clear,19.1,2021-02-24 14:00:00,14
177,238,415,37,15.7,0,Clear,19.1,2021-02-24 15:00:00,15
198,338,536,36,16.3,0,Clear,18.9,2021-02-24 16:00:00,16
236,417,653,37,16.3,0,Clear,17.7,2021-02-24 17:00:00,17
179,336,515,40,15.3,0,Clear,14.5,2021-02-24 18:00:00,18
106,210,316,42,13.6,0,Clear,14.1,2021-02-24 19:00:00,19
72,124,196,43,12.9,0,Clear,16.7,2021-02-24 20:00:00,20
36,105,141,44,12.7,0,Clear,18.7,2021-02-24 21:00:00,21
39,68,107,47,12.5,0,Clear,20.4,2021-02-24 22:00:00,22
27,40,67,50,12.3,0,Clear,16.3,2021-02-24 23:00:00,23
10,12,22,54,11.4,0,Clear,12.6,2021-02-25 00:00:00,0
2,6,8,58,10.3,1,Mostly Clear,12.3,2021-02-25 01:00:00,1
2,3,5,66,9.6,1,Mostly Clear,16.8,2021-02-25 02:00:00,2
3,3,6,71,10.5,1,Mostly Clear,20.2,2021-02-25 03:00:00,3
2,3,5,71,9.3,0,Clear,21.4,2021-02-25 04:00:00,4
3,19,22,67,7.7,0,Clear,19.9,2021-02-25 05:00:00,5
15,80,95,65,6.3,0,Clear,17.1,2021-02-25 06:00:00,6
28,134,162,65,5.0,0,Clear,16.5,2021-02-25 07:00:00,7
49,199,248,66,3.8,0,Clear,15.0,2021-02-25 08:00:00,8
53,140,193,64,3.6,0,Clear,14.1,2021-02-25 09:00:00,9
38,115,153,59,4.2,0,Clear,17.7,2021-02-25 10:00:00,10
52,131,183,54,5.3,0,Clear,15.2,2021-02-25 11:00:00,11
80,187,267,49,6.6,0,Clear,13.4,2021-02-25 12:00:00,12
108,165,273,44,7.9,0,Clear,12.0,2021-02-25 13:00:00,13
78,150,228,41,9.0,0,Clear,11.2,2021-02-25 14:00:00,14
108,202,310,34,11.2,0,Clear,11.2,2021-02-25 15:00:00,15
166,243,409,33,11.4,0,Clear,10.7,2021-02-25 16:00:00,16
168,372,540,32,11.1,0,Clear,10.9,2021-02-25 17:00:00,17
119,276,395,36,10.2,0,Clear,6.8,2021-02-25 18:00:00,18
77,192,269,41,8.5,0,Clear,6.1,2021-02-25 19:00:00,19
34,106,140,47,6.5,0,Clear,5.7,2021-02-25 20:00:00,20
31,78,109,52,4.9,0,Clear,6.6,2021-02-25 21:00:00,21
46,53,99,61,3.3,0,Clear,7.2,2021-02-25 22:00:00,22
18,22,40,67,2.1,0,Clear,6.4,2021-02-25 23:00:00,23
4,13,17,65,2.0,1,Mostly Clear,5.8,2021-02-26 00:00:00,0
10,8,18,67,1.6,2,Partly Cloudy,7.1,2021-02-26 01:00:00,1
3,4,7,70,1.6,3,Cloudy,7.9,2021-02-26 02:00:00,2
2,3,5,65,2.0,3,Cloudy,7.2,2021-02-26 03:00:00,3
5,5,10,67,1.8,3,Cloudy,7.7,2021-02-26 04:00:00,4
4,14,18,66,1.6,3,Cloudy,8.9,2021-02-26 05:00:00,5
21,66,87,63,1.6,3,Cloudy,7.9,2021-02-26 06:00:00,6
25,141,166,64,1.2,2,Partly Cloudy,7.9,2021-02-26 07:00:00,7
55,166,221,71,0.7,2,Partly Cloudy,8.0,2021-02-26 08:00:00,8
66,145,211,76,1.7,0,Clear,7.9,2021-02-26 09:00:00,9
56,103,159,51,5.2,0,Clear,8.2,2021-02-26 10:00:00,10
83,146,229,45,6.6,1,Mostly Clear,10.3,2021-02-26 11:00:00,11
86,167,253,42,7.7,1,Mostly Clear,10.1,2021-02-26 12:00:00,12
99,202,301,40,8.7,1,Mostly Clear,10.1,2021-02-26 13:00:00,13
98,202,300,39,9.3,1,Mostly Clear,11.3,2021-02-26 14:00:00,14
125,198,323,37,9.7,1,Mostly Clear,10.8,2021-02-26 15:00:00,15
146,225,371,37,9.6,1,Mostly Clear,11.7,2021-02-26 16:00:00,16
139,291,430,37,9.2,2,Partly Cloudy,12.8,2021-02-26 17:00:00,17
111,221,332,41,8.2,3,Cloudy,8.8,2021-02-26 18:00:00,18
33,86,119,49,7.1,3,Cloudy,9.0,2021-02-26 19:00:00,19
18,61,79,62,5.8,51,Light Drizzle,9.5,2021-02-26 20:00:00,20
15,21,36,82,4.1,53,Heavy Drizzle,9.8,2021-02-26 21:00:00,21
13,25,38,90,3.0,53,Heavy Drizzle,10.0,2021-02-26 22:00:00,22
13,30,43,96,2.2,71,Light Snow,9.4,2021-02-26 23:00:00,23
18,17,35,99,1.9,73,Snow,8.6,2021-02-27 00:00:00,0
8,10,18,96,2.3,71,Light Snow,8.7,2021-02-27 01:00:00,1
6,8,14,96,2.9,55,Heavy Drizzle,8.7,2021-02-27 02:00:00,2
3,3,6,97,2.4,73,Snow,9.7,2021-02-27 03:00:00,3
4,7,11,97,2.8,53,Heavy Drizzle,8.9,2021-02-27 04:00:00,4
4,3,7,97,3.1,51,Light Drizzle,7.4,2021-02-27 05:00:00,5
10,12,22,96,3.5,51,Light Drizzle,8.9,2021-02-27 06:00:00,6
5,26,31,97,3.9,51,Light Drizzle,6.7,2021-02-27 07:00:00,7
8,41,49,97,4.2,53,Heavy Drizzle,5.6,2021-02-27 08:00:00,8
19,85,104,98,4.8,53,Heavy Drizzle,5.0,2021-02-27 09:00:00,9
54,137,191,97,5.3,51,Light Drizzle,2.5,2021-02-27 10:00:00,10
114,167,281,97,5.7,61,Light Rain,7.3,2021-02-27 11:00:00,11
165,235,400,97,5.8,61,Light Rain,10.4,2021-02-27 12:00:00,12
183,252,435,93,7.2,3,Cloudy,12.0,2021-02-27 13:00:00,13
254,289,543,84,9.6,3,Cloudy,12.5,2021-02-27 14:00:00,14
302,361,663,79,10.3,3,Cloudy,12.0,2021-02-27 15:00:00,15
278,331,609,74,12.1,1,Mostly Clear,10.5,2021-02-27 16:00:00,16
263,341,604,71,13.4,1,Mostly Clear,8.6,2021-02-27 17:00:00,17
106,214,320,75,12.9,1,Mostly Clear,3.1,2021-02-27 18:00:00,18
92,135,227,81,11.6,1,Mostly Clear,5.4,2021-02-27 19:00:00,19
53,95,148,91,9.8,1,Mostly Clear,7.4,2021-02-27 20:00:00,20
59,61,120,94,8.1,1,Mostly Clear,9.5,2021-02-27 21:00:00,21
78,78,156,94,7.7,1,Mostly Clear,9.9,2021-02-27 22:00:00,22
44,41,85,94,7.4,1,Mostly Clear,8.6,2021-02-27 23:00:00,23
42,37,79,94,7.2,1,Mostly Clear,7.9,2021-02-28 00:00:00,0
13,15,28,95,6.9,3,Cloudy,7.5,2021-02-28 01:00:00,1
2,10,12,96,6.4,3,Cloudy,6.0,2021-02-28 02:00:00,2
2,10,12,95,6.0,3,Cloudy,5.7,2021-02-28 03:00:00,3
7,2,9,96,5.8,3,Cloudy,5.9,2021-02-28 04:00:00,4
3,7,10,95,5.9,3,Cloudy,7.2,2021-02-28 05:00:00,5
4,12,16,96,6.0,51,Light Drizzle,7.7,2021-02-28 06:00:00,6
9,15,24,96,6.0,51,Light Drizzle,6.8,2021-02-28 07:00:00,7
6,44,50,96,6.3,55,Heavy Drizzle,6.8,2021-02-28 08:00:00,8
29,47,76,96,6.5,61,Light Rain,9.9,2021-02-28 09:00:00,9
25,44,69,96,6.6,61,Light Rain,12.1,2021-02-28 10:00:00,10
14,32,46,96,6.9,61,Light Rain,10.2,2021-02-28 11:00:00,11
8,27,35,96,7.0,61,Light Rain,10.0,2021-02-28 12:00:00,12
18,28,46,97,7.0,63,Rain,11.2,2021-02-28 13:00:00,13
13,26,39,96,7.2,61,Light Rain,11.5,2021-02-28 14:00:00,14
20,64,84,97,7.0,61,Light Rain,12.6,2021-02-28 15:00:00,15
27,54,81,97,6.7,55,Heavy Drizzle,14.4,2021-02-28 16:00:00,16
19,69,88,97,6.7,53,Heavy Drizzle,15.5,2021-02-28 17:00:00,17
33,74,107,98,6.9,51,Light Drizzle,8.2,2021-02-28 18:00:00,18
18,66,84,99,7.0,51,Light Drizzle,6.2,2021-02-28 19:00:00,19
21,40,61,99,7.1,53,Heavy Drizzle,6.3,2021-02-28 20:00:00,20
13,25,38,100,7.2,53,Heavy Drizzle,5.8,2021-02-28 21:00:00,21
15,15,30,100,7.3,51,Light Drizzle,5.8,2021-02-28 22:00:00,22
10,5,15,99,7.9,3,Cloudy,3.6,2021-02-28 23:00:00,23
9,7,16,100,7.5,53,Heavy Drizzle,2.6,2021-03-01 00:00:00,0
2,2,4,100,7.7,53,Heavy Drizzle,2.8,2021-03-01 01:00:00,1
0,3,3,100,8.0,53,Heavy Drizzle,3.6,2021-03-01 02:00:00,2
1,0,1,100,6.8,61,Light Rain,4.6,2021-03-01 03:00:00,3
5,3,8,100,6.9,63,Rain,4.3,2021-03-01 04:00:00,4
7,10,17,100,7.1,53,Heavy Drizzle,4.0,2021-03-01 05:00:00,5
8,44,52,100,7.3,53,Heavy Drizzle,3.2,2021-03-01 06:00:00,6
6,60,66,99,7.5,61,Light Rain,5.8,2021-03-01 07:00:00,7
23,76,99,99,7.7,61,Light Rain,5.5,2021-03-01 08:00:00,8
25,68,93,98,8.3,53,Heavy Drizzle,7.6,2021-03-01 09:00:00,9
28,71,99,97,10.6,51,Light Drizzle,10.5,2021-03-01 10:00:00,10
26,54,80,96,11.6,51,Light Drizzle,12.5,2021-03-01 11:00:00,11
46,105,151,94,12.6,51,Light Drizzle,16.3,2021-03-01 12:00:00,12
52,102,154,87,10.8,3,Cloudy,27.8,2021-03-01 13:00:00,13
65,112,177,71,9.6,2,Partly Cloudy,18.2,2021-03-01 14:00:00,14
76,129,205,64,9.1,1,Mostly Clear,19.7,2021-03-01 15:00:00,15
76,166,242,53,10.3,1,Mostly Clear,24.0,2021-03-01 16:00:00,16
89,235,324,46,10.1,2,Partly Cloudy,25.8,2021-03-01 17:00:00,17
69,184,253,42,9.5,1,Mostly Clear,19.9,2021-03-01 18:00:00,18
52,143,195,39,8.2,1,Mostly Clear,18.0,2021-03-01 19:00:00,19
27,84,111,38,7.2,1,Mostly Clear,18.1,2021-03-01 20:00:00,20
30,40,70,40,6.5,0,Clear,21.0,2021-03-01 21:00:00,21
23,33,56,43,5.5,0,Clear,19.6,2021-03-01 22:00:00,22
8,19,27,44,4.5,0,Clear,19.6,2021-03-01 23:00:00,23
4,7,11,43,3.5,0,Clear,20.4,2021-03-02 00:00:00,0
1,3,4,41,2.5,0,Clear,20.6,2021-03-02 01:00:00,1
2,3,5,41,1.6,0,Clear,19.5,2021-03-02 02:00:00,2
1,1,2,43,1.7,0,Clear,17.9,2021-03-02 03:00:00,3
4,4,8,45,1.0,0,Clear,17.7,2021-03-02 04:00:00,4
8,12,20,45,0.4,0,Clear,17.6,2021-03-02 05:00:00,5
15,62,77,43,-0.1,0,Clear,14.8,2021-03-02 06:00:00,6
34,135,169,41,-0.7,0,Clear,15.6,2021-03-02 07:00:00,7
55,156,211,42,-1.2,0,Clear,15.0,2021-03-02 08:00:00,8
55,129,184,39,-1.0,0,Clear,16.4,2021-03-02 09:00:00,9
41,92,133,37,-0.1,0,Clear,16.1,2021-03-02 10:00:00,10
52,127,179,36,1.1,0,Clear,15.8,2021-03-02 11:00:00,11
61,170,231,34,2.4,0,Clear,16.1,2021-03-02 12:00:00,12
50,130,180,33,3.7,0,Clear,15.3,2021-03-02 13:00:00,13
69,141,210,31,4.9,0,Clear,13.5,2021-03-02 14:00:00,14
72,161,233,32,5.8,0,Clear,11.5,2021-03-02 15:00:00,15
125,233,358,31,6.4,0,Clear,10.5,2021-03-02 16:00:00,16
105,302,407,30,6.5,0,Clear,10.0,2021-03-02 17:00:00,17
113,236,349,30,6.1,0,Clear,5.8,2021-03-02 18:00:00,18
64,155,219,38,5.2,0,Clear,3.0,2021-03-02 19:00:00,19
24,74,98,46,3.3,0,Clear,5.2,2021-03-02 20:00:00,20
20,57,77,54,1.6,0,Clear,7.2,2021-03-02 21:00:00,21
23,44,67,59,0.5,0,Clear,8.3,2021-03-02 22:00:00,22
16,25,41,65,-0.4,0,Clear,6.8,2021-03-02 23:00:00,23
8,4,12,70,-1.0,0,Clear,8.4,2021-03-03 00:00:00,0
5,9,14,74,-1.2,0,Clear,10.7,2021-03-03 01:00:00,1
3,2,5,77,-1.4,0,Clear,10.0,2021-03-03 02:00:00,2
2,1,3,68,-1.1,0,Clear,11.3,2021-03-03 03:00:00,3
5,4,9,67,-1.1,0,Clear,10.9,2021-03-03 04:00:00,4
5,19,24,70,-1.4,0,Clear,9.5,2021-03-03 05:00:00,5
9,64,73,74,-1.8,0,Clear,7.8,2021-03-03 06:00:00,6
31,110,141,77,-2.2,0,Clear,7.2,2021-03-03 07:00:00,7
55,208,263,80,-2.4,0,Clear,8.2,2021-03-03 08:00:00,8
49,143,192,74,0.9,0,Clear,8.4,2021-03-03 09:00:00,9
69,126,195,60,4.3,0,Clear,7.2,2021-03-03 10:00:00,10
71,150,221,49,7.3,0,Clear,8.3,2021-03-03 11:00:00,11
104,219,323,36,9.5,0,Clear,11.5,2021-03-03 12:00:00,12
103,210,313,33,11.0,0,Clear,11.6,2021-03-03 13:00:00,13
117,205,322,32,12.2,0,Clear,10.9,2021-03-03 14:00:00,14
158,238,396,32,13.2,0,Clear,11.2,2021-03-03 15:00:00,15
211,327,538,31,13.7,0,Clear,11.9,2021-03-03 16:00:00,16
229,432,661,32,13.8,0,Clear,12.6,2021-03-03 17:00:00,17
146,332,478,38,12.8,0,Clear,6.2,2021-03-03 18:00:00,18
77,185,262,44,11.0,0,Clear,9.0,2021-03-03 19:00:00,19
58,112,170,52,8.7,0,Clear,10.7,2021-03-03 20:00:00,20
42,77,119,56,7.3,0,Clear,9.7,2021-03-03 21:00:00,21
23,52,75,58,6.4,0,Clear,10.1,2021-03-03 22:00:00,22
35,27,62,59,5.8,0,Clear,10.9,2021-03-03 23:00:00,23
2,6,8,61,5.1,0,Clear,11.2,2021-03-04 00:00:00,0
5,9,14,64,4.4,0,Clear,11.3,2021-03-04 01:00:00,1
1,9,10,67,3.9,0,Clear,12.2,2021-03-04 02:00:00,2
4,2,6,62,4.4,0,Clear,13.4,2021-03-04 03:00:00,3
4,4,8,64,4.1,0,Clear,13.2,2021-03-04 04:00:00,4
7,23,30,67,3.7,0,Clear,13.0,2021-03-04 05:00:00,5
16,77,93,71,3.3,0,Clear,12.0,2021-03-04 06:00:00,6
31,159,190,75,2.6,0,Clear,11.2,2021-03-04 07:00:00,7
68,190,258,79,2.1,0,Clear,11.5,2021-03-04 08:00:00,8
55,138,193,76,4.0,0,Clear,12.0,2021-03-04 09:00:00,9
55,116,171,64,6.8,0,Clear,12.5,2021-03-04 10:00:00,10
73,159,232,57,8.4,1,Mostly Clear,18.9,2021-03-04 11:00:00,11
83,163,246,48,9.6,1,Mostly Clear,19.9,2021-03-04 12:00:00,12
91,167,258,43,10.3,1,Mostly Clear,21.0,2021-03-04 13:00:00,13
85,141,226,41,10.6,1,Mostly Clear,23.0,2021-03-04 14:00:00,14
94,177,271,38,11.4,1,Mostly Clear,23.0,2021-03-04 15:00:00,15
98,234,332,41,10.9,2,Partly Cloudy,23.4,2021-03-04 16:00:00,16
117,317,434,41,9.9,3,Cloudy,24.2,2021-03-04 17:00:00,17
66,219,285,41,8.3,2,Partly Cloudy,20.9,2021-03-04 18:00:00,18
51,168,219,41,6.9,3,Cloudy,20.6,2021-03-04 19:00:00,19
41,109,150,43,5.7,3,Cloudy,19.9,2021-03-04 20:00:00,20
31,60,91,44,4.7,1,Mostly Clear,20.4,2021-03-04 21:00:00,21
18,36,54,43,3.6,0,Clear,20.9,2021-03-04 22:00:00,22
11,26,37,41,2.4,0,Clear,20.0,2021-03-04 23:00:00,23
7,5,12,39,1.3,0,Clear,19.6,2021-03-05 00:00:00,0
5,6,11,39,0.4,0,Clear,18.9,2021-03-05 01:00:00,1
1,6,7,40,-0.3,0,Clear,17.8,2021-03-05 02:00:00,2
3,4,7,43,-0.8,0,Clear,16.6,2021-03-05 03:00:00,3
3,6,9,42,-1.2,0,Clear,16.3,2021-03-05 04:00:00,4
4,26,30,41,-1.6,0,Clear,16.5,2021-03-05 05:00:00,5
10,58,68,40,-1.8,0,Clear,16.0,2021-03-05 06:00:00,6
23,99,122,39,-2.1,0,Clear,17.0,2021-03-05 07:00:00,7
42,149,191,41,-2.2,0,Clear,17.0,2021-03-05 08:00:00,8
26,132,158,39,-1.5,0,Clear,19.9,2021-03-05 09:00:00,9
34,112,146,38,-0.3,0,Clear,19.9,2021-03-05 10:00:00,10
54,142,196,36,1.1,0,Clear,20.0,2021-03-05 11:00:00,11
68,159,227,35,2.5,0,Clear,20.4,2021-03-05 12:00:00,12
76,173,249,34,3.8,0,Clear,21.1,2021-03-05 13:00:00,13
111,176,287,33,5.1,0,Clear,23.3,2021-03-05 14:00:00,14
92,168,260,29,6.5,1,Mostly Clear,27.2,2021-03-05 15:00:00,15
113,231,344,30,6.5,2,Partly Cloudy,27.8,2021-03-05 16:00:00,16
95,275,370,31,6.0,1,Mostly Clear,27.1,2021-03-05 17:00:00,17
72,221,293,31,5.5,0,Clear,20.9,2021-03-05 18:00:00,18
69,186,255,32,4.3,0,Clear,15.1,2021-03-05 19:00:00,19
43,85,128,35,3.1,0,Clear,13.3,2021-03-05 20:00:00,20
29,75,104,37,2.3,0,Clear,13.2,2021-03-05 21:00:00,21
38,60,98,39,1.7,0,Clear,13.9,2021-03-05 22:00:00,22
30,32,62,41,1.1,0,Clear,15.3,2021-03-05 23:00:00,23
25,28,53,43,0.5,0,Clear,16.4,2021-03-06 00:00:00,0
9,12,21,45,0.1,0,Clear,16.2,2021-03-06 01:00:00,1
3,11,14,47,-0.3,0,Clear,15.6,2021-03-06 02:00:00,2
6,9,15,47,-0.0,0,Clear,14.4,2021-03-06 03:00:00,3
2,8,10,50,-0.5,0,Clear,12.2,2021-03-06 04:00:00,4
3,3,6,55,-1.1,0,Clear,10.4,2021-03-06 05:00:00,5
14,28,42,62,-2.1,0,Clear,8.3,2021-03-06 06:00:00,6
23,55,78,68,-2.9,0,Clear,9.4,2021-03-06 07:00:00,7
38,83,121,71,-3.0,0,Clear,10.1,2021-03-06 08:00:00,8
47,152,199,60,0.5,0,Clear,10.1,2021-03-06 09:00:00,9
113,176,289,49,2.8,1,Mostly Clear,16.1,2021-03-06 10:00:00,10
189,217,406,43,4.0,3,Cloudy,18.4,2021-03-06 11:00:00,11
234,267,501,41,5.0,3,Cloudy,18.6,2021-03-06 12:00:00,12
275,293,568,39,5.9,3,Cloudy,19.2,2021-03-06 13:00:00,13
256,235,491,38,6.3,3,Cloudy,20.0,2021-03-06 14:00:00,14
270,257,527,35,7.1,3,Cloudy,21.1,2021-03-06 15:00:00,15
250,265,515,35,7.0,2,Partly Cloudy,21.2,2021-03-06 16:00:00,16
215,254,469,37,6.4,1,Mostly Clear,19.3,2021-03-06 17:00:00,17
110,181,291,38,5.9,1,Mostly Clear,12.5,2021-03-06 18:00:00,18
60,116,176,41,4.5,0,Clear,9.2,2021-03-06 19:00:00,19
47,78,125,45,3.2,0,Clear,9.3,2021-03-06 20:00:00,20
52,56,108,51,1.9,0,Clear,8.4,2021-03-06 21:00:00,21
40,52,92,59,0.4,0,Clear,7.7,2021-03-06 22:00:00,22
42,33,75,65,-0.8,0,Clear,7.0,2021-03-06 23:00:00,23
28,21,49,67,-1.8,0,Clear,6.7,2021-03-07 00:00:00,0
14,21,35,69,-2.5,0,Clear,7.2,2021-03-07 01:00:00,1
7,13,20,71,-2.9,0,Clear,6.4,2021-03-07 02:00:00,2
8,5,13,69,-2.4,0,Clear,6.4,2021-03-07 03:00:00,3
2,4,6,70,-2.7,0,Clear,6.5,2021-03-07 04:00:00,4
2,3,5,70,-2.9,0,Clear,6.8,2021-03-07 05:00:00,5
7,16,23,70,-3.1,0,Clear,7.5,2021-03-07 06:00:00,6
7,31,38,69,-3.1,0,Clear,7.2,2021-03-07 07:00:00,7
21,60,81,68,-2.7,0,Clear,7.2,2021-03-07 08:00:00,8
59,106,165,62,-0.1,0,Clear,8.7,2021-03-07 09:00:00,9
84,158,242,44,2.2,0,Clear,10.2,2021-03-07 10:00:00,10
136,189,325,41,3.3,0,Clear,10.7,2021-03-07 11:00:00,11
171,237,408,38,4.5,0,Clear,11.2,2021-03-07 12:00:00,12
218,272,490,35,5.6,0,Clear,10.9,2021-03-07 13:00:00,13
270,214,484,32,6.5,0,Clear,11.5,2021-03-07 14:00:00,14
214,261,475,30,7.0,0,Clear,12.2,2021-03-07 15:00:00,15
234,238,472,29,7.4,0,Clear,13.5,2021-03-07 16:00:00,16
132,229,361,29,7.4,0,Clear,13.8,2021-03-07 17:00:00,17
81,161,242,31,6.9,0,Clear,10.7,2021-03-07 18:00:00,18
48,96,144,37,5.4,0,Clear,6.6,2021-03-07 19:00:00,19
38,52,90,43,3.6,0,Clear,7.2,2021-03-07 20:00:00,20
18,31,49,54,1.8,0,Clear,7.6,2021-03-07 21:00:00,21
23,21,44,62,0.4,0,Clear,7.9,2021-03-07 22:00:00,22
13,17,30,64,-0.6,0,Clear,6.9,2021-03-07 23:00:00,23
8,5,13,66,-1.0,0,Clear,6.6,2021-03-08 00:00:00,0
2,4,6,68,-1.4,0,Clear,5.8,2021-03-08 01:00:00,1
1,2,3,71,-2.1,0,Clear,5.2,2021-03-08 02:00:00,2
3,0,3,68,-2.1,0,Clear,5.6,2021-03-08 03:00:00,3
7,5,12,70,-2.6,0,Clear,6.2,2021-03-08 04:00:00,4
5,10,15,70,-3.0,0,Clear,6.9,2021-03-08 05:00:00,5
7,52,59,70,-3.3,0,Clear,6.2,2021-03-08 06:00:00,6
24,104,128,69,-3.4,0,Clear,6.4,2021-03-08 07:00:00,7
41,178,219,67,-2.9,0,Clear,7.4,2021-03-08 08:00:00,8
39,127,166,60,0.2,0,Clear,6.7,2021-03-08 09:00:00,9
37,102,139,48,3.1,0,Clear,7.9,2021-03-08 10:00:00,10
61,130,191,42,4.6,0,Clear,10.7,2021-03-08 11:00:00,11
65,153,218,38,5.9,0,Clear,9.8,2021-03-08 12:00:00,12
87,151,238,36,7.3,0,Clear,9.3,2021-03-08 13:00:00,13
108,154,262,34,8.6,0,Clear,9.1,2021-03-08 14:00:00,14
111,168,279,30,9.9,0,Clear,8.7,2021-03-08 15:00:00,15
165,259,424,29,10.7,0,Clear,8.0,2021-03-08 16:00:00,16
145,305,450,29,11.0,0,Clear,7.2,2021-03-08 17:00:00,17
99,264,363,35,10.3,0,Clear,4.1,2021-03-08 18:00:00,18
47,178,225,43,8.7,1,Mostly Clear,5.4,2021-03-08 19:00:00,19
47,104,151,50,6.2,1,Mostly Clear,7.1,2021-03-08 20:00:00,20
33,57,90,52,4.7,1,Mostly Clear,8.9,2021-03-08 21:00:00,21
28,55,83,54,3.7,0,Clear,9.7,2021-03-08 22:00:00,22
13,13,26,56,3.0,0,Clear,10.4,2021-03-08 23:00:00,23
8,2,10,59,2.5,0,Clear,11.0,2021-03-09 00:00:00,0
6,3,9,61,2.1,0,Clear,11.5,2021-03-09 01:00:00,1
1,5,6,63,1.8,0,Clear,11.7,2021-03-09 02:00:00,2
1,1,2,62,1.9,0,Clear,11.5,2021-03-09 03:00:00,3
4,6,10,64,1.4,0,Clear,11.0,2021-03-09 04:00:00,4
3,24,27,67,1.0,0,Clear,10.0,2021-03-09 05:00:00,5
9,70,79,70,0.6,0,Clear,10.3,2021-03-09 06:00:00,6
28,156,184,73,0.3,0,Clear,9.8,2021-03-09 07:00:00,7
60,201,261,77,0.4,0,Clear,10.3,2021-03-09 08:00:00,8
57,146,203,72,3.7,0,Clear,11.2,2021-03-09 09:00:00,9
77,134,211,53,8.6,1,Mostly Clear,9.8,2021-03-09 10:00:00,10
71,150,221,47,12.2,0,Clear,9.3,2021-03-09 11:00:00,11
111,142,253,42,15.5,0,Clear,11.1,2021-03-09 12:00:00,12
139,214,353,39,17.3,0,Clear,13.4,2021-03-09 13:00:00,13
181,216,397,38,18.8,1,Mostly Clear,13.7,2021-03-09 14:00:00,14
198,248,446,34,20.3,1,Mostly Clear,14.0,2021-03-09 15:00:00,15
234,347,581,34,20.4,1,Mostly Clear,13.3,2021-03-09 16:00:00,16
341,478,819,37,20.0,1,Mostly Clear,10.9,2021-03-09 17:00:00,17
217,368,585,46,18.5,1,Mostly Clear,6.9,2021-03-09 18:00:00,18
129,203,332,62,16.1,1,Mostly Clear,6.1,2021-03-09 19:00:00,19
67,123,190,61,14.5,1,Mostly Clear,4.8,2021-03-09 20:00:00,20
44,82,126,65,13.3,1,Mostly Clear,3.6,2021-03-09 21:00:00,21
57,55,112,68,12.3,1,Mostly Clear,2.1,2021-03-09 22:00:00,22
24,23,47,72,11.2,1,Mostly Clear,3.3,2021-03-09 23:00:00,23
14,6,20,77,9.5,1,Mostly Clear,5.1,2021-03-10 00:00:00,0
6,6,12,86,6.9,1,Mostly Clear,6.2,2021-03-10 01:00:00,1
5,6,11,90,5.7,1,Mostly Clear,6.4,2021-03-10 02:00:00,2
1,1,2,91,4.8,0,Clear,9.0,2021-03-10 03:00:00,3
4,4,8,92,4.2,0,Clear,10.7,2021-03-10 04:00:00,4
4,22,26,92,4.0,0,Clear,11.8,2021-03-10 05:00:00,5
19,81,100,91,3.9,0,Clear,11.9,2021-03-10 06:00:00,6
38,154,192,89,3.7,0,Clear,11.6,2021-03-10 07:00:00,7
71,221,292,89,3.7,0,Clear,11.4,2021-03-10 08:00:00,8
62,143,205,81,6.6,0,Clear,10.6,2021-03-10 09:00:00,9
74,155,229,68,9.9,0,Clear,8.5,2021-03-10 10:00:00,10
116,210,326,61,12.2,0,Clear,6.5,2021-03-10 11:00:00,11
148,223,371,56,14.5,0,Clear,5.9,2021-03-10 12:00:00,12
138,245,383,51,16.4,0,Clear,6.9,2021-03-10 13:00:00,13
180,247,427,47,17.9,0,Clear,8.2,2021-03-10 14:00:00,14
228,268,496,43,18.9,0,Clear,9.4,2021-03-10 15:00:00,15
253,365,618,42,19.3,0,Clear,10.7,2021-03-10 16:00:00,16
385,557,942,43,19.1,0,Clear,11.1,2021-03-10 17:00:00,17
267,375,642,50,17.8,1,Mostly Clear,9.0,2021-03-10 18:00:00,18
138,232,370,58,15.2,1,Mostly Clear,11.0,2021-03-10 19:00:00,19
91,159,250,65,13.1,1,Mostly Clear,12.0,2021-03-10 20:00:00,20
50,91,141,68,11.9,1,Mostly Clear,12.6,2021-03-10 21:00:00,21
62,66,128,69,11.3,1,Mostly Clear,13.0,2021-03-10 22:00:00,22
35,38,73,70,11.0,1,Mostly Clear,12.7,2021-03-10 23:00:00,23
12,12,24,69,10.7,1,Mostly Clear,12.2,2021-03-11 00:00:00,0
6,6,12,67,10.4,1,Mostly Clear,12.4,2021-03-11 01:00:00,1
6,3,9,67,10.0,1,Mostly Clear,12.4,2021-03-11 02:00:00,2
5,2,7,56,10.0,1,Mostly Clear,12.9,2021-03-11 03:00:00,3
3,5,8,58,9.9,1,Mostly Clear,12.9,2021-03-11 04:00:00,4
8,31,39,60,9.7,1,Mostly Clear,12.7,2021-03-11 05:00:00,5
19,66,85,62,9.4,1,Mostly Clear,10.2,2021-03-11 06:00:00,6
47,156,203,65,9.2,2,Partly Cloudy,9.2,2021-03-11 07:00:00,7
68,228,296,69,9.2,1,Mostly Clear,9.7,2021-03-11 08:00:00,8
83,166,249,69,10.9,0,Clear,10.2,2021-03-11 09:00:00,9
108,146,254,61,13.7,0,Clear,10.5,2021-03-11 10:00:00,10
104,212,316,56,16.0,0,Clear,10.7,2021-03-11 11:00:00,11
151,273,424,51,18.3,0,Clear,10.5,2021-03-11 12:00:00,12
213,242,455,47,20.2,0,Clear,11.2,2021-03-11 13:00:00,13
247,242,489,43,21.7,0,Clear,13.2,2021-03-11 14:00:00,14
298,291,589,37,23.2,0,Clear,15.5,2021-03-11 15:00:00,15
311,345,656,36,23.6,0,Clear,17.4,2021-03-11 16:00:00,16
456,596,1052,37,23.2,0,Clear,16.3,2021-03-11 17:00:00,17
292,443,735,40,21.9,1,Mostly Clear,13.0,2021-03-11 18:00:00,18
153,271,424,43,19.9,1,Mostly Clear,12.1,2021-03-11 19:00:00,19
103,165,268,44,18.6,1,Mostly Clear,16.2,2021-03-11 20:00:00,20
90,140,230,47,17.6,0,Clear,14.7,2021-03-11 21:00:00,21
86,87,173,52,16.3,0,Clear,13.6,2021-03-11 22:00:00,22
44,38,82,55,15.5,1,Mostly Clear,12.5,2021-03-11 23:00:00,23
16,15,31,57,15.0,1,Mostly Clear,12.0,2021-03-12 00:00:00,0
3,8,11,58,14.7,1,Mostly Clear,11.8,2021-03-12 01:00:00,1
6,2,8,61,14.4,1,Mostly Clear,10.9,2021-03-12 02:00:00,2
5,3,8,55,14.3,1,Mostly Clear,11.7,2021-03-12 03:00:00,3
3,11,14,58,13.9,2,Partly Cloudy,12.2,2021-03-12 04:00:00,4
15,26,41,62,13.4,3,Cloudy,10.6,2021-03-12 05:00:00,5
26,67,93,64,13.1,3,Cloudy,8.3,2021-03-12 06:00:00,6
56,154,210,70,12.4,2,Partly Cloudy,8.3,2021-03-12 07:00:00,7
72,226,298,78,11.9,2,Partly Cloudy,9.6,2021-03-12 08:00:00,8
80,157,237,83,13.3,2,Partly Cloudy,9.0,2021-03-12 09:00:00,9
85,143,228,66,16.9,2,Partly Cloudy,9.1,2021-03-12 10:00:00,10
123,208,331,64,18.6,2,Partly Cloudy,8.9,2021-03-12 11:00:00,11
124,188,312,64,18.5,3,Cloudy,11.8,2021-03-12 12:00:00,12
132,172,304,64,18.3,3,Cloudy,12.0,2021-03-12 13:00:00,13
201,236,437,63,18.3,3,Cloudy,12.6,2021-03-12 14:00:00,14
206,293,499,58,19.0,2,Partly Cloudy,12.8,2021-03-12 15:00:00,15
318,376,694,56,19.8,1,Mostly Clear,14.3,2021-03-12 16:00:00,16
385,438,823,55,19.9,1,Mostly Clear,13.9,2021-03-12 17:00:00,17
270,356,626,55,19.3,1,Mostly Clear,9.7,2021-03-12 18:00:00,18
160,208,368,53,17.6,0,Clear,9.0,2021-03-12 19:00:00,19
108,143,251,44,16.2,0,Clear,12.6,2021-03-12 20:00:00,20
107,104,211,36,14.8,0,Clear,15.5,2021-03-12 21:00:00,21
131,95,226,35,14.0,1,Mostly Clear,14.3,2021-03-12 22:00:00,22
80,74,154,35,13.1,1,Mostly Clear,15.5,2021-03-12 23:00:00,23
42,40,82,35,12.2,1,Mostly Clear,16.8,2021-03-13 00:00:00,0
29,29,58,34,11.4,1,Mostly Clear,17.6,2021-03-13 01:00:00,1
19,11,30,34,10.9,1,Mostly Clear,17.4,2021-03-13 02:00:00,2
10,4,14,32,12.0,1,Mostly Clear,17.8,2021-03-13 03:00:00,3
5,6,11,34,11.2,1,Mostly Clear,19.2,2021-03-13 04:00:00,4
5,9,14,34,9.9,1,Mostly Clear,20.8,2021-03-13 05:00:00,5
14,24,38,31,8.4,1,Mostly Clear,14.2,2021-03-13 06:00:00,6
22,54,76,28,6.8,0,Clear,13.0,2021-03-13 07:00:00,7
71,107,178,31,5.4,0,Clear,12.3,2021-03-13 08:00:00,8
115,172,287,32,4.9,0,Clear,14.7,2021-03-13 09:00:00,9
214,233,447,32,5.6,0,Clear,12.0,2021-03-13 10:00:00,10
348,311,659,32,6.7,0,Clear,9.2,2021-03-13 11:00:00,11
408,361,769,32,8.0,0,Clear,7.4,2021-03-13 12:00:00,12
489,344,833,31,9.3,0,Clear,6.7,2021-03-13 13:00:00,13
515,362,877,30,10.7,1,Mostly Clear,7.6,2021-03-13 14:00:00,14
534,329,863,27,13.1,1,Mostly Clear,9.0,2021-03-13 15:00:00,15
517,355,872,26,13.7,1,Mostly Clear,9.6,2021-03-13 16:00:00,16
385,321,706,26,13.8,1,Mostly Clear,10.2,2021-03-13 17:00:00,17
242,242,484,29,13.3,1,Mostly Clear,6.8,2021-03-13 18:00:00,18
145,163,308,38,11.9,1,Mostly Clear,5.5,2021-03-13 19:00:00,19
77,89,166,45,9.7,0,Clear,6.8,2021-03-13 20:00:00,20
90,72,162,54,7.8,0,Clear,7.4,2021-03-13 21:00:00,21
111,75,186,64,6.0,0,Clear,7.9,2021-03-13 22:00:00,22
90,45,135,66,4.9,0,Clear,10.3,2021-03-13 23:00:00,23
50,33,83,64,4.0,0,Clear,11.1,2021-03-14 00:00:00,0
21,16,37,59,3.4,0,Clear,12.0,2021-03-14 01:00:00,1
14,13,27,45,3.6,0,Clear,14.4,2021-03-14 03:00:00,3
10,5,15,42,3.9,0,Clear,15.1,2021-03-14 04:00:00,4
7,3,10,41,4.0,0,Clear,15.0,2021-03-14 05:00:00,5
10,17,27,41,4.0,0,Clear,14.6,2021-03-14 06:00:00,6
11,29,40,41,4.1,0,Clear,14.9,2021-03-14 07:00:00,7
31,67,98,45,4.5,0,Clear,14.7,2021-03-14 08:00:00,8
73,115,188,47,6.9,0,Clear,15.4,2021-03-14 09:00:00,9
157,183,340,40,10.0,0,Clear,15.6,2021-03-14 10:00:00,10
251,260,511,37,12.1,0,Clear,18.1,2021-03-14 11:00:00,11
369,295,664,37,13.6,0,Clear,18.9,2021-03-14 12:00:00,12
432,386,818,36,14.8,0,Clear,20.2,2021-03-14 13:00:00,13
460,353,813,35,15.5,0,Clear,23.5,2021-03-14 14:00:00,14
463,340,803,29,16.8,1,Mostly Clear,30.0,2021-03-14 15:00:00,15
457,317,774,30,16.2,0,Clear,27.4,2021-03-14 16:00:00,16
336,290,626,30,15.4,0,Clear,27.4,2021-03-14 17:00:00,17
204,215,419,31,14.2,0,Clear,20.7,2021-03-14 18:00:00,18
124,153,277,29,12.5,0,Clear,18.8,2021-03-14 19:00:00,19
59,74,133,28,10.8,0,Clear,18.9,2021-03-14 20:00:00,20
44,68,112,29,9.3,0,Clear,20.5,2021-03-14 21:00:00,21
30,38,68,31,7.9,0,Clear,20.8,2021-03-14 22:00:00,22
27,22,49,33,6.6,0,Clear,20.9,2021-03-14 23:00:00,23
7,3,10,34,5.4,1,Mostly Clear,20.9,2021-03-15 00:00:00,0
1,5,6,33,4.3,1,Mostly Clear,21.1,2021-03-15 01:00:00,1
1,5,6,32,3.2,0,Clear,19.8,2021-03-15 02:00:00,2
3,2,5,29,3.0,0,Clear,19.0,2021-03-15 03:00:00,3
3,7,10,28,1.8,0,Clear,18.3,2021-03-15 04:00:00,4
3,16,19,29,0.9,0,Clear,16.5,2021-03-15 05:00:00,5
19,46,65,31,0.1,0,Clear,10.7,2021-03-15 06:00:00,6
23,113,136,34,-0.6,0,Clear,9.9,2021-03-15 07:00:00,7
42,158,200,41,-0.8,0,Clear,11.2,2021-03-15 08:00:00,8
39,121,160,36,0.3,0,Clear,14.2,2021-03-15 09:00:00,9
39,72,111,33,1.6,1,Mostly Clear,14.1,2021-03-15 10:00:00,10
42,99,141,31,3.2,1,Mostly Clear,13.8,2021-03-15 11:00:00,11
93,134,227,29,4.8,1,Mostly Clear,11.6,2021-03-15 12:00:00,12
87,138,225,28,6.2,0,Clear,9.8,2021-03-15 13:00:00,13
99,144,243,27,7.3,0,Clear,8.7,2021-03-15 14:00:00,14
118,169,287,26,7.4,0,Clear,6.6,2021-03-15 15:00:00,15
164,197,361,26,7.8,1,Mostly Clear,5.8,2021-03-15 16:00:00,16
169,308,477,25,7.8,1,Mostly Clear,4.5,2021-03-15 17:00:00,17
113,259,372,24,7.5,1,Mostly Clear,4.2,2021-03-15 18:00:00,18
74,181,255,26,6.9,3,Cloudy,2.3,2021-03-15 19:00:00,19
36,85,121,32,6.2,2,Partly Cloudy,5.9,2021-03-15 20:00:00,20
28,69,97,36,5.4,3,Cloudy,5.2,2021-03-15 21:00:00,21
30,39,69,40,5.0,3,Cloudy,6.0,2021-03-15 22:00:00,22
16,24,40,43,4.6,3,Cloudy,8.2,2021-03-15 23:00:00,23
8,6,14,47,4.4,3,Cloudy,8.9,2021-03-16 00:00:00,0
4,4,8,50,4.2,3,Cloudy,8.6,2021-03-16 01:00:00,1
2,1,3,54,4.0,3,Cloudy,10.1,2021-03-16 02:00:00,2
1,2,3,54,3.9,2,Partly Cloudy,9.4,2021-03-16 03:00:00,3
4,3,7,60,3.4,2,Partly Cloudy,8.6,2021-03-16 04:00:00,4
5,24,29,63,3.2,3,Cloudy,7.8,2021-03-16 05:00:00,5
13,63,76,65,3.2,3,Cloudy,8.2,2021-03-16 06:00:00,6
27,119,146,66,3.2,3,Cloudy,8.1,2021-03-16 07:00:00,7
39,178,217,68,3.3,3,Cloudy,9.1,2021-03-16 08:00:00,8
50,126,176,71,3.5,3,Cloudy,10.3,2021-03-16 09:00:00,9
42,98,140,72,4.1,3,Cloudy,12.2,2021-03-16 10:00:00,10
62,122,184,68,5.6,3,Cloudy,13.0,2021-03-16 11:00:00,11
74,132,206,68,6.4,3,Cloudy,12.5,2021-03-16 12:00:00,12
63,135,198,68,7.1,3,Cloudy,14.1,2021-03-16 13:00:00,13
81,135,216,68,7.4,3,Cloudy,13.2,2021-03-16 14:00:00,14
80,143,223,72,6.6,3,Cloudy,12.5,2021-03-16 15:00:00,15
103,191,294,75,6.5,3,Cloudy,12.5,2021-03-16 16:00:00,16
91,271,362,76,6.5,3,Cloudy,13.0,2021-03-16 17:00:00,17
91,275,366,78,6.2,3,Cloudy,10.5,2021-03-16 18:00:00,18
67,195,262,80,5.8,3,Cloudy,9.4,2021-03-16 19:00:00,19
53,92,145,82,5.7,3,Cloudy,8.7,2021-03-16 20:00:00,20
18,65,83,85,5.5,51,Light Drizzle,6.6,2021-03-16 21:00:00,21
31,36,67,86,5.4,3,Cloudy,7.3,2021-03-16 22:00:00,22
20,14,34,88,5.2,3,Cloudy,7.1,2021-03-16 23:00:00,23
9,13,22,88,5.2,3,Cloudy,7.1,2021-03-17 00:00:00,0
0,3,3,88,5.2,3,Cloudy,7.2,2021-03-17 01:00:00,1
3,2,5,89,5.2,3,Cloudy,5.8,2021-03-17 02:00:00,2
1,2,3,90,5.1,3,Cloudy,5.6,2021-03-17 03:00:00,3
12,5,17,91,5.0,3,Cloudy,6.0,2021-03-17 04:00:00,4
12,28,40,92,4.9,3,Cloudy,6.2,2021-03-17 05:00:00,5
14,70,84,93,4.8,3,Cloudy,5.7,2021-03-17 06:00:00,6
26,128,154,93,4.8,3,Cloudy,5.3,2021-03-17 07:00:00,7
49,192,241,92,5.0,3,Cloudy,5.4,2021-03-17 08:00:00,8
34,148,182,89,5.5,3,Cloudy,4.8,2021-03-17 09:00:00,9
59,106,165,83,6.4,3,Cloudy,4.6,2021-03-17 10:00:00,10
89,124,213,84,7.2,3,Cloudy,4.2,2021-03-17 11:00:00,11
95,186,281,79,8.6,3,Cloudy,3.8,2021-03-17 12:00:00,12
136,174,310,77,9.6,3,Cloudy,2.5,2021-03-17 13:00:00,13
132,149,281,74,10.4,3,Cloudy,6.5,2021-03-17 14:00:00,14
137,176,313,74,10.4,3,Cloudy,6.0,2021-03-17 15:00:00,15
120,224,344,73,10.9,3,Cloudy,4.7,2021-03-17 16:00:00,16
185,375,560,73,11.0,3,Cloudy,6.9,2021-03-17 17:00:00,17
167,351,518,73,10.7,3,Cloudy,6.0,2021-03-17 18:00:00,18
119,222,341,77,10.0,3,Cloudy,5.9,2021-03-17 19:00:00,19
72,130,202,81,9.2,3,Cloudy,7.7,2021-03-17 20:00:00,20
57,94,151,83,8.8,3,Cloudy,6.5,2021-03-17 21:00:00,21
46,80,126,86,8.3,3,Cloudy,8.4,2021-03-17 22:00:00,22
36,37,73,87,8.2,3,Cloudy,8.8,2021-03-17 23:00:00,23
15,17,32,88,8.1,3,Cloudy,8.7,2021-03-18 00:00:00,0
8,3,11,88,8.0,3,Cloudy,9.8,2021-03-18 01:00:00,1
5,10,15,89,8.0,3,Cloudy,10.4,2021-03-18 02:00:00,2
4,3,7,89,8.1,3,Cloudy,9.5,2021-03-18 03:00:00,3
2,9,11,90,8.0,3,Cloudy,10.0,2021-03-18 04:00:00,4
6,16,22,92,7.9,51,Light Drizzle,12.5,2021-03-18 05:00:00,5
6,29,35,96,7.6,53,Heavy Drizzle,11.7,2021-03-18 06:00:00,6
13,46,59,99,7.5,61,Light Rain,10.9,2021-03-18 07:00:00,7
21,87,108,99,7.7,63,Rain,11.0,2021-03-18 08:00:00,8
18,64,82,99,7.9,61,Light Rain,10.2,2021-03-18 09:00:00,9
28,68,96,99,8.3,53,Heavy Drizzle,11.1,2021-03-18 10:00:00,10
39,61,100,99,8.7,53,Heavy Drizzle,10.4,2021-03-18 11:00:00,11
19,72,91,100,9.1,53,Heavy Drizzle,10.7,2021-03-18 12:00:00,12
27,57,84,99,9.6,53,Heavy Drizzle,8.3,2021-03-18 13:00:00,13
33,43,76,99,9.9,53,Heavy Drizzle,8.0,2021-03-18 14:00:00,14
50,98,148,99,10.4,53,Heavy Drizzle,4.7,2021-03-18 15:00:00,15
36,113,149,98,10.9,51,Light Drizzle,5.8,2021-03-18 16:00:00,16
45,158,203,99,11.1,51,Light Drizzle,4.0,2021-03-18 17:00:00,17
50,192,242,99,11.0,53,Heavy Drizzle,6.1,2021-03-18 18:00:00,18
35,102,137,99,10.6,55,Heavy Drizzle,8.2,2021-03-18 19:00:00,19
21,80,101,99,10.0,61,Light Rain,11.5,2021-03-18 20:00:00,20
26,51,77,100,9.5,61,Light Rain,15.5,2021-03-18 21:00:00,21
29,40,69,99,8.5,63,Rain,17.7,2021-03-18 22:00:00,22
22,26,48,98,7.6,63,Rain,18.9,2021-03-18 23:00:00,23
18,14,32,97,7.2,53,Heavy Drizzle,18.5,2021-03-19 00:00:00,0
9,3,12,96,6.8,53,Heavy Drizzle,19.3,2021-03-19 01:00:00,1
5,6,11,96,6.4,51,Light Drizzle,21.3,2021-03-19 02:00:00,2
3,5,8,91,6.6,3,Cloudy,21.8,2021-03-19 03:00:00,3
4,11,15,88,6.2,51,Light Drizzle,22.2,2021-03-19 04:00:00,4
8,22,30,85,5.7,3,Cloudy,21.8,2021-03-19 05:00:00,5
12,48,60,78,5.1,3,Cloudy,20.2,2021-03-19 06:00:00,6
23,133,156,67,4.6,2,Partly Cloudy,20.6,2021-03-19 07:00:00,7
47,158,205,56,4.0,2,Partly Cloudy,20.8,2021-03-19 08:00:00,8
44,134,178,44,3.7,2,Partly Cloudy,22.0,2021-03-19 09:00:00,9
55,132,187,38,4.2,1,Mostly Clear,21.7,2021-03-19 10:00:00,10
85,136,221,34,5.4,0,Clear,21.5,2021-03-19 11:00:00,11
123,186,309,32,6.6,0,Clear,22.1,2021-03-19 12:00:00,12
138,145,283,31,7.9,0,Clear,21.7,2021-03-19 13:00:00,13
131,179,310,30,8.9,0,Clear,20.5,2021-03-19 14:00:00,14
182,230,412,29,9.1,0,Clear,19.5,2021-03-19 15:00:00,15
175,234,409,28,9.5,0,Clear,19.1,2021-03-19 16:00:00,16
197,354,551,28,9.4,0,Clear,18.2,2021-03-19 17:00:00,17
196,345,541,29,8.9,0,Clear,12.9,2021-03-19 18:00:00,18
119,225,344,31,7.7,0,Clear,8.7,2021-03-19 19:00:00,19
63,99,162,34,6.2,0,Clear,8.6,2021-03-19 20:00:00,20
46,81,127,37,5.0,0,Clear,9.4,2021-03-19 21:00:00,21
49,71,120,39,4.1,0,Clear,10.1,2021-03-19 22:00:00,22
41,67,108,41,3.3,0,Clear,10.9,2021-03-19 23:00:00,23
33,38,71,42,2.6,0,Clear,11.7,2021-03-20 00:00:00,0
11,17,28,43,2.0,0,Clear,12.1,2021-03-20 01:00:00,1
8,7,15,46,1.3,0,Clear,11.1,2021-03-20 02:00:00,2
8,9,17,49,0.8,0,Clear,10.3,2021-03-20 03:00:00,3
6,6,12,53,0.0,0,Clear,9.9,2021-03-20 04:00:00,4
4,8,12,58,-0.8,0,Clear,9.1,2021-03-20 05:00:00,5
15,18,33,62,-1.6,0,Clear,8.0,2021-03-20 06:00:00,6
30,52,82,68,-2.2,0,Clear,7.7,2021-03-20 07:00:00,7
49,76,125,71,-1.7,0,Clear,9.1,2021-03-20 08:00:00,8
81,136,217,52,2.1,0,Clear,7.5,2021-03-20 09:00:00,9
183,217,400,46,4.3,0,Clear,7.2,2021-03-20 10:00:00,10
325,291,616,41,6.4,0,Clear,6.4,2021-03-20 11:00:00,11
404,335,739,38,8.2,0,Clear,6.1,2021-03-20 12:00:00,12
405,366,771,36,9.7,0,Clear,6.4,2021-03-20 13:00:00,13
513,371,884,35,10.9,0,Clear,5.4,2021-03-20 14:00:00,14
530,347,877,34,12.1,0,Clear,4.9,2021-03-20 15:00:00,15
501,344,845,33,12.5,0,Clear,5.0,2021-03-20 16:00:00,16
448,365,813,34,12.4,0,Clear,5.0,2021-03-20 17:00:00,17
308,339,647,36,11.7,0,Clear,4.8,2021-03-20 18:00:00,18
174,226,400,44,10.4,0,Clear,5.6,2021-03-20 19:00:00,19
106,106,212,52,8.2,0,Clear,6.9,2021-03-20 20:00:00,20
74,82,156,64,6.1,0,Clear,6.5,2021-03-20 21:00:00,21
104,62,166,66,5.1,0,Clear,8.2,2021-03-20 22:00:00,22
59,57,116,62,5.3,0,Clear,6.8,2021-03-20 23:00:00,23
75,52,127,63,5.1,0,Clear,5.1,2021-03-21 00:00:00,0
21,8,29,67,4.5,0,Clear,6.0,2021-03-21 01:00:00,1
7,13,20,73,3.3,0,Clear,5.9,2021-03-21 02:00:00,2
6,3,9,70,2.8,0,Clear,5.7,2021-03-21 03:00:00,3
4,3,7,77,1.5,0,Clear,5.6,2021-03-21 04:00:00,4
9,5,14,83,0.5,0,Clear,5.4,2021-03-21 05:00:00,5
16,14,30,86,-0.3,0,Clear,5.9,2021-03-21 06:00:00,6
9,29,38,87,-0.6,0,Clear,6.2,2021-03-21 07:00:00,7
38,87,125,85,0.3,0,Clear,7.3,2021-03-21 08:00:00,8
93,160,253,73,4.9,0,Clear,6.0,2021-03-21 09:00:00,9
153,241,394,52,9.6,0,Clear,5.4,2021-03-21 10:00:00,10
267,259,526,40,12.1,0,Clear,5.9,2021-03-21 11:00:00,11
403,362,765,35,13.5,0,Clear,6.5,2021-03-21 12:00:00,12
512,395,907,33,14.5,0,Clear,6.6,2021-03-21 13:00:00,13
525,428,953,32,15.1,0,Clear,7.0,2021-03-21 14:00:00,14
523,442,965,30,15.7,0,Clear,7.6,2021-03-21 15:00:00,15
496,412,908,30,15.8,0,Clear,8.7,2021-03-21 16:00:00,16
374,359,733,30,15.3,0,Clear,10.0,2021-03-21 17:00:00,17
304,270,574,35,14.2,0,Clear,8.6,2021-03-21 18:00:00,18
120,162,282,43,12.4,0,Clear,6.6,2021-03-21 19:00:00,19
98,93,191,50,10.3,0,Clear,7.4,2021-03-21 20:00:00,20
45,49,94,57,8.4,0,Clear,8.0,2021-03-21 21:00:00,21
51,35,86,61,6.7,0,Clear,8.2,2021-03-21 22:00:00,22
31,28,59,65,5.4,0,Clear,9.0,2021-03-21 23:00:00,23
12,17,29,71,4.1,0,Clear,8.3,2021-03-22 00:00:00,0
3,5,8,76,3.3,0,Clear,7.2,2021-03-22 01:00:00,1
6,5,11,75,3.4,0,Clear,7.8,2021-03-22 02:00:00,2
0,3,3,70,4.6,0,Clear,6.9,2021-03-22 03:00:00,3
6,8,14,81,1.9,0,Clear,6.0,2021-03-22 04:00:00,4
4,22,26,87,0.3,0,Clear,5.7,2021-03-22 05:00:00,5
22,58,80,89,-0.2,0,Clear,6.9,2021-03-22 06:00:00,6
30,129,159,89,-0.5,0,Clear,7.1,2021-03-22 07:00:00,7
61,180,241,89,0.4,0,Clear,8.6,2021-03-22 08:00:00,8
70,148,218,75,5.7,0,Clear,7.3,2021-03-22 09:00:00,9
76,135,211,64,9.0,0,Clear,7.6,2021-03-22 10:00:00,10
104,137,241,58,11.6,0,Clear,7.9,2021-03-22 11:00:00,11
116,196,312,53,13.6,0,Clear,7.6,2021-03-22 12:00:00,12
168,137,305,50,15.1,0,Clear,7.9,2021-03-22 13:00:00,13
185,219,404,49,16.1,0,Clear,8.4,2021-03-22 14:00:00,14
174,235,409,41,16.4,0,Clear,9.0,2021-03-22 15:00:00,15
236,255,491,41,16.5,0,Clear,9.7,2021-03-22 16:00:00,16
258,428,686,42,16.1,0,Clear,10.5,2021-03-22 17:00:00,17
276,383,659,48,15.2,0,Clear,7.3,2021-03-22 18:00:00,18
177,244,421,58,13.3,0,Clear,6.5,2021-03-22 19:00:00,19
85,132,217,65,11.3,0,Clear,7.3,2021-03-22 20:00:00,20
73,89,162,71,9.9,0,Clear,8.4,2021-03-22 21:00:00,21
41,34,75,78,8.6,0,Clear,8.0,2021-03-22 22:00:00,22
36,30,66,84,7.4,0,Clear,7.6,2021-03-22 23:00:00,23
23,13,36,88,6.4,0,Clear,8.3,2021-03-23 00:00:00,0
19,3,22,89,5.8,0,Clear,8.7,2021-03-23 01:00:00,1
1,1,2,90,5.4,0,Clear,8.3,2021-03-23 02:00:00,2
2,4,6,86,5.3,0,Clear,8.5,2021-03-23 03:00:00,3
6,7,13,88,4.6,0,Clear,8.9,2021-03-23 04:00:00,4
6,26,32,89,4.2,0,Clear,9.4,2021-03-23 05:00:00,5
19,70,89,89,4.0,0,Clear,9.7,2021-03-23 06:00:00,6
31,161,192,90,3.8,0,Clear,9.4,2021-03-23 07:00:00,7
71,254,325,90,4.5,1,Mostly Clear,9.5,2021-03-23 08:00:00,8
60,157,217,78,8.3,1,Mostly Clear,7.8,2021-03-23 09:00:00,9
92,124,216,75,11.1,1,Mostly Clear,8.5,2021-03-23 10:00:00,10
106,154,260,72,13.3,1,Mostly Clear,9.7,2021-03-23 11:00:00,11
155,211,366,69,15.2,1,Mostly Clear,10.2,2021-03-23 12:00:00,12
155,163,318,65,16.7,1,Mostly Clear,12.2,2021-03-23 13:00:00,13
151,196,347,60,17.8,1,Mostly Clear,11.9,2021-03-23 14:00:00,14
175,234,409,54,18.5,1,Mostly Clear,11.5,2021-03-23 15:00:00,15
218,343,561,54,18.3,1,Mostly Clear,11.9,2021-03-23 16:00:00,16
261,431,692,55,17.7,2,Partly Cloudy,12.7,2021-03-23 17:00:00,17
223,440,663,58,17.0,2,Partly Cloudy,9.1,2021-03-23 18:00:00,18
184,295,479,64,15.4,1,Mostly Clear,8.3,2021-03-23 19:00:00,19
97,140,237,72,13.7,1,Mostly Clear,9.7,2021-03-23 20:00:00,20
85,92,177,78,12.7,2,Partly Cloudy,9.7,2021-03-23 21:00:00,21
57,61,118,82,12.1,3,Cloudy,12.0,2021-03-23 22:00:00,22
32,26,58,84,11.7,3,Cloudy,12.8,2021-03-23 23:00:00,23
16,9,25,86,11.3,3,Cloudy,11.3,2021-03-24 00:00:00,0
3,3,6,87,11.0,3,Cloudy,13.1,2021-03-24 01:00:00,1
9,3,12,90,10.7,3,Cloudy,11.7,2021-03-24 02:00:00,2
1,1,2,88,11.3,3,Cloudy,11.0,2021-03-24 03:00:00,3
9,5,14,90,11.2,3,Cloudy,10.9,2021-03-24 04:00:00,4
5,15,20,94,11.2,3,Cloudy,10.6,2021-03-24 05:00:00,5
12,43,55,95,11.3,51,Light Drizzle,8.6,2021-03-24 06:00:00,6
9,55,64,98,11.4,53,Heavy Drizzle,8.4,2021-03-24 07:00:00,7
23,95,118,99,11.6,55,Heavy Drizzle,7.3,2021-03-24 08:00:00,8
26,89,115,99,12.0,61,Light Rain,6.1,2021-03-24 09:00:00,9
8,23,31,98,12.6,55,Heavy Drizzle,5.1,2021-03-24 10:00:00,10
11,44,55,99,13.0,55,Heavy Drizzle,4.7,2021-03-24 11:00:00,11
7,40,47,99,13.6,55,Heavy Drizzle,3.3,2021-03-24 12:00:00,12
5,30,35,99,14.0,61,Light Rain,5.2,2021-03-24 13:00:00,13
13,45,58,99,14.1,63,Rain,5.1,2021-03-24 14:00:00,14
23,74,97,99,14.3,63,Rain,8.0,2021-03-24 15:00:00,15
24,91,115,99,14.1,63,Rain,10.5,2021-03-24 16:00:00,16
43,173,216,99,14.0,63,Rain,11.4,2021-03-24 17:00:00,17
79,199,278,100,14.0,55,Heavy Drizzle,7.7,2021-03-24 18:00:00,18
61,156,217,99,14.0,3,Cloudy,3.7,2021-03-24 19:00:00,19
39,110,149,100,13.6,51,Light Drizzle,6.2,2021-03-24 20:00:00,20
40,89,129,99,13.4,3,Cloudy,4.7,2021-03-24 21:00:00,21
41,37,78,99,13.1,3,Cloudy,4.0,2021-03-24 22:00:00,22
15,36,51,100,12.8,3,Cloudy,5.5,2021-03-24 23:00:00,23
13,14,27,100,12.6,3,Cloudy,5.9,2021-03-25 00:00:00,0
8,6,14,100,12.5,3,Cloudy,3.5,2021-03-25 01:00:00,1
6,5,11,100,12.5,3,Cloudy,5.1,2021-03-25 02:00:00,2
4,1,5,100,12.0,3,Cloudy,4.9,2021-03-25 03:00:00,3
5,6,11,99,12.0,3,Cloudy,5.4,2021-03-25 04:00:00,4
7,19,26,100,11.8,3,Cloudy,5.6,2021-03-25 05:00:00,5
19,67,86,100,11.7,3,Cloudy,2.8,2021-03-25 06:00:00,6
45,145,190,100,11.4,3,Cloudy,2.5,2021-03-25 07:00:00,7
63,216,279,100,11.8,3,Cloudy,2.5,2021-03-25 08:00:00,8
65,166,231,99,12.7,3,Cloudy,3.4,2021-03-25 09:00:00,9
74,160,234,97,13.6,3,Cloudy,3.7,2021-03-25 10:00:00,10
101,150,251,93,14.8,3,Cloudy,6.0,2021-03-25 11:00:00,11
117,213,330,85,16.3,3,Cloudy,7.6,2021-03-25 12:00:00,12
119,178,297,79,18.0,3,Cloudy,7.6,2021-03-25 13:00:00,13
145,195,340,71,19.8,3,Cloudy,8.8,2021-03-25 14:00:00,14
138,204,342,75,19.1,3,Cloudy,10.0,2021-03-25 15:00:00,15
170,244,414,69,20.3,3,Cloudy,10.5,2021-03-25 16:00:00,16
220,472,692,63,21.4,3,Cloudy,9.0,2021-03-25 17:00:00,17
170,356,526,69,20.4,3,Cloudy,4.5,2021-03-25 18:00:00,18
123,240,363,79,18.5,51,Light Drizzle,9.7,2021-03-25 19:00:00,19
91,161,252,87,17.4,3,Cloudy,10.9,2021-03-25 20:00:00,20
65,121,186,90,17.2,3,Cloudy,9.2,2021-03-25 21:00:00,21
70,95,165,90,17.4,2,Partly Cloudy,10.2,2021-03-25 22:00:00,22
56,36,92,90,17.6,3,Cloudy,11.3,2021-03-25 23:00:00,23
25,22,47,90,17.9,3,Cloudy,14.8,2021-03-26 00:00:00,0
11,12,23,88,18.3,3,Cloudy,18.3,2021-03-26 01:00:00,1
6,6,12,87,18.7,53,Heavy Drizzle,18.6,2021-03-26 02:00:00,2
5,3,8,94,17.7,51,Light Drizzle,18.5,2021-03-26 03:00:00,3
5,6,11,94,17.6,1,Mostly Clear,21.3,2021-03-26 04:00:00,4
10,24,34,94,17.5,1,Mostly Clear,21.7,2021-03-26 05:00:00,5
17,78,95,95,17.4,2,Partly Cloudy,19.4,2021-03-26 06:00:00,6
51,143,194,95,17.6,3,Cloudy,20.0,2021-03-26 07:00:00,7
73,228,301,94,18.2,2,Partly Cloudy,20.8,2021-03-26 08:00:00,8
74,184,258,92,19.0,1,Mostly Clear,22.2,2021-03-26 09:00:00,9
122,184,306,88,20.3,0,Clear,22.0,2021-03-26 10:00:00,10
167,241,408,74,22.6,1,Mostly Clear,26.4,2021-03-26 11:00:00,11
234,259,493,58,24.2,0,Clear,27.7,2021-03-26 12:00:00,12
261,295,556,46,25.1,1,Mostly Clear,28.2,2021-03-26 13:00:00,13
303,286,589,37,25.1,0,Clear,28.1,2021-03-26 14:00:00,14
335,334,669,31,26.4,0,Clear,28.1,2021-03-26 15:00:00,15
400,424,824,34,25.5,0,Clear,27.3,2021-03-26 16:00:00,16
513,531,1044,39,24.1,0,Clear,24.7,2021-03-26 17:00:00,17
454,484,938,43,22.3,0,Clear,18.0,2021-03-26 18:00:00,18
342,311,653,47,19.8,0,Clear,16.8,2021-03-26 19:00:00,19
199,206,405,50,17.9,0,Clear,16.9,2021-03-26 20:00:00,20
127,141,268,53,16.5,0,Clear,16.5,2021-03-26 21:00:00,21
131,98,229,56,15.4,0,Clear,15.8,2021-03-26 22:00:00,22
117,85,202,59,14.4,0,Clear,14.0,2021-03-26 23:00:00,23
96,69,165,62,13.6,0,Clear,12.1,2021-03-27 00:00:00,0
43,34,77,65,12.7,0,Clear,11.3,2021-03-27 01:00:00,1
21,9,30,69,11.9,0,Clear,10.2,2021-03-27 02:00:00,2
10,12,22,69,11.5,0,Clear,9.2,2021-03-27 03:00:00,3
5,9,14,75,10.3,0,Clear,7.6,2021-03-27 04:00:00,4
5,13,18,81,9.3,0,Clear,6.4,2021-03-27 05:00:00,5
27,35,62,81,9.1,0,Clear,7.4,2021-03-27 06:00:00,6
45,93,138,73,10.6,0,Clear,5.2,2021-03-27 07:00:00,7
105,163,268,78,10.1,0,Clear,2.8,2021-03-27 08:00:00,8
248,270,518,71,12.9,0,Clear,2.2,2021-03-27 09:00:00,9
430,365,795,63,15.1,0,Clear,4.5,2021-03-27 10:00:00,10
594,433,1027,58,16.9,0,Clear,5.5,2021-03-27 11:00:00,11
814,459,1273,54,18.5,0,Clear,6.5,2021-03-27 12:00:00,12
990,477,1467,51,19.8,1,Mostly Clear,9.4,2021-03-27 13:00:00,13
1008,457,1465,49,20.7,1,Mostly Clear,10.8,2021-03-27 14:00:00,14
929,453,1382,47,21.6,1,Mostly Clear,12.3,2021-03-27 15:00:00,15
872,448,1320,48,21.3,1,Mostly Clear,14.0,2021-03-27 16:00:00,16
654,361,1015,53,20.1,2,Partly Cloudy,13.5,2021-03-27 17:00:00,17
465,304,769,58,18.5,1,Mostly Clear,12.5,2021-03-27 18:00:00,18
295,232,527,62,16.9,2,Partly Cloudy,13.9,2021-03-27 19:00:00,19
171,134,305,65,15.7,1,Mostly Clear,13.6,2021-03-27 20:00:00,20
163,95,258,68,14.7,1,Mostly Clear,13.5,2021-03-27 21:00:00,21
137,97,234,72,14.0,1,Mostly Clear,14.1,2021-03-27 22:00:00,22
105,84,189,76,13.3,1,Mostly Clear,14.1,2021-03-27 23:00:00,23
126,66,192,80,13.0,1,Mostly Clear,12.3,2021-03-28 00:00:00,0
61,22,83,81,13.0,1,Mostly Clear,11.5,2021-03-28 01:00:00,1
27,18,45,84,12.9,1,Mostly Clear,10.3,2021-03-28 02:00:00,2
11,9,20,86,12.5,1,Mostly Clear,10.6,2021-03-28 03:00:00,3
5,5,10,91,12.1,3,Cloudy,10.4,2021-03-28 04:00:00,4
5,8,13,93,12.1,3,Cloudy,11.3,2021-03-28 05:00:00,5
9,15,24,95,12.4,3,Cloudy,9.8,2021-03-28 06:00:00,6
8,7,15,98,12.8,51,Light Drizzle,10.0,2021-03-28 07:00:00,7
8,30,38,99,13.6,51,Light Drizzle,8.4,2021-03-28 08:00:00,8
14,53,67,98,14.7,51,Light Drizzle,11.1,2021-03-28 09:00:00,9
82,136,218,98,15.9,55,Heavy Drizzle,15.6,2021-03-28 10:00:00,10
141,159,300,95,17.5,51,Light Drizzle,18.4,2021-03-28 11:00:00,11
124,161,285,92,18.9,3,Cloudy,18.2,2021-03-28 12:00:00,12
143,183,326,89,19.9,3,Cloudy,20.1,2021-03-28 13:00:00,13
229,197,426,85,20.6,55,Heavy Drizzle,21.4,2021-03-28 14:00:00,14
296,249,545,90,19.0,51,Light Drizzle,24.0,2021-03-28 15:00:00,15
259,273,532,81,21.2,2,Partly Cloudy,21.0,2021-03-28 16:00:00,16
236,185,421,76,21.8,2,Partly Cloudy,25.0,2021-03-28 17:00:00,17
33,51,84,85,19.3,63,Rain,19.9,2021-03-28 18:00:00,18
53,78,131,82,15.4,61,Light Rain,23.4,2021-03-28 19:00:00,19
60,66,126,71,13.6,51,Light Drizzle,22.5,2021-03-28 20:00:00,20
49,48,97,54,13.5,1,Mostly Clear,26.9,2021-03-28 21:00:00,21
26,38,64,43,13.2,1,Mostly Clear,28.3,2021-03-28 22:00:00,22
23,14,37,43,12.0,0,Clear,28.5,2021-03-28 23:00:00,23
13,11,24,46,10.4,0,Clear,30.6,2021-03-29 00:00:00,0
4,6,10,48,9.3,0,Clear,29.0,2021-03-29 01:00:00,1
1,3,4,49,8.6,0,Clear,26.5,2021-03-29 02:00:00,2
4,0,4,51,7.6,0,Clear,24.3,2021-03-29 03:00:00,3
7,8,15,52,7.1,0,Clear,22.9,2021-03-29 04:00:00,4
9,26,35,52,6.7,0,Clear,21.3,2021-03-29 05:00:00,5
23,61,84,52,6.3,0,Clear,16.3,2021-03-29 06:00:00,6
39,159,198,53,6.0,0,Clear,15.4,2021-03-29 07:00:00,7
66,238,304,56,6.1,0,Clear,14.5,2021-03-29 08:00:00,8
85,152,237,51,6.8,1,Mostly Clear,20.3,2021-03-29 09:00:00,9
105,134,239,49,7.8,1,Mostly Clear,21.0,2021-03-29 10:00:00,10
182,164,346,45,8.9,2,Partly Cloudy,19.1,2021-03-29 11:00:00,11
216,204,420,43,10.2,0,Clear,17.6,2021-03-29 12:00:00,12
224,216,440,40,11.5,0,Clear,17.6,2021-03-29 13:00:00,13
272,207,479,38,12.7,0,Clear,16.7,2021-03-29 14:00:00,14
301,246,547,36,13.8,0,Clear,15.8,2021-03-29 15:00:00,15
297,326,623,34,14.4,0,Clear,14.7,2021-03-29 16:00:00,16
330,496,826,34,14.5,0,Clear,12.0,2021-03-29 17:00:00,17
327,464,791,35,14.1,0,Clear,8.0,2021-03-29 18:00:00,18
223,310,533,46,13.1,0,Clear,4.8,2021-03-29 19:00:00,19
117,182,299,41,12.7,0,Clear,1.3,2021-03-29 20:00:00,20
81,89,170,44,11.8,0,Clear,4.3,2021-03-29 21:00:00,21
48,55,103,61,8.8,0,Clear,5.6,2021-03-29 22:00:00,22
20,28,48,74,6.8,0,Clear,6.3,2021-03-29 23:00:00,23
16,11,27,78,6.0,0,Clear,7.9,2021-03-30 00:00:00,0
10,4,14,79,5.5,0,Clear,8.7,2021-03-30 01:00:00,1
1,4,5,81,5.2,0,Clear,9.2,2021-03-30 02:00:00,2
2,1,3,85,4.8,0,Clear,8.7,2021-03-30 03:00:00,3
8,8,16,88,4.6,0,Clear,8.8,2021-03-30 04:00:00,4
6,24,30,91,4.5,1,Mostly Clear,9.2,2021-03-30 05:00:00,5
64,112,176,94,4.3,0,Clear,8.7,2021-03-30 06:00:00,6
93,201,294,96,4.1,0,Clear,8.4,2021-03-30 07:00:00,7
130,274,404,95,5.5,1,Mostly Clear,10.0,2021-03-30 08:00:00,8
112,178,290,81,9.9,1,Mostly Clear,9.8,2021-03-30 09:00:00,9
177,164,341,69,12.4,1,Mostly Clear,10.8,2021-03-30 10:00:00,10
220,189,409,59,14.5,1,Mostly Clear,11.9,2021-03-30 11:00:00,11
355,272,627,50,16.4,1,Mostly Clear,14.5,2021-03-30 12:00:00,12
300,242,542,44,17.4,0,Clear,16.3,2021-03-30 13:00:00,13
347,273,620,42,18.4,0,Clear,16.9,2021-03-30 14:00:00,14
389,305,694,40,19.1,0,Clear,18.0,2021-03-30 15:00:00,15
459,396,855,39,19.3,0,Clear,18.2,2021-03-30 16:00:00,16
677,629,1306,41,18.9,0,Clear,18.3,2021-03-30 17:00:00,17
650,564,1214,49,17.6,0,Clear,14.4,2021-03-30 18:00:00,18
366,383,749,56,15.3,0,Clear,16.0,2021-03-30 19:00:00,19
204,247,451,61,13.3,1,Mostly Clear,17.1,2021-03-30 20:00:00,20
105,124,229,65,12.3,1,Mostly Clear,16.1,2021-03-30 21:00:00,21
66,92,158,72,11.7,1,Mostly Clear,15.3,2021-03-30 22:00:00,22
48,49,97,78,11.5,1,Mostly Clear,14.5,2021-03-30 23:00:00,23
18,17,35,82,11.5,1,Mostly Clear,14.1,2021-03-31 00:00:00,0
16,1,17,85,11.6,1,Mostly Clear,14.7,2021-03-31 01:00:00,1
1,2,3,86,11.8,1,Mostly Clear,14.9,2021-03-31 02:00:00,2
5,5,10,85,12.6,0,Clear,15.1,2021-03-31 03:00:00,3
9,6,15,87,12.6,0,Clear,14.9,2021-03-31 04:00:00,4
16,19,35,89,12.5,1,Mostly Clear,14.9,2021-03-31 05:00:00,5
46,94,140,90,12.6,1,Mostly Clear,15.7,2021-03-31 06:00:00,6
80,186,266,91,12.6,0,Clear,14.8,2021-03-31 07:00:00,7
105,264,369,90,13.3,3,Cloudy,15.0,2021-03-31 08:00:00,8
103,207,310,86,15.0,3,Cloudy,13.7,2021-03-31 09:00:00,9
92,167,259,81,16.8,3,Cloudy,17.9,2021-03-31 10:00:00,10
148,184,332,79,17.8,3,Cloudy,17.7,2021-03-31 11:00:00,11
106,190,296,80,18.5,53,Heavy Drizzle,16.5,2021-03-31 12:00:00,12
20,64,84,90,18.0,61,Light Rain,12.3,2021-03-31 13:00:00,13
16,34,50,94,17.3,63,Rain,6.6,2021-03-31 14:00:00,14
26,50,76,94,17.4,63,Rain,2.9,2021-03-31 15:00:00,15
24,54,78,95,17.0,63,Rain,1.4,2021-03-31 16:00:00,16
31,104,135,97,16.6,63,Rain,5.2,2021-03-31 17:00:00,17
66,198,264,98,16.3,61,Light Rain,5.2,2021-03-31 18:00:00,18
61,158,219,98,15.9,51,Light Drizzle,3.4,2021-03-31 19:00:00,19
48,95,143,100,15.1,3,Cloudy,3.3,2021-03-31 20:00:00,20
35,64,99,100,14.4,3,Cloudy,3.0,2021-03-31 21:00:00,21
39,39,78,99,14.2,3,Cloudy,4.7,2021-03-31 22:00:00,22
27,37,64,99,14.4,3,Cloudy,12.8,2021-03-31 23:00:00,23
15,8,23,97,13.2,3,Cloudy,19.0,2021-04-01 00:00:00,0
10,2,12,90,10.8,51,Light Drizzle,20.8,2021-04-01 01:00:00,1
3,3,6,86,9.5,51,Light Drizzle,23.3,2021-04-01 02:00:00,2
2,0,2,87,7.7,53,Heavy Drizzle,23.4,2021-04-01 03:00:00,3
4,4,8,89,6.0,53,Heavy Drizzle,22.1,2021-04-01 04:00:00,4
4,8,12,92,4.9,53,Heavy Drizzle,19.6,2021-04-01 05:00:00,5
11,39,50,94,4.2,53,Heavy Drizzle,13.2,2021-04-01 06:00:00,6
36,100,136,94,4.1,51,Light Drizzle,14.9,2021-04-01 07:00:00,7
65,181,246,91,4.4,51,Light Drizzle,11.8,2021-04-01 08:00:00,8
82,150,232,86,5.2,3,Cloudy,15.7,2021-04-01 09:00:00,9
128,155,283,80,6.0,51,Light Drizzle,16.8,2021-04-01 10:00:00,10
144,131,275,75,7.0,53,Heavy Drizzle,18.9,2021-04-01 11:00:00,11
159,168,327,62,8.3,53,Heavy Drizzle,18.1,2021-04-01 12:00:00,12
156,170,326,56,9.2,51,Light Drizzle,18.9,2021-04-01 13:00:00,13
143,149,292,52,9.8,51,Light Drizzle,19.7,2021-04-01 14:00:00,14
147,169,316,49,9.9,51,Light Drizzle,21.0,2021-04-01 15:00:00,15
151,203,354,45,9.1,1,Mostly Clear,26.4,2021-04-01 16:00:00,16
148,283,431,41,8.3,1,Mostly Clear,26.2,2021-04-01 17:00:00,17
133,292,425,36,8.0,1,Mostly Clear,22.7,2021-04-01 18:00:00,18
104,165,269,35,7.1,1,Mostly Clear,22.4,2021-04-01 19:00:00,19
68,122,190,37,6.1,0,Clear,21.6,2021-04-01 20:00:00,20
44,87,131,37,5.3,0,Clear,20.7,2021-04-01 21:00:00,21
41,43,84,36,4.4,0,Clear,20.4,2021-04-01 22:00:00,22
26,38,64,36,3.6,0,Clear,18.9,2021-04-01 23:00:00,23
16,12,28,39,2.9,0,Clear,17.4,2021-04-02 00:00:00,0
4,4,8,43,2.2,0,Clear,17.1,2021-04-02 01:00:00,1
2,3,5,48,1.6,0,Clear,17.7,2021-04-02 02:00:00,2
3,1,4,52,0.4,0,Clear,17.7,2021-04-02 03:00:00,3
5,8,13,54,-0.0,0,Clear,17.4,2021-04-02 04:00:00,4
6,14,20,54,-0.3,0,Clear,16.9,2021-04-02 05:00:00,5
29,52,81,53,-0.6,0,Clear,16.6,2021-04-02 06:00:00,6
42,123,165,53,-0.8,0,Clear,16.5,2021-04-02 07:00:00,7
71,136,207,51,-0.3,0,Clear,17.6,2021-04-02 08:00:00,8
85,140,225,40,0.9,3,Cloudy,22.7,2021-04-02 09:00:00,9
123,151,274,35,2.1,3,Cloudy,24.2,2021-04-02 10:00:00,10
140,160,300,32,3.4,2,Partly Cloudy,23.4,2021-04-02 11:00:00,11
171,165,336,30,4.8,2,Partly Cloudy,23.0,2021-04-02 12:00:00,12
211,195,406,28,6.1,2,Partly Cloudy,23.6,2021-04-02 13:00:00,13
257,179,436,27,6.8,2,Partly Cloudy,23.8,2021-04-02 14:00:00,14
251,215,466,27,6.8,2,Partly Cloudy,24.3,2021-04-02 15:00:00,15
246,243,489,26,7.2,2,Partly Cloudy,24.0,2021-04-02 16:00:00,16
265,276,541,25,7.2,2,Partly Cloudy,23.2,2021-04-02 17:00:00,17
214,296,510,25,7.1,1,Mostly Clear,20.9,2021-04-02 18:00:00,18
132,232,364,26,6.7,0,Clear,14.5,2021-04-02 19:00:00,19
87,120,207,29,5.5,0,Clear,10.7,2021-04-02 20:00:00,20
63,71,134,31,4.5,0,Clear,10.6,2021-04-02 21:00:00,21
49,51,100,32,3.7,0,Clear,12.0,2021-04-02 22:00:00,22
67,57,124,34,3.1,0,Clear,13.0,2021-04-02 23:00:00,23
56,27,83,36,2.4,0,Clear,12.8,2021-04-03 00:00:00,0
24,12,36,39,1.7,0,Clear,12.0,2021-04-03 01:00:00,1
4,8,12,43,0.8,0,Clear,10.9,2021-04-03 02:00:00,2
5,2,7,48,0.1,0,Clear,9.7,2021-04-03 03:00:00,3
5,5,10,54,-0.8,0,Clear,9.8,2021-04-03 04:00:00,4
4,3,7,59,-1.6,0,Clear,9.3,2021-04-03 05:00:00,5
37,23,60,64,-2.2,0,Clear,7.2,2021-04-03 06:00:00,6
37,53,90,69,-2.7,0,Clear,9.0,2021-04-03 07:00:00,7
73,84,157,68,-0.6,0,Clear,10.7,2021-04-03 08:00:00,8
190,191,381,50,2.8,0,Clear,10.4,2021-04-03 09:00:00,9
298,217,515,45,4.6,0,Clear,10.5,2021-04-03 10:00:00,10
513,284,797,39,6.3,0,Clear,9.4,2021-04-03 11:00:00,11
648,299,947,36,7.9,0,Clear,8.5,2021-04-03 12:00:00,12
767,372,1139,33,9.4,0,Clear,8.2,2021-04-03 13:00:00,13
917,333,1250,32,10.6,0,Clear,8.8,2021-04-03 14:00:00,14
821,367,1188,30,11.5,0,Clear,9.7,2021-04-03 15:00:00,15
787,345,1132,29,11.9,0,Clear,9.2,2021-04-03 16:00:00,16
763,316,1079,28,12.1,0,Clear,9.0,2021-04-03 17:00:00,17
512,287,799,29,11.7,0,Clear,6.5,2021-04-03 18:00:00,18
322,193,515,39,10.5,0,Clear,4.6,2021-04-03 19:00:00,19
154,102,256,46,8.7,0,Clear,5.8,2021-04-03 20:00:00,20
107,94,201,49,7.3,0,Clear,7.3,2021-04-03 21:00:00,21
64,70,134,53,6.3,0,Clear,9.0,2021-04-03 22:00:00,22
98,56,154,57,5.6,0,Clear,9.4,2021-04-03 23:00:00,23
52,54,106,60,5.0,1,Mostly Clear,9.1,2021-04-04 00:00:00,0
36,31,67,65,4.4,0,Clear,7.5,2021-04-04 01:00:00,1
14,13,27,69,3.8,0,Clear,7.5,2021-04-04 02:00:00,2
7,2,9,71,3.5,0,Clear,7.9,2021-04-04 03:00:00,3
5,5,10,73,3.1,1,Mostly Clear,7.8,2021-04-04 04:00:00,4
4,6,10,72,3.7,2,Partly Cloudy,8.2,2021-04-04 05:00:00,5
28,36,64,69,4.3,1,Mostly Clear,9.4,2021-04-04 06:00:00,6
41,50,91,71,4.5,1,Mostly Clear,9.4,2021-04-04 07:00:00,7
98,103,201,71,5.5,1,Mostly Clear,10.6,2021-04-04 08:00:00,8
195,145,340,59,8.5,0,Clear,9.9,2021-04-04 09:00:00,9
375,244,619,50,11.8,0,Clear,11.2,2021-04-04 10:00:00,10
513,304,817,45,14.2,0,Clear,14.8,2021-04-04 11:00:00,11
633,339,972,44,16.2,0,Clear,15.9,2021-04-04 12:00:00,12
819,372,1191,43,17.7,0,Clear,16.4,2021-04-04 13:00:00,13
864,374,1238,39,18.7,0,Clear,17.0,2021-04-04 14:00:00,14
903,454,1357,34,20.1,0,Clear,17.5,2021-04-04 15:00:00,15
760,398,1158,33,20.4,0,Clear,19.3,2021-04-04 16:00:00,16
715,349,1064,33,20.1,1,Mostly Clear,17.6,2021-04-04 17:00:00,17
576,295,871,38,19.3,1,Mostly Clear,11.2,2021-04-04 18:00:00,18
367,204,571,43,17.1,0,Clear,10.4,2021-04-04 19:00:00,19
176,119,295,48,14.9,0,Clear,12.3,2021-04-04 20:00:00,20
130,72,202,49,13.5,0,Clear,13.0,2021-04-04 21:00:00,21
80,50,130,50,12.6,0,Clear,13.3,2021-04-04 22:00:00,22
50,31,81,51,11.8,0,Clear,14.5,2021-04-04 23:00:00,23
27,8,35,52,10.8,0,Clear,13.7,2021-04-05 00:00:00,0
13,4,17,56,9.7,0,Clear,12.3,2021-04-05 01:00:00,1
4,3,7,62,8.5,0,Clear,10.6,2021-04-05 02:00:00,2
7,1,8,64,7.8,0,Clear,8.7,2021-04-05 03:00:00,3
10,4,14,70,6.3,0,Clear,8.7,2021-04-05 04:00:00,4
12,23,35,74,5.2,0,Clear,9.0,2021-04-05 05:00:00,5
27,76,103,76,4.5,0,Clear,8.9,2021-04-05 06:00:00,6
60,149,209,79,4.1,0,Clear,9.9,2021-04-05 07:00:00,7
81,223,304,77,6.1,0,Clear,11.1,2021-04-05 08:00:00,8
94,142,236,59,10.6,0,Clear,9.0,2021-04-05 09:00:00,9
175,134,309,50,13.2,0,Clear,9.2,2021-04-05 10:00:00,10
233,182,415,43,15.2,0,Clear,11.5,2021-04-05 11:00:00,11
309,208,517,38,16.6,0,Clear,12.7,2021-04-05 12:00:00,12
344,215,559,35,17.9,0,Clear,13.1,2021-04-05 13:00:00,13
333,210,543,34,19.0,0,Clear,13.2,2021-04-05 14:00:00,14
317,261,578,30,20.6,1,Mostly Clear,13.5,2021-04-05 15:00:00,15
382,346,728,30,20.9,1,Mostly Clear,13.4,2021-04-05 16:00:00,16
404,525,929,32,20.9,1,Mostly Clear,11.9,2021-04-05 17:00:00,17
411,441,852,41,20.0,1,Mostly Clear,6.0,2021-04-05 18:00:00,18
287,324,611,52,18.6,2,Partly Cloudy,2.8,2021-04-05 19:00:00,19
124,145,269,56,17.5,3,Cloudy,1.3,2021-04-05 20:00:00,20
74,99,173,61,16.1,3,Cloudy,0.7,2021-04-05 21:00:00,21
65,64,129,69,14.2,2,Partly Cloudy,5.5,2021-04-05 22:00:00,22
42,46,88,77,12.9,2,Partly Cloudy,5.6,2021-04-05 23:00:00,23
16,28,44,80,11.9,1,Mostly Clear,4.8,2021-04-06 00:00:00,0
21,19,40,75,12.0,1,Mostly Clear,6.1,2021-04-06 01:00:00,1
15,3,18,66,12.4,0,Clear,7.0,2021-04-06 02:00:00,2
4,3,7,73,11.6,1,Mostly Clear,8.8,2021-04-06 03:00:00,3
7,5,12,70,10.7,1,Mostly Clear,11.8,2021-04-06 04:00:00,4
7,31,38,66,10.1,1,Mostly Clear,12.2,2021-04-06 05:00:00,5
26,100,126,65,9.4,1,Mostly Clear,8.6,2021-04-06 06:00:00,6
62,221,283,69,9.0,0,Clear,6.0,2021-04-06 07:00:00,7
105,254,359,74,9.9,0,Clear,5.8,2021-04-06 08:00:00,8
104,201,305,51,12.9,0,Clear,1.8,2021-04-06 09:00:00,9
126,176,302,45,14.5,1,Mostly Clear,3.6,2021-04-06 10:00:00,10
183,198,381,45,15.5,51,Light Drizzle,5.2,2021-04-06 11:00:00,11
241,242,483,43,16.7,0,Clear,2.2,2021-04-06 12:00:00,12
251,265,516,41,18.5,0,Clear,2.1,2021-04-06 13:00:00,13
262,246,508,41,20.0,0,Clear,4.0,2021-04-06 14:00:00,14
290,249,539,39,22.0,0,Clear,5.2,2021-04-06 15:00:00,15
325,343,668,39,22.7,0,Clear,5.9,2021-04-06 16:00:00,16
383,551,934,40,22.9,1,Mostly Clear,7.3,2021-04-06 17:00:00,17
437,450,887,46,21.9,1,Mostly Clear,4.1,2021-04-06 18:00:00,18
297,344,641,56,19.9,0,Clear,5.6,2021-04-06 19:00:00,19
157,214,371,61,17.5,0,Clear,7.9,2021-04-06 20:00:00,20
105,130,235,65,15.8,1,Mostly Clear,7.3,2021-04-06 21:00:00,21
74,84,158,69,14.4,1,Mostly Clear,6.7,2021-04-06 22:00:00,22
32,50,82,75,13.3,1,Mostly Clear,7.0,2021-04-06 23:00:00,23
22,17,39,81,12.3,1,Mostly Clear,6.6,2021-04-07 00:00:00,0
12,4,16,86,11.5,1,Mostly Clear,6.4,2021-04-07 01:00:00,1
5,6,11,88,11.0,2,Partly Cloudy,6.9,2021-04-07 02:00:00,2
4,5,9,66,13.1,1,Mostly Clear,3.4,2021-04-07 03:00:00,3
4,6,10,77,11.3,0,Clear,4.0,2021-04-07 04:00:00,4
9,21,30,85,9.8,0,Clear,5.8,2021-04-07 05:00:00,5
24,89,113,87,9.2,0,Clear,5.6,2021-04-07 06:00:00,6
60,186,246,85,9.1,0,Clear,5.7,2021-04-07 07:00:00,7
91,310,401,80,11.4,0,Clear,5.1,2021-04-07 08:00:00,8
90,188,278,66,14.8,0,Clear,2.5,2021-04-07 09:00:00,9
149,173,322,57,17.3,0,Clear,3.7,2021-04-07 10:00:00,10
205,188,393,54,19.7,1,Mostly Clear,2.4,2021-04-07 11:00:00,11
233,266,499,51,21.8,1,Mostly Clear,0.8,2021-04-07 12:00:00,12
264,262,526,49,23.4,1,Mostly Clear,1.8,2021-04-07 13:00:00,13
257,242,499,47,24.4,1,Mostly Clear,3.6,2021-04-07 14:00:00,14
294,298,592,43,25.3,1,Mostly Clear,5.6,2021-04-07 15:00:00,15
325,325,650,42,25.2,1,Mostly Clear,4.5,2021-04-07 16:00:00,16
376,552,928,45,24.6,1,Mostly Clear,5.2,2021-04-07 17:00:00,17
351,480,831,50,23.8,1,Mostly Clear,6.9,2021-04-07 18:00:00,18
265,314,579,60,21.5,1,Mostly Clear,10.2,2021-04-07 19:00:00,19
164,227,391,66,19.1,1,Mostly Clear,11.9,2021-04-07 20:00:00,20
98,140,238,67,17.5,1,Mostly Clear,11.7,2021-04-07 21:00:00,21
108,94,202,69,15.9,1,Mostly Clear,11.9,2021-04-07 22:00:00,22
51,43,94,69,14.8,1,Mostly Clear,12.0,2021-04-07 23:00:00,23
34,25,59,69,13.7,1,Mostly Clear,11.4,2021-04-08 00:00:00,0
11,7,18,66,13.0,1,Mostly Clear,11.6,2021-04-08 01:00:00,1
7,6,13,65,12.4,1,Mostly Clear,11.6,2021-04-08 02:00:00,2
5,1,6,61,12.6,1,Mostly Clear,10.0,2021-04-08 03:00:00,3
11,10,21,63,12.3,51,Light Drizzle,10.1,2021-04-08 04:00:00,4
9,22,31,66,11.7,1,Mostly Clear,10.7,2021-04-08 05:00:00,5
25,93,118,68,11.3,1,Mostly Clear,7.1,2021-04-08 06:00:00,6
65,170,235,73,10.7,1,Mostly Clear,7.5,2021-04-08 07:00:00,7
84,262,346,73,11.7,1,Mostly Clear,8.5,2021-04-08 08:00:00,8
104,205,309,66,13.3,0,Clear,9.3,2021-04-08 09:00:00,9
118,164,282,61,15.1,0,Clear,11.4,2021-04-08 10:00:00,10
197,190,387,58,16.9,1,Mostly Clear,13.4,2021-04-08 11:00:00,11
229,223,452,56,17.8,0,Clear,15.5,2021-04-08 12:00:00,12
287,239,526,53,18.9,0,Clear,15.9,2021-04-08 13:00:00,13
277,253,530,52,19.3,0,Clear,16.5,2021-04-08 14:00:00,14
276,284,560,49,20.1,1,Mostly Clear,17.3,2021-04-08 15:00:00,15
300,355,655,50,19.9,1,Mostly Clear,17.6,2021-04-08 16:00:00,16
357,531,888,51,19.5,1,Mostly Clear,17.8,2021-04-08 17:00:00,17
355,498,853,55,18.4,1,Mostly Clear,14.8,2021-04-08 18:00:00,18
244,391,635,60,16.9,1,Mostly Clear,13.8,2021-04-08 19:00:00,19
122,237,359,64,15.3,1,Mostly Clear,13.5,2021-04-08 20:00:00,20
95,140,235,67,14.0,1,Mostly Clear,13.9,2021-04-08 21:00:00,21
85,86,171,71,13.2,1,Mostly Clear,14.0,2021-04-08 22:00:00,22
61,41,102,73,12.7,1,Mostly Clear,14.5,2021-04-08 23:00:00,23
35,24,59,76,12.2,1,Mostly Clear,13.3,2021-04-09 00:00:00,0
8,5,13,79,11.9,2,Partly Cloudy,12.0,2021-04-09 01:00:00,1
6,4,10,83,11.5,3,Cloudy,11.8,2021-04-09 02:00:00,2
4,3,7,83,11.6,51,Light Drizzle,10.2,2021-04-09 03:00:00,3
3,7,10,91,11.0,53,Heavy Drizzle,10.0,2021-04-09 04:00:00,4
2,8,10,93,10.9,61,Light Rain,11.3,2021-04-09 05:00:00,5
17,47,64,94,10.7,61,Light Rain,10.1,2021-04-09 06:00:00,6
36,137,173,95,10.7,51,Light Drizzle,10.6,2021-04-09 07:00:00,7
57,195,252,95,11.3,3,Cloudy,9.5,2021-04-09 08:00:00,8
68,162,230,87,12.5,3,Cloudy,8.4,2021-04-09 09:00:00,9
85,160,245,87,13.1,3,Cloudy,9.9,2021-04-09 10:00:00,10
115,181,296,84,13.9,3,Cloudy,13.2,2021-04-09 11:00:00,11
194,205,399,81,14.6,3,Cloudy,13.7,2021-04-09 12:00:00,12
198,221,419,80,15.2,3,Cloudy,15.6,2021-04-09 13:00:00,13
210,231,441,77,16.2,3,Cloudy,15.0,2021-04-09 14:00:00,14
254,303,557,86,16.2,55,Heavy Drizzle,13.9,2021-04-09 15:00:00,15
226,309,535,89,16.1,61,Light Rain,14.4,2021-04-09 16:00:00,16
139,324,463,91,16.0,61,Light Rain,11.4,2021-04-09 17:00:00,17
160,325,485,93,15.8,55,Heavy Drizzle,9.0,2021-04-09 18:00:00,18
142,235,377,94,15.3,3,Cloudy,9.6,2021-04-09 19:00:00,19
110,147,257,95,14.7,51,Light Drizzle,9.0,2021-04-09 20:00:00,20
109,102,211,96,14.2,61,Light Rain,10.0,2021-04-09 21:00:00,21
60,94,154,96,14.0,61,Light Rain,10.1,2021-04-09 22:00:00,22
85,79,164,97,13.7,3,Cloudy,9.5,2021-04-09 23:00:00,23
62,43,105,97,13.4,3,Cloudy,8.5,2021-04-10 00:00:00,0
32,25,57,98,13.1,3,Cloudy,7.4,2021-04-10 01:00:00,1
21,14,35,98,12.9,3,Cloudy,8.1,2021-04-10 02:00:00,2
5,9,14,97,12.4,3,Cloudy,8.4,2021-04-10 03:00:00,3
4,6,10,97,12.5,3,Cloudy,7.4,2021-04-10 04:00:00,4
6,8,14,97,12.5,3,Cloudy,7.8,2021-04-10 05:00:00,5
20,35,55,97,12.5,3,Cloudy,6.4,2021-04-10 06:00:00,6
36,77,113,97,12.6,3,Cloudy,7.6,2021-04-10 07:00:00,7
89,139,228,96,13.0,3,Cloudy,8.4,2021-04-10 08:00:00,8
157,251,408,93,13.7,3,Cloudy,8.4,2021-04-10 09:00:00,9
274,240,514,92,14.4,3,Cloudy,7.9,2021-04-10 10:00:00,10
412,302,714,91,15.4,3,Cloudy,7.8,2021-04-10 11:00:00,11
518,379,897,90,16.5,3,Cloudy,10.1,2021-04-10 12:00:00,12
666,424,1090,87,17.5,3,Cloudy,9.4,2021-04-10 13:00:00,13
741,377,1118,77,19.3,3,Cloudy,8.4,2021-04-10 14:00:00,14
708,404,1112,71,19.7,3,Cloudy,7.6,2021-04-10 15:00:00,15
687,380,1067,68,20.5,3,Cloudy,7.8,2021-04-10 16:00:00,16
642,398,1040,66,20.7,3,Cloudy,8.2,2021-04-10 17:00:00,17
520,353,873,69,20.2,2,Partly Cloudy,6.3,2021-04-10 18:00:00,18
379,308,687,77,18.6,2,Partly Cloudy,9.0,2021-04-10 19:00:00,19
244,173,417,84,17.0,1,Mostly Clear,12.0,2021-04-10 20:00:00,20
177,155,332,89,16.0,1,Mostly Clear,11.9,2021-04-10 21:00:00,21
180,123,303,92,15.6,3,Cloudy,10.6,2021-04-10 22:00:00,22
139,87,226,93,15.4,3,Cloudy,10.9,2021-04-10 23:00:00,23
83,45,128,92,15.1,51,Light Drizzle,11.5,2021-04-11 00:00:00,0
25,17,42,94,14.6,53,Heavy Drizzle,11.0,2021-04-11 01:00:00,1
15,12,27,97,14.4,53,Heavy Drizzle,11.8,2021-04-11 02:00:00,2
4,6,10,97,14.7,55,Heavy Drizzle,13.0,2021-04-11 03:00:00,3
3,3,6,97,14.9,61,Light Rain,15.0,2021-04-11 04:00:00,4
2,8,10,97,15.4,61,Light Rain,17.6,2021-04-11 05:00:00,5
10,24,34,97,15.8,61,Light Rain,13.3,2021-04-11 06:00:00,6
17,33,50,98,16.1,53,Heavy Drizzle,14.5,2021-04-11 07:00:00,7
69,93,162,98,16.4,53,Heavy Drizzle,14.5,2021-04-11 08:00:00,8
203,202,405,97,17.0,51,Light Drizzle,14.1,2021-04-11 09:00:00,9
286,271,557,90,18.4,1,Mostly Clear,16.2,2021-04-11 10:00:00,10
443,351,794,76,20.3,0,Clear,13.7,2021-04-11 11:00:00,11
593,403,996,63,22.0,0,Clear,12.5,2021-04-11 12:00:00,12
634,403,1037,54,23.4,0,Clear,11.4,2021-04-11 13:00:00,13
604,436,1040,50,24.0,1,Mostly Clear,9.2,2021-04-11 14:00:00,14
691,468,1159,43,24.6,1,Mostly Clear,10.6,2021-04-11 15:00:00,15
556,411,967,44,24.3,1,Mostly Clear,12.1,2021-04-11 16:00:00,16
436,352,788,45,24.0,0,Clear,11.3,2021-04-11 17:00:00,17
234,271,505,49,23.4,1,Mostly Clear,6.6,2021-04-11 18:00:00,18
193,209,402,56,21.9,1,Mostly Clear,6.6,2021-04-11 19:00:00,19
70,109,179,62,19.9,1,Mostly Clear,8.1,2021-04-11 20:00:00,20
63,80,143,70,18.4,1,Mostly Clear,4.4,2021-04-11 21:00:00,21
73,48,121,70,17.3,1,Mostly Clear,8.9,2021-04-11 22:00:00,22
61,33,94,69,16.7,0,Clear,14.4,2021-04-11 23:00:00,23
33,24,57,67,16.3,0,Clear,14.4,2021-04-12 00:00:00,0
18,5,23,68,16.0,1,Mostly Clear,11.7,2021-04-12 01:00:00,1
2,3,5,71,15.6,2,Partly Cloudy,9.1,2021-04-12 02:00:00,2
9,5,14,85,15.4,2,Partly Cloudy,8.4,2021-04-12 03:00:00,3
8,10,18,91,14.7,2,Partly Cloudy,6.6,2021-04-12 04:00:00,4
14,27,41,96,13.8,2,Partly Cloudy,4.7,2021-04-12 05:00:00,5
35,71,106,98,13.1,3,Cloudy,7.1,2021-04-12 06:00:00,6
45,171,216,99,12.6,3,Cloudy,9.1,2021-04-12 07:00:00,7
78,236,314,96,13.3,3,Cloudy,9.6,2021-04-12 08:00:00,8
82,180,262,91,14.0,3,Cloudy,9.3,2021-04-12 09:00:00,9
102,169,271,80,15.5,3,Cloudy,9.6,2021-04-12 10:00:00,10
148,207,355,70,16.9,3,Cloudy,9.6,2021-04-12 11:00:00,11
133,204,337,66,17.7,3,Cloudy,10.1,2021-04-12 12:00:00,12
77,169,246,63,18.2,3,Cloudy,10.8,2021-04-12 13:00:00,13
113,176,289,64,17.9,51,Light Drizzle,9.0,2021-04-12 14:00:00,14
117,180,297,74,15.4,51,Light Drizzle,8.3,2021-04-12 15:00:00,15
179,244,423,74,15.2,51,Light Drizzle,8.7,2021-04-12 16:00:00,16
191,373,564,73,15.4,2,Partly Cloudy,8.6,2021-04-12 17:00:00,17
151,325,476,74,14.7,2,Partly Cloudy,11.0,2021-04-12 18:00:00,18
123,254,377,75,14.2,3,Cloudy,10.8,2021-04-12 19:00:00,19
54,139,193,78,13.5,3,Cloudy,10.0,2021-04-12 20:00:00,20
44,56,100,80,12.5,51,Light Drizzle,8.9,2021-04-12 21:00:00,21
19,27,46,83,11.7,51,Light Drizzle,7.6,2021-04-12 22:00:00,22
19,31,50,87,10.9,51,Light Drizzle,5.4,2021-04-12 23:00:00,23
20,13,33,90,10.4,51,Light Drizzle,3.8,2021-04-13 00:00:00,0
8,5,13,89,10.1,3,Cloudy,6.1,2021-04-13 01:00:00,1
8,1,9,88,10.1,3,Cloudy,5.3,2021-04-13 02:00:00,2
4,0,4,87,10.1,3,Cloudy,4.1,2021-04-13 03:00:00,3
8,13,21,86,10.1,3,Cloudy,3.8,2021-04-13 04:00:00,4
9,32,41,85,10.2,3,Cloudy,3.4,2021-04-13 05:00:00,5
18,102,120,84,10.2,3,Cloudy,2.3,2021-04-13 06:00:00,6
45,146,191,86,10.2,3,Cloudy,1.5,2021-04-13 07:00:00,7
73,269,342,86,10.5,3,Cloudy,1.9,2021-04-13 08:00:00,8
84,206,290,83,11.4,3,Cloudy,2.3,2021-04-13 09:00:00,9
107,144,251,77,12.7,3,Cloudy,5.5,2021-04-13 10:00:00,10
121,198,319,65,14.6,51,Light Drizzle,8.4,2021-04-13 11:00:00,11
120,222,342,62,15.3,3,Cloudy,10.1,2021-04-13 12:00:00,12
153,206,359,60,15.8,3,Cloudy,9.7,2021-04-13 13:00:00,13
131,235,366,58,16.4,3,Cloudy,10.1,2021-04-13 14:00:00,14
185,265,450,57,17.3,3,Cloudy,7.8,2021-04-13 15:00:00,15
163,298,461,57,17.4,3,Cloudy,5.9,2021-04-13 16:00:00,16
282,512,794,56,17.7,3,Cloudy,4.9,2021-04-13 17:00:00,17
255,489,744,56,17.7,1,Mostly Clear,6.4,2021-04-13 18:00:00,18
235,315,550,64,16.6,1,Mostly Clear,5.8,2021-04-13 19:00:00,19
109,228,337,73,14.6,1,Mostly Clear,8.0,2021-04-13 20:00:00,20
65,99,164,79,13.2,1,Mostly Clear,7.9,2021-04-13 21:00:00,21
54,84,138,84,12.2,0,Clear,7.3,2021-04-13 22:00:00,22
43,44,87,88,11.4,0,Clear,8.6,2021-04-13 23:00:00,23
27,16,43,91,10.9,0,Clear,9.8,2021-04-14 00:00:00,0
13,5,18,93,10.4,0,Clear,8.6,2021-04-14 01:00:00,1
7,2,9,95,10.0,0,Clear,7.0,2021-04-14 02:00:00,2
6,2,8,96,9.5,0,Clear,6.1,2021-04-14 03:00:00,3
6,11,17,97,8.9,0,Clear,6.1,2021-04-14 04:00:00,4
9,25,34,97,8.6,0,Clear,7.5,2021-04-14 05:00:00,5
25,91,116,98,8.4,1,Mostly Clear,7.4,2021-04-14 06:00:00,6
56,162,218,98,8.8,2,Partly Cloudy,7.5,2021-04-14 07:00:00,7
73,273,346,94,10.9,1,Mostly Clear,8.0,2021-04-14 08:00:00,8
68,201,269,83,13.5,1,Mostly Clear,8.1,2021-04-14 09:00:00,9
107,179,286,76,15.4,2,Partly Cloudy,9.4,2021-04-14 10:00:00,10
68,140,208,67,17.8,3,Cloudy,11.2,2021-04-14 11:00:00,11
56,119,175,68,18.0,51,Light Drizzle,10.0,2021-04-14 12:00:00,12
61,111,172,78,17.0,53,Heavy Drizzle,6.2,2021-04-14 13:00:00,13
64,104,168,84,16.7,51,Light Drizzle,5.7,2021-04-14 14:00:00,14
36,101,137,90,15.5,53,Heavy Drizzle,4.8,2021-04-14 15:00:00,15
41,84,125,92,15.4,53,Heavy Drizzle,5.9,2021-04-14 16:00:00,16
59,142,201,91,15.5,53,Heavy Drizzle,4.5,2021-04-14 17:00:00,17
36,149,185,93,15.2,53,Heavy Drizzle,5.0,2021-04-14 18:00:00,18
27,96,123,95,14.9,55,Heavy Drizzle,3.9,2021-04-14 19:00:00,19
15,58,73,96,14.4,53,Heavy Drizzle,4.2,2021-04-14 20:00:00,20
14,47,61,98,13.9,53,Heavy Drizzle,5.1,2021-04-14 21:00:00,21
24,45,69,99,13.5,53,Heavy Drizzle,7.6,2021-04-14 22:00:00,22
34,20,54,99,13.0,53,Heavy Drizzle,8.4,2021-04-14 23:00:00,23
14,7,21,98,12.6,53,Heavy Drizzle,6.2,2021-04-15 00:00:00,0
6,5,11,97,12.2,53,Heavy Drizzle,5.7,2021-04-15 01:00:00,1
2,5,7,97,12.0,3,Cloudy,5.8,2021-04-15 02:00:00,2
3,2,5,99,11.8,3,Cloudy,5.2,2021-04-15 03:00:00,3
5,13,18,99,11.7,3,Cloudy,6.5,2021-04-15 04:00:00,4
10,30,40,99,11.5,3,Cloudy,6.6,2021-04-15 05:00:00,5
24,70,94,99,11.5,3,Cloudy,6.9,2021-04-15 06:00:00,6
61,147,208,99,11.3,3,Cloudy,8.7,2021-04-15 07:00:00,7
78,276,354,94,11.6,1,Mostly Clear,10.0,2021-04-15 08:00:00,8
99,218,317,86,12.1,1,Mostly Clear,10.7,2021-04-15 09:00:00,9
106,176,282,76,13.7,1,Mostly Clear,11.1,2021-04-15 10:00:00,10
147,227,374,66,15.5,1,Mostly Clear,11.3,2021-04-15 11:00:00,11
163,269,432,55,17.1,1,Mostly Clear,13.4,2021-04-15 12:00:00,12
170,275,445,49,17.8,1,Mostly Clear,16.3,2021-04-15 13:00:00,13
221,231,452,47,18.2,1,Mostly Clear,18.6,2021-04-15 14:00:00,14
227,238,465,44,17.8,0,Clear,19.2,2021-04-15 15:00:00,15
214,345,559,42,17.1,0,Clear,19.7,2021-04-15 16:00:00,16
369,529,898,41,16.8,0,Clear,20.5,2021-04-15 17:00:00,17
280,457,737,41,15.9,0,Clear,21.7,2021-04-15 18:00:00,18
186,341,527,42,14.3,2,Partly Cloudy,20.7,2021-04-15 19:00:00,19
96,176,272,42,12.8,1,Mostly Clear,20.2,2021-04-15 20:00:00,20
69,128,197,43,11.6,0,Clear,18.6,2021-04-15 21:00:00,21
68,97,165,45,10.6,0,Clear,17.0,2021-04-15 22:00:00,22
65,66,131,47,9.7,0,Clear,16.2,2021-04-15 23:00:00,23
30,30,60,49,9.0,0,Clear,14.2,2021-04-16 00:00:00,0
12,8,20,50,8.5,0,Clear,12.6,2021-04-16 01:00:00,1
4,5,9,53,8.0,0,Clear,12.2,2021-04-16 02:00:00,2
4,11,15,58,7.1,0,Clear,12.2,2021-04-16 03:00:00,3
3,12,15,60,6.7,0,Clear,12.6,2021-04-16 04:00:00,4
6,16,22,64,6.3,0,Clear,13.0,2021-04-16 05:00:00,5
22,70,92,67,5.9,0,Clear,7.2,2021-04-16 06:00:00,6
38,146,184,71,5.7,0,Clear,8.2,2021-04-16 07:00:00,7
76,230,306,70,6.8,1,Mostly Clear,8.9,2021-04-16 08:00:00,8
83,180,263,64,8.4,1,Mostly Clear,12.7,2021-04-16 09:00:00,9
128,161,289,61,9.7,3,Cloudy,18.9,2021-04-16 10:00:00,10
116,193,309,59,10.5,3,Cloudy,18.6,2021-04-16 11:00:00,11
146,208,354,55,11.5,2,Partly Cloudy,21.0,2021-04-16 12:00:00,12
179,227,406,49,12.8,2,Partly Cloudy,22.6,2021-04-16 13:00:00,13
195,238,433,46,13.8,51,Light Drizzle,23.3,2021-04-16 14:00:00,14
213,258,471,43,14.6,2,Partly Cloudy,25.4,2021-04-16 15:00:00,15
234,322,556,42,14.7,2,Partly Cloudy,24.1,2021-04-16 16:00:00,16
243,423,666,44,14.4,1,Mostly Clear,22.5,2021-04-16 17:00:00,17
246,395,641,45,14.1,1,Mostly Clear,17.9,2021-04-16 18:00:00,18
183,295,478,47,13.3,0,Clear,16.2,2021-04-16 19:00:00,19
75,190,265,49,12.3,0,Clear,15.8,2021-04-16 20:00:00,20
73,112,185,51,11.4,0,Clear,15.9,2021-04-16 21:00:00,21
62,104,166,54,10.7,0,Clear,15.8,2021-04-16 22:00:00,22
72,97,169,57,10.1,0,Clear,15.1,2021-04-16 23:00:00,23
65,54,119,60,9.4,0,Clear,14.3,2021-04-17 00:00:00,0
25,33,58,63,8.7,0,Clear,12.9,2021-04-17 01:00:00,1
16,21,37,66,8.1,0,Clear,12.3,2021-04-17 02:00:00,2
6,13,19,69,7.5,0,Clear,11.8,2021-04-17 03:00:00,3
2,4,6,72,7.1,0,Clear,11.1,2021-04-17 04:00:00,4
5,12,17,75,6.6,0,Clear,10.4,2021-04-17 05:00:00,5
19,35,54,79,6.0,0,Clear,7.8,2021-04-17 06:00:00,6
21,67,88,83,5.6,0,Clear,7.5,2021-04-17 07:00:00,7
58,134,192,78,7.3,0,Clear,7.3,2021-04-17 08:00:00,8
150,209,359,66,9.2,0,Clear,9.7,2021-04-17 09:00:00,9
261,302,563,64,10.3,2,Partly Cloudy,10.8,2021-04-17 10:00:00,10
342,338,680,61,11.5,3,Cloudy,8.6,2021-04-17 11:00:00,11
431,404,835,58,12.4,3,Cloudy,7.7,2021-04-17 12:00:00,12
448,388,836,55,13.4,3,Cloudy,9.2,2021-04-17 13:00:00,13
550,355,905,53,13.6,3,Cloudy,10.8,2021-04-17 14:00:00,14
470,364,834,52,14.2,3,Cloudy,11.3,2021-04-17 15:00:00,15
479,373,852,52,14.2,3,Cloudy,10.6,2021-04-17 16:00:00,16
384,326,710,53,14.1,3,Cloudy,8.9,2021-04-17 17:00:00,17
353,344,697,55,13.8,3,Cloudy,7.3,2021-04-17 18:00:00,18
247,247,494,60,13.2,2,Partly Cloudy,5.6,2021-04-17 19:00:00,19
170,183,353,66,12.3,2,Partly Cloudy,5.9,2021-04-17 20:00:00,20
116,97,213,71,11.2,2,Partly Cloudy,6.9,2021-04-17 21:00:00,21
144,119,263,73,10.5,2,Partly Cloudy,6.8,2021-04-17 22:00:00,22
147,95,242,75,9.6,0,Clear,6.0,2021-04-17 23:00:00,23
98,50,148,78,8.9,0,Clear,6.3,2021-04-18 00:00:00,0
63,34,97,81,8.0,0,Clear,6.8,2021-04-18 01:00:00,1
24,15,39,84,7.0,0,Clear,7.3,2021-04-18 02:00:00,2
16,8,24,85,6.5,0,Clear,7.1,2021-04-18 03:00:00,3
7,1,8,87,5.8,0,Clear,6.7,2021-04-18 04:00:00,4
10,14,24,88,5.1,0,Clear,7.1,2021-04-18 05:00:00,5
9,32,41,89,4.6,0,Clear,6.2,2021-04-18 06:00:00,6
31,44,75,90,4.5,0,Clear,6.9,2021-04-18 07:00:00,7
75,133,208,81,7.8,0,Clear,6.2,2021-04-18 08:00:00,8
136,203,339,67,10.8,0,Clear,5.6,2021-04-18 09:00:00,9
293,271,564,58,12.8,0,Clear,5.0,2021-04-18 10:00:00,10
358,314,672,53,14.4,0,Clear,5.5,2021-04-18 11:00:00,11
393,370,763,48,15.7,0,Clear,5.0,2021-04-18 12:00:00,12
547,395,942,43,16.7,0,Clear,5.9,2021-04-18 13:00:00,13
591,430,1021,42,17.2,0,Clear,7.6,2021-04-18 14:00:00,14
522,445,967,40,17.6,2,Partly Cloudy,9.7,2021-04-18 15:00:00,15
440,366,806,39,17.8,1,Mostly Clear,10.5,2021-04-18 16:00:00,16
345,337,682,41,17.4,1,Mostly Clear,11.0,2021-04-18 17:00:00,17
250,246,496,47,16.5,1,Mostly Clear,10.1,2021-04-18 18:00:00,18
174,193,367,54,15.6,0,Clear,6.8,2021-04-18 19:00:00,19
137,120,257,64,14.1,0,Clear,7.1,2021-04-18 20:00:00,20
98,93,191,74,12.2,0,Clear,7.1,2021-04-18 21:00:00,21
58,56,114,75,11.3,1,Mostly Clear,7.7,2021-04-18 22:00:00,22
52,39,91,82,9.9,1,Mostly Clear,7.3,2021-04-18 23:00:00,23
36,16,52,84,9.1,0,Clear,7.1,2021-04-19 00:00:00,0
10,4,14,85,8.7,0,Clear,6.4,2021-04-19 01:00:00,1
9,5,14,87,8.5,0,Clear,7.9,2021-04-19 02:00:00,2
2,2,4,87,8.3,0,Clear,6.9,2021-04-19 03:00:00,3
9,10,19,86,8.5,0,Clear,7.1,2021-04-19 04:00:00,4
8,30,38,87,8.1,0,Clear,7.3,2021-04-19 05:00:00,5
26,76,102,88,7.7,1,Mostly Clear,4.8,2021-04-19 06:00:00,6
51,144,195,88,8.2,2,Partly Cloudy,5.7,2021-04-19 07:00:00,7
80,242,322,87,10.2,3,Cloudy,6.7,2021-04-19 08:00:00,8
68,167,235,76,12.6,3,Cloudy,5.5,2021-04-19 09:00:00,9
55,89,144,75,13.2,2,Partly Cloudy,6.6,2021-04-19 10:00:00,10
67,115,182,72,14.0,3,Cloudy,8.0,2021-04-19 11:00:00,11
99,155,254,65,14.7,3,Cloudy,9.7,2021-04-19 12:00:00,12
118,162,280,61,15.0,3,Cloudy,8.7,2021-04-19 13:00:00,13
155,199,354,58,15.8,2,Partly Cloudy,7.7,2021-04-19 14:00:00,14
173,216,389,58,16.0,1,Mostly Clear,7.6,2021-04-19 15:00:00,15
191,277,468,57,16.3,1,Mostly Clear,6.9,2021-04-19 16:00:00,16
274,445,719,56,16.4,0,Clear,8.4,2021-04-19 17:00:00,17
255,404,659,57,16.0,0,Clear,9.8,2021-04-19 18:00:00,18
153,302,455,62,15.0,0,Clear,9.5,2021-04-19 19:00:00,19
82,183,265,69,13.6,0,Clear,8.4,2021-04-19 20:00:00,20
47,117,164,74,12.2,0,Clear,9.4,2021-04-19 21:00:00,21
68,64,132,80,11.1,0,Clear,9.1,2021-04-19 22:00:00,22
34,38,72,86,10.0,0,Clear,9.4,2021-04-19 23:00:00,23
16,12,28,89,9.2,0,Clear,10.1,2021-04-20 00:00:00,0
5,8,13,89,8.8,0,Clear,10.7,2021-04-20 01:00:00,1
4,5,9,89,8.7,0,Clear,11.2,2021-04-20 02:00:00,2
4,0,4,83,8.3,0,Clear,11.0,2021-04-20 03:00:00,3
7,8,15,84,8.0,0,Clear,10.5,2021-04-20 04:00:00,4
5,37,42,86,7.7,0,Clear,10.2,2021-04-20 05:00:00,5
24,95,119,87,7.5,0,Clear,9.5,2021-04-20 06:00:00,6
54,184,238,87,7.6,0,Clear,10.2,2021-04-20 07:00:00,7
84,288,372,81,10.3,1,Mostly Clear,10.7,2021-04-20 08:00:00,8
113,217,330,67,14.0,0,Clear,8.7,2021-04-20 09:00:00,9
128,198,326,58,16.9,0,Clear,8.7,2021-04-20 10:00:00,10
140,195,335,51,19.3,0,Clear,10.7,2021-04-20 11:00:00,11
189,293,482,42,21.0,0,Clear,12.1,2021-04-20 12:00:00,12
215,273,488,38,21.9,0,Clear,13.0,2021-04-20 13:00:00,13
210,253,463,36,22.5,0,Clear,14.5,2021-04-20 14:00:00,14
242,299,541,34,23.0,0,Clear,14.9,2021-04-20 15:00:00,15
269,380,649,34,23.0,0,Clear,16.3,2021-04-20 16:00:00,16
410,556,966,35,22.7,0,Clear,16.5,2021-04-20 17:00:00,17
400,558,958,40,21.7,0,Clear,13.1,2021-04-20 18:00:00,18
257,406,663,47,19.9,0,Clear,14.0,2021-04-20 19:00:00,19
148,222,370,54,17.8,0,Clear,15.2,2021-04-20 20:00:00,20
102,147,249,58,16.5,0,Clear,15.7,2021-04-20 21:00:00,21
74,112,186,60,15.8,0,Clear,15.9,2021-04-20 22:00:00,22
57,69,126,59,15.4,0,Clear,17.7,2021-04-20 23:00:00,23
18,34,52,57,15.3,0,Clear,18.5,2021-04-21 00:00:00,0
11,13,24,57,14.8,0,Clear,18.5,2021-04-21 01:00:00,1
2,3,5,59,14.3,0,Clear,18.2,2021-04-21 02:00:00,2
3,5,8,56,14.4,0,Clear,17.7,2021-04-21 03:00:00,3
9,11,20,58,14.1,0,Clear,17.4,2021-04-21 04:00:00,4
9,23,32,61,13.7,0,Clear,16.6,2021-04-21 05:00:00,5
28,86,114,64,13.2,0,Clear,14.3,2021-04-21 06:00:00,6
59,181,240,68,13.0,0,Clear,14.1,2021-04-21 07:00:00,7
85,286,371,70,14.0,0,Clear,14.2,2021-04-21 08:00:00,8
82,199,281,66,15.8,1,Mostly Clear,14.0,2021-04-21 09:00:00,9
100,156,256,61,17.4,2,Partly Cloudy,14.9,2021-04-21 10:00:00,10
116,185,301,58,18.2,2,Partly Cloudy,15.4,2021-04-21 11:00:00,11
102,219,321,60,16.6,51,Light Drizzle,21.8,2021-04-21 12:00:00,12
94,150,244,51,16.0,2,Partly Cloudy,25.0,2021-04-21 13:00:00,13
101,164,265,45,14.8,0,Clear,27.9,2021-04-21 14:00:00,14
122,220,342,42,13.6,0,Clear,29.4,2021-04-21 15:00:00,15
113,255,368,39,12.7,0,Clear,29.6,2021-04-21 16:00:00,16
150,336,486,38,11.6,0,Clear,28.7,2021-04-21 17:00:00,17
143,325,468,37,10.6,0,Clear,26.2,2021-04-21 18:00:00,18
96,258,354,34,9.6,0,Clear,23.6,2021-04-21 19:00:00,19
70,117,187,35,8.7,0,Clear,19.9,2021-04-21 20:00:00,20
54,103,157,35,7.9,0,Clear,19.7,2021-04-21 21:00:00,21
38,64,102,36,7.3,0,Clear,19.1,2021-04-21 22:00:00,22
38,36,74,38,6.6,0,Clear,20.1,2021-04-21 23:00:00,23
12,11,23,39,5.9,0,Clear,20.8,2021-04-22 00:00:00,0
2,8,10,39,5.3,0,Clear,19.8,2021-04-22 01:00:00,1
0,2,2,40,4.6,0,Clear,18.4,2021-04-22 02:00:00,2
2,3,5,42,3.9,0,Clear,16.4,2021-04-22 03:00:00,3
4,7,11,45,3.6,0,Clear,14.1,2021-04-22 04:00:00,4
6,22,28,48,3.2,0,Clear,12.4,2021-04-22 05:00:00,5
24,84,108,53,2.9,0,Clear,9.1,2021-04-22 06:00:00,6
45,149,194,60,2.9,0,Clear,10.7,2021-04-22 07:00:00,7
67,229,296,58,4.3,1,Mostly Clear,11.5,2021-04-22 08:00:00,8
71,156,227,50,5.8,2,Partly Cloudy,21.8,2021-04-22 09:00:00,9
56,141,197,44,6.7,2,Partly Cloudy,23.7,2021-04-22 10:00:00,10
70,159,229,39,7.7,2,Partly Cloudy,24.3,2021-04-22 11:00:00,11
76,154,230,36,8.7,2,Partly Cloudy,24.4,2021-04-22 12:00:00,12
99,171,270,33,9.7,2,Partly Cloudy,25.7,2021-04-22 13:00:00,13
119,169,288,33,10.2,2,Partly Cloudy,25.0,2021-04-22 14:00:00,14
89,155,244,32,10.3,2,Partly Cloudy,25.8,2021-04-22 15:00:00,15
113,229,342,30,11.0,2,Partly Cloudy,26.1,2021-04-22 16:00:00,16
159,302,461,28,11.2,2,Partly Cloudy,24.3,2021-04-22 17:00:00,17
174,320,494,30,10.6,2,Partly Cloudy,18.1,2021-04-22 18:00:00,18
127,258,385,33,9.9,0,Clear,10.8,2021-04-22 19:00:00,19
56,153,209,36,8.6,1,Mostly Clear,7.0,2021-04-22 20:00:00,20
70,119,189,38,7.4,1,Mostly Clear,7.0,2021-04-22 21:00:00,21
45,75,120,45,6.2,0,Clear,8.0,2021-04-22 22:00:00,22
49,49,98,51,5.3,0,Clear,9.4,2021-04-22 23:00:00,23
30,20,50,55,4.7,0,Clear,10.8,2021-04-23 00:00:00,0
8,10,18,60,4.0,0,Clear,11.9,2021-04-23 01:00:00,1
4,3,7,65,3.5,0,Clear,11.5,2021-04-23 02:00:00,2
2,5,7,75,3.3,0,Clear,10.8,2021-04-23 03:00:00,3
3,6,9,79,3.0,0,Clear,10.1,2021-04-23 04:00:00,4
10,26,36,83,2.5,0,Clear,9.5,2021-04-23 05:00:00,5
13,78,91,86,2.1,0,Clear,8.4,2021-04-23 06:00:00,6
52,161,213,87,2.2,0,Clear,9.2,2021-04-23 07:00:00,7
78,221,299,76,5.6,0,Clear,9.5,2021-04-23 08:00:00,8
86,187,273,62,8.5,0,Clear,10.2,2021-04-23 09:00:00,9
107,182,289,49,10.4,0,Clear,13.0,2021-04-23 10:00:00,10
167,225,392,41,11.9,0,Clear,14.4,2021-04-23 11:00:00,11
194,270,464,39,13.3,0,Clear,15.1,2021-04-23 12:00:00,12
202,284,486,37,14.6,1,Mostly Clear,15.1,2021-04-23 13:00:00,13
290,312,602,36,15.7,1,Mostly Clear,15.5,2021-04-23 14:00:00,14
257,300,557,35,16.7,1,Mostly Clear,16.3,2021-04-23 15:00:00,15
283,380,663,35,16.8,2,Partly Cloudy,16.3,2021-04-23 16:00:00,16
337,418,755,37,16.5,3,Cloudy,14.4,2021-04-23 17:00:00,17
239,416,655,43,15.9,3,Cloudy,10.1,2021-04-23 18:00:00,18
229,299,528,50,14.7,2,Partly Cloudy,8.6,2021-04-23 19:00:00,19
136,197,333,56,13.3,0,Clear,7.8,2021-04-23 20:00:00,20
103,153,256,60,11.8,0,Clear,8.3,2021-04-23 21:00:00,21
106,123,229,67,10.4,0,Clear,9.9,2021-04-23 22:00:00,22
88,112,200,72,9.1,0,Clear,9.7,2021-04-23 23:00:00,23
64,83,147,75,7.8,0,Clear,9.4,2021-04-24 00:00:00,0
47,42,89,75,6.9,0,Clear,8.7,2021-04-24 01:00:00,1
19,22,41,72,6.4,0,Clear,8.3,2021-04-24 02:00:00,2
6,9,15,76,5.7,0,Clear,9.0,2021-04-24 03:00:00,3
8,4,12,78,5.3,0,Clear,9.2,2021-04-24 04:00:00,4
2,14,16,80,4.8,0,Clear,8.8,2021-04-24 05:00:00,5
23,28,51,81,4.6,0,Clear,8.7,2021-04-24 06:00:00,6
41,70,111,82,4.9,1,Mostly Clear,6.2,2021-04-24 07:00:00,7
75,153,228,78,8.2,1,Mostly Clear,5.8,2021-04-24 08:00:00,8
146,260,406,62,12.5,0,Clear,3.6,2021-04-24 09:00:00,9
255,320,575,50,15.2,1,Mostly Clear,1.8,2021-04-24 10:00:00,10
323,428,751,43,16.5,1,Mostly Clear,3.7,2021-04-24 11:00:00,11
368,436,804,39,17.2,1,Mostly Clear,7.2,2021-04-24 12:00:00,12
455,419,874,39,17.7,1,Mostly Clear,9.4,2021-04-24 13:00:00,13
444,390,834,40,17.8,1,Mostly Clear,9.7,2021-04-24 14:00:00,14
414,350,764,40,17.6,3,Cloudy,10.8,2021-04-24 15:00:00,15
410,338,748,42,17.1,3,Cloudy,10.4,2021-04-24 16:00:00,16
295,297,592,47,16.3,3,Cloudy,11.5,2021-04-24 17:00:00,17
155,190,345,57,14.7,51,Light Drizzle,9.7,2021-04-24 18:00:00,18
43,83,126,72,13.0,51,Light Drizzle,9.5,2021-04-24 19:00:00,19
25,64,89,85,11.6,55,Heavy Drizzle,5.2,2021-04-24 20:00:00,20
17,40,57,93,10.8,61,Light Rain,7.3,2021-04-24 21:00:00,21
13,29,42,95,10.6,61,Light Rain,8.2,2021-04-24 22:00:00,22
24,18,42,96,10.3,61,Light Rain,8.8,2021-04-24 23:00:00,23
23,24,47,96,10.2,61,Light Rain,8.6,2021-04-25 00:00:00,0
6,11,17,96,10.2,63,Rain,8.3,2021-04-25 01:00:00,1
3,3,6,97,10.1,61,Light Rain,9.7,2021-04-25 02:00:00,2
7,4,11,96,9.7,61,Light Rain,10.7,2021-04-25 03:00:00,3
5,5,10,96,9.6,53,Heavy Drizzle,11.4,2021-04-25 04:00:00,4
3,9,12,96,9.5,51,Light Drizzle,11.9,2021-04-25 05:00:00,5
8,15,23,96,9.4,51,Light Drizzle,10.9,2021-04-25 06:00:00,6
4,29,33,95,9.5,3,Cloudy,11.4,2021-04-25 07:00:00,7
45,86,131,93,9.8,3,Cloudy,10.6,2021-04-25 08:00:00,8
85,166,251,92,10.6,3,Cloudy,9.9,2021-04-25 09:00:00,9
199,215,414,82,12.0,3,Cloudy,13.7,2021-04-25 10:00:00,10
245,294,539,69,14.4,51,Light Drizzle,12.7,2021-04-25 11:00:00,11
332,289,621,59,15.8,3,Cloudy,16.8,2021-04-25 12:00:00,12
360,351,711,57,16.0,3,Cloudy,18.0,2021-04-25 13:00:00,13
365,356,721,54,16.7,3,Cloudy,16.3,2021-04-25 14:00:00,14
359,358,717,56,17.1,3,Cloudy,18.8,2021-04-25 15:00:00,15
327,324,651,51,17.6,1,Mostly Clear,20.7,2021-04-25 16:00:00,16
324,341,665,47,18.1,1,Mostly Clear,19.2,2021-04-25 17:00:00,17
228,241,469,47,18.1,1,Mostly Clear,14.0,2021-04-25 18:00:00,18
146,249,395,51,16.9,1,Mostly Clear,9.9,2021-04-25 19:00:00,19
107,137,244,57,15.1,1,Mostly Clear,8.6,2021-04-25 20:00:00,20
71,81,152,60,13.9,1,Mostly Clear,10.4,2021-04-25 21:00:00,21
54,58,112,63,13.1,1,Mostly Clear,11.2,2021-04-25 22:00:00,22
59,34,93,64,12.5,0,Clear,14.1,2021-04-25 23:00:00,23
31,22,53,63,12.0,0,Clear,16.1,2021-04-26 00:00:00,0
12,14,26,60,11.1,0,Clear,15.1,2021-04-26 01:00:00,1
11,3,14,57,9.9,1,Mostly Clear,16.0,2021-04-26 02:00:00,2
4,3,7,53,9.3,0,Clear,16.3,2021-04-26 03:00:00,3
8,5,13,51,8.1,0,Clear,15.9,2021-04-26 04:00:00,4
12,36,48,50,7.1,0,Clear,15.9,2021-04-26 05:00:00,5
23,86,109,50,6.3,0,Clear,13.0,2021-04-26 06:00:00,6
39,159,198,53,5.8,0,Clear,12.7,2021-04-26 07:00:00,7
81,275,356,51,6.4,0,Clear,12.2,2021-04-26 08:00:00,8
73,175,248,48,7.6,0,Clear,15.3,2021-04-26 09:00:00,9
95,135,230,45,9.1,0,Clear,14.8,2021-04-26 10:00:00,10
112,164,276,42,10.9,0,Clear,14.3,2021-04-26 11:00:00,11
132,205,337,39,12.7,0,Clear,14.0,2021-04-26 12:00:00,12
176,206,382,36,14.4,0,Clear,14.0,2021-04-26 13:00:00,13
135,207,342,34,15.8,0,Clear,14.3,2021-04-26 14:00:00,14
186,250,436,30,17.7,0,Clear,14.5,2021-04-26 15:00:00,15
199,321,520,30,18.2,0,Clear,13.0,2021-04-26 16:00:00,16
254,473,727,31,18.3,0,Clear,11.7,2021-04-26 17:00:00,17
235,463,698,35,18.1,0,Clear,7.3,2021-04-26 18:00:00,18
172,349,521,47,16.9,0,Clear,1.4,2021-04-26 19:00:00,19
112,175,287,45,16.4,0,Clear,4.3,2021-04-26 20:00:00,20
76,120,196,65,13.1,0,Clear,6.6,2021-04-26 21:00:00,21
59,53,112,74,10.9,0,Clear,8.4,2021-04-26 22:00:00,22
46,46,92,76,9.9,0,Clear,10.1,2021-04-26 23:00:00,23
25,26,51,72,10.1,0,Clear,8.8,2021-04-27 00:00:00,0
4,3,7,78,8.9,0,Clear,9.9,2021-04-27 01:00:00,1
4,5,9,81,8.2,0,Clear,8.8,2021-04-27 02:00:00,2
6,3,9,74,8.6,0,Clear,11.2,2021-04-27 03:00:00,3
7,9,16,77,8.4,0,Clear,9.4,2021-04-27 04:00:00,4
11,34,45,82,8.1,0,Clear,9.2,2021-04-27 05:00:00,5
20,101,121,85,7.8,0,Clear,7.2,2021-04-27 06:00:00,6
56,210,266,87,8.0,1,Mostly Clear,6.8,2021-04-27 07:00:00,7
107,334,441,79,11.6,1,Mostly Clear,7.1,2021-04-27 08:00:00,8
91,213,304,69,14.6,1,Mostly Clear,6.9,2021-04-27 09:00:00,9
115,210,325,63,17.3,0,Clear,7.7,2021-04-27 10:00:00,10
156,211,367,58,20.1,0,Clear,8.2,2021-04-27 11:00:00,11
172,255,427,54,22.6,0,Clear,9.0,2021-04-27 12:00:00,12
207,280,487,50,24.7,0,Clear,10.2,2021-04-27 13:00:00,13
183,237,420,47,26.1,0,Clear,11.7,2021-04-27 14:00:00,14
217,279,496,43,27.3,0,Clear,13.2,2021-04-27 15:00:00,15
248,346,594,43,27.7,0,Clear,14.8,2021-04-27 16:00:00,16
316,511,827,46,27.6,0,Clear,12.9,2021-04-27 17:00:00,17
378,566,944,53,26.6,0,Clear,10.1,2021-04-27 18:00:00,18
279,365,644,59,24.8,0,Clear,9.8,2021-04-27 19:00:00,19
167,253,420,63,22.7,1,Mostly Clear,11.2,2021-04-27 20:00:00,20
128,182,310,62,21.9,0,Clear,13.1,2021-04-27 21:00:00,21
95,114,209,60,21.5,1,Mostly Clear,15.3,2021-04-27 22:00:00,22
73,51,124,59,21.3,1,Mostly Clear,16.8,2021-04-27 23:00:00,23
19,27,46,60,20.8,1,Mostly Clear,16.3,2021-04-28 00:00:00,0
15,11,26,61,20.3,1,Mostly Clear,15.8,2021-04-28 01:00:00,1
10,3,13,65,19.5,1,Mostly Clear,14.8,2021-04-28 02:00:00,2
4,3,7,63,18.9,1,Mostly Clear,14.1,2021-04-28 03:00:00,3
10,6,16,68,18.3,1,Mostly Clear,12.3,2021-04-28 04:00:00,4
11,34,45,72,17.6,1,Mostly Clear,11.1,2021-04-28 05:00:00,5
28,98,126,76,17.0,1,Mostly Clear,10.5,2021-04-28 06:00:00,6
55,166,221,79,16.8,1,Mostly Clear,9.0,2021-04-28 07:00:00,7
91,315,406,79,18.0,1,Mostly Clear,8.9,2021-04-28 08:00:00,8
85,229,314,72,20.7,1,Mostly Clear,8.2,2021-04-28 09:00:00,9
96,186,282,64,23.7,1,Mostly Clear,8.5,2021-04-28 10:00:00,10
126,196,322,57,26.1,1,Mostly Clear,10.5,2021-04-28 11:00:00,11
145,236,381,52,27.5,1,Mostly Clear,13.1,2021-04-28 12:00:00,12
171,220,391,50,28.4,0,Clear,14.2,2021-04-28 13:00:00,13
157,259,416,47,29.1,1,Mostly Clear,12.9,2021-04-28 14:00:00,14
171,247,418,41,29.9,1,Mostly Clear,14.8,2021-04-28 15:00:00,15
219,339,558,40,29.9,1,Mostly Clear,17.4,2021-04-28 16:00:00,16
292,539,831,46,28.9,1,Mostly Clear,12.0,2021-04-28 17:00:00,17
306,495,801,53,28.0,1,Mostly Clear,8.9,2021-04-28 18:00:00,18
241,357,598,60,26.3,1,Mostly Clear,7.9,2021-04-28 19:00:00,19
176,270,446,66,24.4,1,Mostly Clear,9.5,2021-04-28 20:00:00,20
132,146,278,70,23.0,1,Mostly Clear,9.8,2021-04-28 21:00:00,21
89,113,202,76,21.9,1,Mostly Clear,8.9,2021-04-28 22:00:00,22
63,59,122,80,21.1,1,Mostly Clear,9.2,2021-04-28 23:00:00,23
41,19,60,82,20.5,1,Mostly Clear,7.6,2021-04-29 00:00:00,0
22,10,32,83,20.3,1,Mostly Clear,9.0,2021-04-29 01:00:00,1
5,6,11,84,20.0,1,Mostly Clear,10.0,2021-04-29 02:00:00,2
4,5,9,84,19.7,1,Mostly Clear,9.4,2021-04-29 03:00:00,3
10,10,20,85,19.5,2,Partly Cloudy,9.6,2021-04-29 04:00:00,4
13,37,50,87,19.4,2,Partly Cloudy,8.2,2021-04-29 05:00:00,5
26,89,115,88,19.2,2,Partly Cloudy,5.8,2021-04-29 06:00:00,6
52,227,279,90,19.0,1,Mostly Clear,5.4,2021-04-29 07:00:00,7
94,309,403,86,20.4,1,Mostly Clear,7.6,2021-04-29 08:00:00,8
75,228,303,79,22.0,1,Mostly Clear,8.0,2021-04-29 09:00:00,9
86,164,250,78,22.4,2,Partly Cloudy,10.3,2021-04-29 10:00:00,10
133,198,331,76,22.9,51,Light Drizzle,10.2,2021-04-29 11:00:00,11
136,222,358,70,24.5,2,Partly Cloudy,8.0,2021-04-29 12:00:00,12
125,231,356,72,24.3,53,Heavy Drizzle,8.6,2021-04-29 13:00:00,13
157,228,385,66,26.1,2,Partly Cloudy,12.2,2021-04-29 14:00:00,14
192,243,435,59,27.6,2,Partly Cloudy,18.9,2021-04-29 15:00:00,15
196,329,525,61,27.3,2,Partly Cloudy,20.4,2021-04-29 16:00:00,16
208,456,664,62,26.8,3,Cloudy,16.6,2021-04-29 17:00:00,17
208,448,656,56,26.2,3,Cloudy,14.0,2021-04-29 18:00:00,18
176,305,481,64,23.9,51,Light Drizzle,12.7,2021-04-29 19:00:00,19
130,205,335,65,23.3,3,Cloudy,10.9,2021-04-29 20:00:00,20
94,164,258,61,23.0,3,Cloudy,7.2,2021-04-29 21:00:00,21
118,113,231,55,23.2,3,Cloudy,12.4,2021-04-29 22:00:00,22
45,56,101,58,22.6,3,Cloudy,18.0,2021-04-29 23:00:00,23
32,38,70,62,22.3,3,Cloudy,20.2,2021-04-30 00:00:00,0
11,11,22,69,21.3,1,Mostly Clear,20.1,2021-04-30 01:00:00,1
18,12,30,74,19.5,2,Partly Cloudy,22.1,2021-04-30 02:00:00,2
8,7,15,81,17.9,3,Cloudy,23.3,2021-04-30 03:00:00,3
7,12,19,75,16.9,3,Cloudy,24.0,2021-04-30 04:00:00,4
15,29,44,70,15.7,0,Clear,23.2,2021-04-30 05:00:00,5
20,99,119,68,14.8,0,Clear,22.4,2021-04-30 06:00:00,6
59,214,273,70,14.2,0,Clear,19.7,2021-04-30 07:00:00,7
107,260,367,68,14.6,0,Clear,16.4,2021-04-30 08:00:00,8
103,207,310,61,15.7,0,Clear,23.3,2021-04-30 09:00:00,9
106,190,296,53,17.0,2,Partly Cloudy,29.4,2021-04-30 10:00:00,10
173,250,423,49,17.8,1,Mostly Clear,27.0,2021-04-30 11:00:00,11
160,249,409,46,18.3,1,Mostly Clear,28.9,2021-04-30 12:00:00,12
215,261,476,42,19.3,0,Clear,28.7,2021-04-30 13:00:00,13
215,223,438,34,19.8,0,Clear,28.7,2021-04-30 14:00:00,14
230,299,529,30,20.7,0,Clear,29.9,2021-04-30 15:00:00,15
215,290,505,31,20.7,0,Clear,29.6,2021-04-30 16:00:00,16
214,348,562,35,19.3,51,Light Drizzle,36.7,2021-04-30 17:00:00,17
122,292,414,47,15.8,1,Mostly Clear,28.2,2021-04-30 18:00:00,18
132,200,332,50,14.2,2,Partly Cloudy,24.0,2021-04-30 19:00:00,19
105,125,230,47,13.4,0,Clear,21.6,2021-04-30 20:00:00,20
71,88,159,44,12.9,0,Clear,25.8,2021-04-30 21:00:00,21
64,91,155,38,11.6,0,Clear,28.6,2021-04-30 22:00:00,22
73,82,155,36,10.5,0,Clear,28.0,2021-04-30 23:00:00,23
55,41,96,36,9.7,0,Clear,26.3,2021-05-01 00:00:00,0
24,18,42,35,9.1,0,Clear,26.8,2021-05-01 01:00:00,1
15,12,27,35,8.5,0,Clear,27.0,2021-05-01 02:00:00,2
6,13,19,35,8.8,0,Clear,25.2,2021-05-01 03:00:00,3
9,3,12,35,8.3,0,Clear,23.7,2021-05-01 04:00:00,4
6,9,15,36,7.9,0,Clear,22.2,2021-05-01 05:00:00,5
20,40,60,38,7.6,0,Clear,15.8,2021-05-01 06:00:00,6
38,60,98,43,7.5,0,Clear,15.9,2021-05-01 07:00:00,7
94,128,222,46,8.3,0,Clear,15.4,2021-05-01 08:00:00,8
163,226,389,44,9.5,0,Clear,20.0,2021-05-01 09:00:00,9
254,317,571,43,10.9,0,Clear,19.4,2021-05-01 10:00:00,10
407,394,801,41,12.7,0,Clear,17.1,2021-05-01 11:00:00,11
444,397,841,38,14.5,0,Clear,15.3,2021-05-01 12:00:00,12
541,425,966,34,16.1,0,Clear,13.7,2021-05-01 13:00:00,13
506,413,919,31,17.4,0,Clear,13.2,2021-05-01 14:00:00,14
579,436,1015,27,18.7,0,Clear,13.0,2021-05-01 15:00:00,15
550,435,985,26,19.2,1,Mostly Clear,13.0,2021-05-01 16:00:00,16
434,415,849,27,19.3,1,Mostly Clear,13.0,2021-05-01 17:00:00,17
422,344,766,29,18.9,0,Clear,8.6,2021-05-01 18:00:00,18
315,290,605,41,17.9,0,Clear,5.6,2021-05-01 19:00:00,19
215,182,397,48,16.0,0,Clear,8.0,2021-05-01 20:00:00,20
171,150,321,48,14.3,0,Clear,10.5,2021-05-01 21:00:00,21
155,117,272,50,13.3,0,Clear,11.6,2021-05-01 22:00:00,22
128,123,251,53,12.6,0,Clear,13.2,2021-05-01 23:00:00,23
99,100,199,55,12.0,0,Clear,15.0,2021-05-02 00:00:00,0
44,38,82,57,11.7,0,Clear,15.3,2021-05-02 01:00:00,1
26,16,42,57,11.5,0,Clear,14.1,2021-05-02 02:00:00,2
14,13,27,48,12.1,1,Mostly Clear,12.8,2021-05-02 03:00:00,3
14,7,21,48,12.2,1,Mostly Clear,12.7,2021-05-02 04:00:00,4
11,12,23,49,12.3,1,Mostly Clear,12.1,2021-05-02 05:00:00,5
19,35,54,54,11.9,1,Mostly Clear,13.2,2021-05-02 06:00:00,6
37,54,91,60,12.1,1,Mostly Clear,12.4,2021-05-02 07:00:00,7
81,144,225,61,13.9,0,Clear,13.0,2021-05-02 08:00:00,8
151,198,349,54,16.9,0,Clear,12.2,2021-05-02 09:00:00,9
285,312,597,49,19.7,1,Mostly Clear,12.3,2021-05-02 10:00:00,10
366,356,722,45,22.4,1,Mostly Clear,12.6,2021-05-02 11:00:00,11
457,433,890,41,24.4,1,Mostly Clear,13.8,2021-05-02 12:00:00,12
497,409,906,39,25.9,1,Mostly Clear,15.9,2021-05-02 13:00:00,13
518,412,930,38,27.0,1,Mostly Clear,17.1,2021-05-02 14:00:00,14
472,421,893,35,28.1,1,Mostly Clear,17.8,2021-05-02 15:00:00,15
452,394,846,35,27.9,1,Mostly Clear,18.7,2021-05-02 16:00:00,16
414,336,750,36,27.5,1,Mostly Clear,15.8,2021-05-02 17:00:00,17
318,314,632,41,26.2,1,Mostly Clear,12.6,2021-05-02 18:00:00,18
277,278,555,45,24.4,1,Mostly Clear,11.7,2021-05-02 19:00:00,19
147,197,344,48,22.5,1,Mostly Clear,12.4,2021-05-02 20:00:00,20
130,125,255,46,21.5,1,Mostly Clear,13.7,2021-05-02 21:00:00,21
107,87,194,47,20.6,1,Mostly Clear,14.3,2021-05-02 22:00:00,22
53,43,96,50,19.6,1,Mostly Clear,15.2,2021-05-02 23:00:00,23
34,30,64,52,18.9,1,Mostly Clear,15.8,2021-05-03 00:00:00,0
17,12,29,55,18.4,1,Mostly Clear,13.3,2021-05-03 01:00:00,1
15,3,18,58,18.0,1,Mostly Clear,10.5,2021-05-03 02:00:00,2
6,8,14,63,18.4,3,Cloudy,10.6,2021-05-03 03:00:00,3
11,11,22,66,18.0,3,Cloudy,9.8,2021-05-03 04:00:00,4
8,27,35,67,17.8,3,Cloudy,9.8,2021-05-03 05:00:00,5
12,64,76,68,17.7,3,Cloudy,9.2,2021-05-03 06:00:00,6
63,152,215,71,17.7,3,Cloudy,7.6,2021-05-03 07:00:00,7
89,252,341,73,18.0,3,Cloudy,7.4,2021-05-03 08:00:00,8
100,185,285,73,18.8,3,Cloudy,6.1,2021-05-03 09:00:00,9
100,152,252,71,19.4,3,Cloudy,1.0,2021-05-03 10:00:00,10
87,177,264,69,20.2,3,Cloudy,6.0,2021-05-03 11:00:00,11
101,191,292,70,20.8,51,Light Drizzle,10.2,2021-05-03 12:00:00,12
142,195,337,70,21.8,51,Light Drizzle,14.0,2021-05-03 13:00:00,13
152,209,361,76,22.2,53,Heavy Drizzle,18.6,2021-05-03 14:00:00,14
189,227,416,85,22.2,51,Light Drizzle,15.6,2021-05-03 15:00:00,15
147,292,439,85,22.7,51,Light Drizzle,14.4,2021-05-03 16:00:00,16
190,367,557,85,23.1,51,Light Drizzle,14.8,2021-05-03 17:00:00,17
137,390,527,88,22.0,61,Light Rain,8.0,2021-05-03 18:00:00,18
121,243,364,92,20.9,61,Light Rain,10.0,2021-05-03 19:00:00,19
70,149,219,94,20.5,51,Light Drizzle,10.3,2021-05-03 20:00:00,20
73,117,190,95,20.4,2,Partly Cloudy,13.0,2021-05-03 21:00:00,21
64,73,137,96,20.1,3,Cloudy,15.6,2021-05-03 22:00:00,22
24,26,50,96,19.9,2,Partly Cloudy,16.4,2021-05-03 23:00:00,23
18,8,26,95,19.7,51,Light Drizzle,15.5,2021-05-04 00:00:00,0
8,5,13,95,19.6,51,Light Drizzle,14.4,2021-05-04 01:00:00,1
8,3,11,95,19.3,1,Mostly Clear,14.2,2021-05-04 02:00:00,2
2,4,6,96,18.9,1,Mostly Clear,13.4,2021-05-04 03:00:00,3
8,11,19,96,18.7,1,Mostly Clear,13.3,2021-05-04 04:00:00,4
11,34,45,95,18.5,0,Clear,13.6,2021-05-04 05:00:00,5
39,97,136,95,18.1,0,Clear,9.5,2021-05-04 06:00:00,6
74,213,287,95,18.1,0,Clear,9.8,2021-05-04 07:00:00,7
123,319,442,92,19.5,0,Clear,8.7,2021-05-04 08:00:00,8
112,212,324,85,21.6,0,Clear,8.0,2021-05-04 09:00:00,9
114,203,317,75,23.5,1,Mostly Clear,12.8,2021-05-04 10:00:00,10
138,217,355,66,25.2,1,Mostly Clear,13.0,2021-05-04 11:00:00,11
172,258,430,63,25.9,2,Partly Cloudy,12.2,2021-05-04 12:00:00,12
161,246,407,62,26.1,1,Mostly Clear,11.6,2021-05-04 13:00:00,13
200,243,443,60,26.9,1,Mostly Clear,11.8,2021-05-04 14:00:00,14
207,273,480,56,29.0,0,Clear,12.0,2021-05-04 15:00:00,15
161,350,511,57,28.8,0,Clear,12.0,2021-05-04 16:00:00,16
45,120,165,60,28.2,51,Light Drizzle,13.4,2021-05-04 17:00:00,17
89,204,293,65,27.3,53,Heavy Drizzle,6.1,2021-05-04 18:00:00,18
116,268,384,71,26.2,51,Light Drizzle,9.1,2021-05-04 19:00:00,19
108,197,305,76,24.6,1,Mostly Clear,11.6,2021-05-04 20:00:00,20
86,122,208,77,23.3,2,Partly Cloudy,10.3,2021-05-04 21:00:00,21
95,88,183,77,22.6,0,Clear,10.2,2021-05-04 22:00:00,22
49,60,109,79,22.1,1,Mostly Clear,9.0,2021-05-04 23:00:00,23
32,14,46,84,21.5,1,Mostly Clear,9.4,2021-05-05 00:00:00,0
11,6,17,88,21.1,1,Mostly Clear,10.5,2021-05-05 01:00:00,1
3,5,8,90,20.8,1,Mostly Clear,8.5,2021-05-05 02:00:00,2
6,1,7,96,19.1,1,Mostly Clear,7.6,2021-05-05 03:00:00,3
12,18,30,96,18.8,3,Cloudy,6.6,2021-05-05 04:00:00,4
14,30,44,96,18.6,3,Cloudy,4.8,2021-05-05 05:00:00,5
25,99,124,97,18.3,3,Cloudy,2.3,2021-05-05 06:00:00,6
39,129,168,97,18.3,53,Heavy Drizzle,4.1,2021-05-05 07:00:00,7
51,164,215,97,18.5,61,Light Rain,4.8,2021-05-05 08:00:00,8
43,118,161,96,19.2,63,Rain,4.0,2021-05-05 09:00:00,9
63,138,201,93,20.0,55,Heavy Drizzle,6.0,2021-05-05 10:00:00,10
75,187,262,84,22.4,61,Light Rain,9.2,2021-05-05 11:00:00,11
122,246,368,82,23.0,63,Rain,6.1,2021-05-05 12:00:00,12
111,225,336,80,22.1,63,Rain,11.3,2021-05-05 13:00:00,13
119,213,332,74,22.9,51,Light Drizzle,23.7,2021-05-05 14:00:00,14
157,242,399,65,23.3,51,Light Drizzle,20.7,2021-05-05 15:00:00,15
164,363,527,62,23.1,0,Clear,21.2,2021-05-05 16:00:00,16
277,546,823,58,22.8,1,Mostly Clear,21.3,2021-05-05 17:00:00,17
299,533,832,58,21.7,0,Clear,23.2,2021-05-05 18:00:00,18
212,399,611,56,20.2,0,Clear,21.4,2021-05-05 19:00:00,19
124,238,362,56,18.3,0,Clear,20.7,2021-05-05 20:00:00,20
106,186,292,55,16.6,0,Clear,20.6,2021-05-05 21:00:00,21
106,108,214,55,15.3,0,Clear,20.1,2021-05-05 22:00:00,22
73,57,130,55,14.1,0,Clear,19.1,2021-05-05 23:00:00,23
21,37,58,55,13.2,0,Clear,18.9,2021-05-06 00:00:00,0
11,15,26,54,12.5,0,Clear,18.9,2021-05-06 01:00:00,1
5,5,10,52,12.0,1,Mostly Clear,18.9,2021-05-06 02:00:00,2
3,7,10,49,11.2,1,Mostly Clear,17.2,2021-05-06 03:00:00,3
10,8,18,49,10.5,0,Clear,14.3,2021-05-06 04:00:00,4
10,32,42,51,10.0,0,Clear,12.6,2021-05-06 05:00:00,5
26,95,121,55,9.5,0,Clear,12.9,2021-05-06 06:00:00,6
69,218,287,62,9.3,0,Clear,13.5,2021-05-06 07:00:00,7
102,316,418,62,10.3,0,Clear,13.0,2021-05-06 08:00:00,8
109,229,338,60,11.6,0,Clear,14.5,2021-05-06 09:00:00,9
136,188,324,54,13.0,0,Clear,13.4,2021-05-06 10:00:00,10
169,233,402,52,14.0,0,Clear,12.1,2021-05-06 11:00:00,11
191,270,461,50,15.1,0,Clear,10.4,2021-05-06 12:00:00,12
170,256,426,48,16.0,1,Mostly Clear,10.2,2021-05-06 13:00:00,13
213,263,476,47,16.8,1,Mostly Clear,9.8,2021-05-06 14:00:00,14
286,320,606,43,17.8,1,Mostly Clear,8.8,2021-05-06 15:00:00,15
223,362,585,42,18.0,1,Mostly Clear,9.2,2021-05-06 16:00:00,16
305,477,782,41,18.0,2,Partly Cloudy,10.0,2021-05-06 17:00:00,17
298,539,837,40,17.7,2,Partly Cloudy,7.6,2021-05-06 18:00:00,18
289,380,669,48,17.1,2,Partly Cloudy,4.8,2021-05-06 19:00:00,19
178,260,438,56,16.2,2,Partly Cloudy,6.0,2021-05-06 20:00:00,20
100,149,249,60,14.9,3,Cloudy,6.9,2021-05-06 21:00:00,21
99,128,227,67,13.8,3,Cloudy,7.4,2021-05-06 22:00:00,22
59,75,134,74,12.7,2,Partly Cloudy,7.9,2021-05-06 23:00:00,23
38,21,59,78,12.1,1,Mostly Clear,8.2,2021-05-07 00:00:00,0
18,15,33,80,11.5,0,Clear,8.0,2021-05-07 01:00:00,1
5,6,11,82,10.5,0,Clear,8.0,2021-05-07 02:00:00,2
7,2,9,85,9.6,0,Clear,8.6,2021-05-07 03:00:00,3
9,11,20,85,9.4,0,Clear,7.4,2021-05-07 04:00:00,4
22,22,44,83,9.8,0,Clear,6.2,2021-05-07 05:00:00,5
29,103,132,84,9.9,0,Clear,3.7,2021-05-07 06:00:00,6
65,201,266,87,9.9,0,Clear,4.2,2021-05-07 07:00:00,7
114,300,414,79,11.9,1,Mostly Clear,3.8,2021-05-07 08:00:00,8
116,255,371,65,14.3,2,Partly Cloudy,5.7,2021-05-07 09:00:00,9
164,222,386,54,16.1,3,Cloudy,6.9,2021-05-07 10:00:00,10
180,267,447,49,17.4,3,Cloudy,7.7,2021-05-07 11:00:00,11
190,265,455,48,18.3,3,Cloudy,8.6,2021-05-07 12:00:00,12
202,295,497,48,18.7,3,Cloudy,8.8,2021-05-07 13:00:00,13
256,243,499,52,17.4,3,Cloudy,8.1,2021-05-07 14:00:00,14
135,217,352,72,14.7,63,Rain,8.6,2021-05-07 15:00:00,15
121,196,317,79,13.6,63,Rain,5.4,2021-05-07 16:00:00,16
86,149,235,85,13.4,53,Heavy Drizzle,2.9,2021-05-07 17:00:00,17
71,158,229,89,12.8,53,Heavy Drizzle,2.8,2021-05-07 18:00:00,18
75,136,211,91,11.9,61,Light Rain,9.4,2021-05-07 19:00:00,19
61,117,178,91,11.4,55,Heavy Drizzle,11.1,2021-05-07 20:00:00,20
57,100,157,94,10.9,51,Light Drizzle,11.2,2021-05-07 21:00:00,21
58,84,142,95,10.4,3,Cloudy,11.9,2021-05-07 22:00:00,22
80,85,165,92,9.9,2,Partly Cloudy,10.9,2021-05-07 23:00:00,23
92,61,153,91,9.1,1,Mostly Clear,10.3,2021-05-08 00:00:00,0
31,34,65,91,8.4,0,Clear,9.6,2021-05-08 01:00:00,1
13,16,29,91,7.8,0,Clear,8.3,2021-05-08 02:00:00,2
12,9,21,91,7.1,0,Clear,6.5,2021-05-08 03:00:00,3
5,4,9,92,6.7,0,Clear,7.2,2021-05-08 04:00:00,4
10,15,25,94,6.2,3,Cloudy,7.9,2021-05-08 05:00:00,5
25,35,60,94,6.0,3,Cloudy,5.6,2021-05-08 06:00:00,6
22,45,67,94,7.1,53,Heavy Drizzle,6.7,2021-05-08 07:00:00,7
48,109,157,91,8.6,53,Heavy Drizzle,6.9,2021-05-08 08:00:00,8
128,198,326,90,9.1,53,Heavy Drizzle,9.2,2021-05-08 09:00:00,9
219,270,489,85,10.0,53,Heavy Drizzle,11.6,2021-05-08 10:00:00,10
367,346,713,79,11.2,51,Light Drizzle,12.5,2021-05-08 11:00:00,11
374,385,759,74,12.6,51,Light Drizzle,12.8,2021-05-08 12:00:00,12
389,333,722,64,14.5,1,Mostly Clear,13.8,2021-05-08 13:00:00,13
376,313,689,58,15.2,2,Partly Cloudy,16.8,2021-05-08 14:00:00,14
418,349,767,56,15.3,51,Light Drizzle,19.8,2021-05-08 15:00:00,15
342,351,693,50,15.0,51,Light Drizzle,21.5,2021-05-08 16:00:00,16
315,302,617,42,14.9,0,Clear,22.8,2021-05-08 17:00:00,17
252,304,556,43,14.5,0,Clear,20.0,2021-05-08 18:00:00,18
246,285,531,47,13.8,0,Clear,14.5,2021-05-08 19:00:00,19
182,191,373,52,12.6,0,Clear,11.0,2021-05-08 20:00:00,20
125,123,248,54,11.5,0,Clear,9.9,2021-05-08 21:00:00,21
120,94,214,59,10.5,0,Clear,9.6,2021-05-08 22:00:00,22
117,99,216,64,9.6,0,Clear,9.0,2021-05-08 23:00:00,23
96,67,163,69,8.7,1,Mostly Clear,7.7,2021-05-09 00:00:00,0
39,27,66,73,8.2,1,Mostly Clear,6.9,2021-05-09 01:00:00,1
16,24,40,75,7.8,1,Mostly Clear,7.4,2021-05-09 02:00:00,2
13,15,28,77,7.5,3,Cloudy,6.5,2021-05-09 03:00:00,3
11,3,14,78,7.4,2,Partly Cloudy,6.4,2021-05-09 04:00:00,4
8,8,16,78,7.4,3,Cloudy,6.5,2021-05-09 05:00:00,5
13,20,33,82,7.4,2,Partly Cloudy,5.2,2021-05-09 06:00:00,6
24,40,64,81,7.9,3,Cloudy,3.8,2021-05-09 07:00:00,7
59,110,169,71,9.5,2,Partly Cloudy,2.2,2021-05-09 08:00:00,8
95,187,282,61,11.6,2,Partly Cloudy,5.2,2021-05-09 09:00:00,9
178,237,415,55,12.6,2,Partly Cloudy,6.6,2021-05-09 10:00:00,10
220,284,504,54,12.8,3,Cloudy,7.3,2021-05-09 11:00:00,11
303,283,586,52,13.8,2,Partly Cloudy,9.8,2021-05-09 12:00:00,12
316,297,613,50,15.3,3,Cloudy,13.9,2021-05-09 13:00:00,13
412,341,753,49,16.3,1,Mostly Clear,14.7,2021-05-09 14:00:00,14
343,362,705,48,17.9,1,Mostly Clear,16.6,2021-05-09 15:00:00,15
322,335,657,50,18.7,1,Mostly Clear,17.2,2021-05-09 16:00:00,16
249,325,574,57,18.4,1,Mostly Clear,15.8,2021-05-09 17:00:00,17
256,277,533,66,17.7,2,Partly Cloudy,13.6,2021-05-09 18:00:00,18
178,201,379,70,17.2,2,Partly Cloudy,13.5,2021-05-09 19:00:00,19
92,131,223,75,16.3,2,Partly Cloudy,12.0,2021-05-09 20:00:00,20
69,109,178,77,15.9,3,Cloudy,11.8,2021-05-09 21:00:00,21
76,84,160,73,16.8,2,Partly Cloudy,13.8,2021-05-09 22:00:00,22
60,51,111,69,17.5,51,Light Drizzle,16.7,2021-05-09 23:00:00,23
29,27,56,70,17.7,53,Heavy Drizzle,19.6,2021-05-10 00:00:00,0
21,5,26,69,17.8,51,Light Drizzle,20.2,2021-05-10 01:00:00,1
5,2,7,73,17.0,51,Light Drizzle,20.5,2021-05-10 02:00:00,2
11,4,15,64,18.5,2,Partly Cloudy,19.1,2021-05-10 03:00:00,3
14,11,25,72,17.6,3,Cloudy,20.0,2021-05-10 04:00:00,4
15,37,52,74,15.9,1,Mostly Clear,22.1,2021-05-10 05:00:00,5
41,85,126,72,13.6,3,Cloudy,18.6,2021-05-10 06:00:00,6
54,188,242,71,12.0,2,Partly Cloudy,17.0,2021-05-10 07:00:00,7
85,255,340,72,11.4,3,Cloudy,17.9,2021-05-10 08:00:00,8
81,203,284,70,11.5,3,Cloudy,17.4,2021-05-10 09:00:00,9
73,187,260,68,11.8,3,Cloudy,16.4,2021-05-10 10:00:00,10
118,172,290,65,12.6,2,Partly Cloudy,14.8,2021-05-10 11:00:00,11
156,215,371,60,14.1,1,Mostly Clear,13.9,2021-05-10 12:00:00,12
190,247,437,55,15.6,0,Clear,12.7,2021-05-10 13:00:00,13
188,223,411,52,16.7,2,Partly Cloudy,12.9,2021-05-10 14:00:00,14
233,246,479,47,18.1,2,Partly Cloudy,14.1,2021-05-10 15:00:00,15
265,339,604,46,18.2,0,Clear,13.6,2021-05-10 16:00:00,16
283,479,762,45,18.2,0,Clear,13.6,2021-05-10 17:00:00,17
293,516,809,45,17.7,0,Clear,12.2,2021-05-10 18:00:00,18
205,377,582,50,16.7,0,Clear,9.2,2021-05-10 19:00:00,19
142,221,363,55,15.2,0,Clear,9.2,2021-05-10 20:00:00,20
97,132,229,56,13.9,0,Clear,9.4,2021-05-10 21:00:00,21
67,106,173,60,12.6,0,Clear,9.4,2021-05-10 22:00:00,22
27,39,66,63,11.4,0,Clear,10.2,2021-05-10 23:00:00,23
22,19,41,68,10.3,1,Mostly Clear,7.7,2021-05-11 00:00:00,0
7,5,12,72,9.5,3,Cloudy,6.4,2021-05-11 01:00:00,1
10,4,14,72,8.9,2,Partly Cloudy,8.5,2021-05-11 02:00:00,2
8,2,10,69,9.5,3,Cloudy,9.3,2021-05-11 03:00:00,3
10,10,20,67,9.8,3,Cloudy,9.2,2021-05-11 04:00:00,4
7,33,40,67,9.9,2,Partly Cloudy,8.4,2021-05-11 05:00:00,5
22,103,125,73,9.3,1,Mostly Clear,5.4,2021-05-11 06:00:00,6
67,209,276,80,9.1,0,Clear,5.4,2021-05-11 07:00:00,7
108,357,465,66,11.9,0,Clear,5.0,2021-05-11 08:00:00,8
87,273,360,57,13.9,0,Clear,4.1,2021-05-11 09:00:00,9
111,201,312,50,15.4,0,Clear,4.1,2021-05-11 10:00:00,10
140,238,378,48,16.7,0,Clear,7.2,2021-05-11 11:00:00,11
182,293,475,44,18.1,0,Clear,10.3,2021-05-11 12:00:00,12
177,252,429,40,19.0,2,Partly Cloudy,15.0,2021-05-11 13:00:00,13
187,248,435,40,18.9,1,Mostly Clear,14.0,2021-05-11 14:00:00,14
212,294,506,40,18.7,1,Mostly Clear,17.5,2021-05-11 15:00:00,15
223,360,583,42,18.5,1,Mostly Clear,19.4,2021-05-11 16:00:00,16
279,518,797,42,18.6,1,Mostly Clear,19.1,2021-05-11 17:00:00,17
312,503,815,44,18.1,1,Mostly Clear,11.2,2021-05-11 18:00:00,18
246,395,641,50,16.9,1,Mostly Clear,10.4,2021-05-11 19:00:00,19
116,230,346,53,15.6,1,Mostly Clear,12.3,2021-05-11 20:00:00,20
92,172,264,51,14.5,1,Mostly Clear,12.8,2021-05-11 21:00:00,21
71,114,185,48,14.1,0,Clear,13.2,2021-05-11 22:00:00,22
56,65,121,44,13.4,0,Clear,15.6,2021-05-11 23:00:00,23
31,25,56,42,12.6,1,Mostly Clear,15.6,2021-05-12 00:00:00,0
9,10,19,41,11.9,3,Cloudy,15.5,2021-05-12 01:00:00,1
2,2,4,43,10.8,2,Partly Cloudy,15.3,2021-05-12 02:00:00,2
5,1,6,41,11.0,1,Mostly Clear,13.4,2021-05-12 03:00:00,3
5,8,13,43,10.2,1,Mostly Clear,11.2,2021-05-12 04:00:00,4
15,28,43,47,9.2,1,Mostly Clear,11.1,2021-05-12 05:00:00,5
28,110,138,51,8.6,2,Partly Cloudy,6.3,2021-05-12 06:00:00,6
68,221,289,58,8.3,2,Partly Cloudy,9.0,2021-05-12 07:00:00,7
97,303,400,55,9.1,2,Partly Cloudy,10.1,2021-05-12 08:00:00,8
95,231,326,54,10.1,1,Mostly Clear,14.6,2021-05-12 09:00:00,9
108,193,301,53,11.0,1,Mostly Clear,13.2,2021-05-12 10:00:00,10
145,216,361,51,12.5,1,Mostly Clear,10.9,2021-05-12 11:00:00,11
175,216,391,49,14.1,2,Partly Cloudy,9.0,2021-05-12 12:00:00,12
175,246,421,47,15.6,1,Mostly Clear,7.9,2021-05-12 13:00:00,13
196,253,449,41,17.2,1,Mostly Clear,9.1,2021-05-12 14:00:00,14
198,323,521,39,17.9,1,Mostly Clear,10.4,2021-05-12 15:00:00,15
230,392,622,38,18.2,0,Clear,10.2,2021-05-12 16:00:00,16
320,518,838,38,18.2,0,Clear,10.7,2021-05-12 17:00:00,17
361,574,935,39,17.8,0,Clear,10.1,2021-05-12 18:00:00,18
261,372,633,47,16.8,0,Clear,5.4,2021-05-12 19:00:00,19
129,262,391,55,15.3,0,Clear,0.5,2021-05-12 20:00:00,20
115,169,284,57,13.9,0,Clear,4.0,2021-05-12 21:00:00,21
89,120,209,59,12.9,0,Clear,6.5,2021-05-12 22:00:00,22
76,69,145,61,12.0,0,Clear,6.8,2021-05-12 23:00:00,23
27,36,63,64,11.3,0,Clear,7.0,2021-05-13 00:00:00,0
11,9,20,67,10.7,0,Clear,8.7,2021-05-13 01:00:00,1
1,11,12,70,10.0,0,Clear,10.0,2021-05-13 02:00:00,2
4,9,13,69,9.3,0,Clear,10.0,2021-05-13 03:00:00,3
10,14,24,70,8.7,0,Clear,10.0,2021-05-13 04:00:00,4
16,41,57,71,8.4,0,Clear,10.0,2021-05-13 05:00:00,5
36,120,156,74,7.9,0,Clear,9.7,2021-05-13 06:00:00,6
57,215,272,76,8.3,0,Clear,9.8,2021-05-13 07:00:00,7
126,296,422,66,11.2,0,Clear,8.0,2021-05-13 08:00:00,8
127,234,361,57,13.7,0,Clear,7.0,2021-05-13 09:00:00,9
111,186,297,50,15.9,0,Clear,6.8,2021-05-13 10:00:00,10
160,240,400,40,17.5,0,Clear,7.3,2021-05-13 11:00:00,11
185,265,450,34,18.4,1,Mostly Clear,10.0,2021-05-13 12:00:00,12
207,288,495,32,19.1,1,Mostly Clear,10.4,2021-05-13 13:00:00,13
210,276,486,31,19.6,1,Mostly Clear,9.6,2021-05-13 14:00:00,14
244,292,536,30,19.9,0,Clear,9.3,2021-05-13 15:00:00,15
286,363,649,30,19.8,1,Mostly Clear,10.4,2021-05-13 16:00:00,16
330,534,864,31,19.6,1,Mostly Clear,11.1,2021-05-13 17:00:00,17
386,551,937,32,19.1,1,Mostly Clear,7.7,2021-05-13 18:00:00,18
336,406,742,39,18.0,1,Mostly Clear,6.5,2021-05-13 19:00:00,19
206,261,467,49,16.4,0,Clear,5.4,2021-05-13 20:00:00,20
124,200,324,51,14.9,0,Clear,7.1,2021-05-13 21:00:00,21
169,167,336,57,13.4,0,Clear,7.1,2021-05-13 22:00:00,22
125,86,211,61,12.3,0,Clear,6.6,2021-05-13 23:00:00,23
69,62,131,65,11.3,0,Clear,7.1,2021-05-14 00:00:00,0
18,16,34,68,10.5,0,Clear,7.9,2021-05-14 01:00:00,1
13,5,18,70,9.7,0,Clear,7.9,2021-05-14 02:00:00,2
6,5,11,81,9.1,0,Clear,7.7,2021-05-14 03:00:00,3
5,9,14,83,8.5,0,Clear,7.7,2021-05-14 04:00:00,4
14,29,43,83,8.0,0,Clear,7.8,2021-05-14 05:00:00,5
27,93,120,84,7.6,1,Mostly Clear,7.7,2021-05-14 06:00:00,6
63,202,265,84,8.5,0,Clear,8.2,2021-05-14 07:00:00,7
107,311,418,69,12.6,0,Clear,6.3,2021-05-14 08:00:00,8
103,237,340,60,15.5,0,Clear,4.9,2021-05-14 09:00:00,9
170,231,401,51,18.0,0,Clear,3.7,2021-05-14 10:00:00,10
220,275,495,42,19.8,0,Clear,2.5,2021-05-14 11:00:00,11
244,296,540,34,20.6,1,Mostly Clear,5.1,2021-05-14 12:00:00,12
290,306,596,33,20.6,1,Mostly Clear,5.4,2021-05-14 13:00:00,13
267,301,568,32,21.0,1,Mostly Clear,4.0,2021-05-14 14:00:00,14
330,321,651,30,20.9,1,Mostly Clear,2.2,2021-05-14 15:00:00,15
359,419,778,29,21.1,1,Mostly Clear,1.5,2021-05-14 16:00:00,16
377,543,920,29,20.8,0,Clear,0.7,2021-05-14 17:00:00,17
378,502,880,31,20.3,1,Mostly Clear,3.3,2021-05-14 18:00:00,18
266,329,595,43,19.2,0,Clear,7.2,2021-05-14 19:00:00,19
213,244,457,55,17.7,0,Clear,7.9,2021-05-14 20:00:00,20
165,172,337,61,15.7,0,Clear,8.9,2021-05-14 21:00:00,21
151,155,306,69,14.1,0,Clear,8.0,2021-05-14 22:00:00,22
129,167,296,73,12.8,0,Clear,7.7,2021-05-14 23:00:00,23
135,114,249,76,11.8,0,Clear,8.1,2021-05-15 00:00:00,0
61,39,100,78,11.0,0,Clear,8.3,2021-05-15 01:00:00,1
35,24,59,81,10.2,0,Clear,8.8,2021-05-15 02:00:00,2
7,6,13,80,9.6,0,Clear,8.1,2021-05-15 03:00:00,3
9,6,15,81,9.2,0,Clear,8.2,2021-05-15 04:00:00,4
11,14,25,80,8.8,0,Clear,8.6,2021-05-15 05:00:00,5
32,53,85,80,8.5,0,Clear,9.7,2021-05-15 06:00:00,6
56,103,159,81,9.3,0,Clear,10.4,2021-05-15 07:00:00,7
93,188,281,67,13.4,0,Clear,8.6,2021-05-15 08:00:00,8
249,258,507,58,16.6,0,Clear,5.5,2021-05-15 09:00:00,9
380,356,736,50,19.2,0,Clear,4.3,2021-05-15 10:00:00,10
551,445,996,41,21.3,0,Clear,2.5,2021-05-15 11:00:00,11
604,466,1070,30,22.4,0,Clear,1.3,2021-05-15 12:00:00,12
674,450,1124,28,22.7,1,Mostly Clear,0.8,2021-05-15 13:00:00,13
717,457,1174,28,22.9,0,Clear,1.8,2021-05-15 14:00:00,14
654,426,1080,26,23.7,0,Clear,3.2,2021-05-15 15:00:00,15
569,476,1045,25,23.9,1,Mostly Clear,4.7,2021-05-15 16:00:00,16
627,478,1105,25,23.5,2,Partly Cloudy,5.5,2021-05-15 17:00:00,17
571,376,947,30,22.6,1,Mostly Clear,3.7,2021-05-15 18:00:00,18
378,283,661,41,21.2,1,Mostly Clear,6.2,2021-05-15 19:00:00,19
265,224,489,50,19.3,1,Mostly Clear,7.9,2021-05-15 20:00:00,20
207,185,392,52,17.3,0,Clear,8.4,2021-05-15 21:00:00,21
192,141,333,58,15.7,0,Clear,9.8,2021-05-15 22:00:00,22
196,135,331,62,14.4,0,Clear,9.6,2021-05-15 23:00:00,23
150,94,244,65,13.6,0,Clear,8.9,2021-05-16 00:00:00,0
71,39,110,73,12.6,1,Mostly Clear,8.7,2021-05-16 01:00:00,1
28,24,52,82,11.6,1,Mostly Clear,7.6,2021-05-16 02:00:00,2
17,16,33,83,10.7,1,Mostly Clear,7.3,2021-05-16 03:00:00,3
10,8,18,86,10.2,1,Mostly Clear,6.9,2021-05-16 04:00:00,4
8,6,14,88,9.7,1,Mostly Clear,6.5,2021-05-16 05:00:00,5
29,27,56,88,9.6,1,Mostly Clear,5.8,2021-05-16 06:00:00,6
47,57,104,88,10.5,2,Partly Cloudy,7.3,2021-05-16 07:00:00,7
89,163,252,73,13.7,3,Cloudy,5.8,2021-05-16 08:00:00,8
185,239,424,63,15.4,3,Cloudy,5.5,2021-05-16 09:00:00,9
281,327,608,57,16.7,3,Cloudy,4.7,2021-05-16 10:00:00,10
423,365,788,53,17.7,2,Partly Cloudy,5.4,2021-05-16 11:00:00,11
493,465,958,46,19.5,2,Partly Cloudy,6.1,2021-05-16 12:00:00,12
528,404,932,39,21.5,3,Cloudy,6.1,2021-05-16 13:00:00,13
486,417,903,34,22.5,2,Partly Cloudy,8.1,2021-05-16 14:00:00,14
351,306,657,43,20.6,53,Heavy Drizzle,10.5,2021-05-16 15:00:00,15
308,276,584,47,19.4,51,Light Drizzle,11.8,2021-05-16 16:00:00,16
223,230,453,57,17.9,51,Light Drizzle,8.7,2021-05-16 17:00:00,17
178,242,420,63,17.0,2,Partly Cloudy,7.1,2021-05-16 18:00:00,18
194,239,433,67,16.4,2,Partly Cloudy,7.0,2021-05-16 19:00:00,19
122,136,258,70,15.7,2,Partly Cloudy,6.8,2021-05-16 20:00:00,20
78,106,184,72,14.9,2,Partly Cloudy,6.2,2021-05-16 21:00:00,21
96,84,180,74,14.4,2,Partly Cloudy,5.0,2021-05-16 22:00:00,22
63,42,105,78,13.9,2,Partly Cloudy,3.2,2021-05-16 23:00:00,23
25,25,50,85,13.4,3,Cloudy,2.9,2021-05-17 00:00:00,0
26,9,35,86,13.1,3,Cloudy,1.8,2021-05-17 01:00:00,1
8,3,11,89,12.5,2,Partly Cloudy,3.1,2021-05-17 02:00:00,2
7,6,13,92,12.7,2,Partly Cloudy,4.3,2021-05-17 03:00:00,3
14,10,24,93,12.1,0,Clear,5.1,2021-05-17 04:00:00,4
17,25,42,95,11.1,0,Clear,5.1,2021-05-17 05:00:00,5
45,92,137,98,10.0,1,Mostly Clear,5.2,2021-05-17 06:00:00,6
59,193,252,96,11.0,1,Mostly Clear,6.4,2021-05-17 07:00:00,7
101,340,441,84,14.6,0,Clear,2.6,2021-05-17 08:00:00,8
111,223,334,69,17.0,0,Clear,2.5,2021-05-17 09:00:00,9
142,212,354,56,19.0,1,Mostly Clear,2.1,2021-05-17 10:00:00,10
171,224,395,48,20.5,1,Mostly Clear,4.6,2021-05-17 11:00:00,11
214,245,459,43,21.6,2,Partly Cloudy,6.4,2021-05-17 12:00:00,12
228,231,459,40,22.4,2,Partly Cloudy,6.4,2021-05-17 13:00:00,13
226,240,466,39,22.5,3,Cloudy,6.3,2021-05-17 14:00:00,14
260,306,566,42,22.2,3,Cloudy,6.1,2021-05-17 15:00:00,15
230,384,614,43,22.1,3,Cloudy,6.9,2021-05-17 16:00:00,16
307,541,848,42,22.2,3,Cloudy,7.9,2021-05-17 17:00:00,17
317,553,870,44,21.7,2,Partly Cloudy,5.5,2021-05-17 18:00:00,18
299,387,686,51,20.8,2,Partly Cloudy,6.9,2021-05-17 19:00:00,19
175,268,443,59,19.3,2,Partly Cloudy,7.5,2021-05-17 20:00:00,20
110,144,254,62,18.1,1,Mostly Clear,7.1,2021-05-17 21:00:00,21
101,95,196,68,16.9,1,Mostly Clear,6.6,2021-05-17 22:00:00,22
61,44,105,74,15.7,1,Mostly Clear,7.2,2021-05-17 23:00:00,23
22,25,47,81,14.4,1,Mostly Clear,6.9,2021-05-18 00:00:00,0
16,7,23,87,13.4,1,Mostly Clear,6.9,2021-05-18 01:00:00,1
8,8,16,89,12.5,1,Mostly Clear,6.5,2021-05-18 02:00:00,2
4,3,7,87,12.0,1,Mostly Clear,6.6,2021-05-18 03:00:00,3
6,4,10,88,11.5,1,Mostly Clear,7.1,2021-05-18 04:00:00,4
14,42,56,88,11.1,1,Mostly Clear,6.6,2021-05-18 05:00:00,5
36,118,154,88,10.8,1,Mostly Clear,8.8,2021-05-18 06:00:00,6
84,250,334,86,12.0,0,Clear,6.4,2021-05-18 07:00:00,7
110,382,492,72,15.6,0,Clear,3.8,2021-05-18 08:00:00,8
126,254,380,61,18.3,0,Clear,2.9,2021-05-18 09:00:00,9
154,206,360,50,20.8,0,Clear,3.7,2021-05-18 10:00:00,10
169,271,440,44,22.6,0,Clear,3.3,2021-05-18 11:00:00,11
218,315,533,40,23.8,1,Mostly Clear,3.1,2021-05-18 12:00:00,12
215,252,467,38,24.6,2,Partly Cloudy,3.2,2021-05-18 13:00:00,13
222,256,478,35,25.4,2,Partly Cloudy,3.6,2021-05-18 14:00:00,14
212,283,495,33,25.5,1,Mostly Clear,4.3,2021-05-18 15:00:00,15
263,368,631,32,25.6,0,Clear,4.1,2021-05-18 16:00:00,16
353,584,937,32,25.8,0,Clear,2.9,2021-05-18 17:00:00,17
363,573,936,34,25.2,0,Clear,1.8,2021-05-18 18:00:00,18
314,451,765,42,23.7,0,Clear,5.6,2021-05-18 19:00:00,19
217,314,531,50,21.4,0,Clear,6.7,2021-05-18 20:00:00,20
117,215,332,54,19.3,0,Clear,9.6,2021-05-18 21:00:00,21
88,131,219,59,17.9,0,Clear,11.2,2021-05-18 22:00:00,22
73,93,166,62,16.8,0,Clear,12.0,2021-05-18 23:00:00,23
28,36,64,65,15.9,0,Clear,11.1,2021-05-19 00:00:00,0
16,12,28,66,15.2,0,Clear,10.3,2021-05-19 01:00:00,1
12,3,15,67,14.6,0,Clear,9.7,2021-05-19 02:00:00,2
6,5,11,74,14.0,0,Clear,8.3,2021-05-19 03:00:00,3
14,8,22,80,13.1,0,Clear,7.1,2021-05-19 04:00:00,4
18,41,59,85,12.4,0,Clear,6.4,2021-05-19 05:00:00,5
41,139,180,88,11.9,0,Clear,6.7,2021-05-19 06:00:00,6
76,249,325,89,13.0,0,Clear,7.9,2021-05-19 07:00:00,7
124,345,469,75,17.2,0,Clear,5.6,2021-05-19 08:00:00,8
115,267,382,67,20.3,0,Clear,5.1,2021-05-19 09:00:00,9
130,215,345,59,23.3,0,Clear,6.1,2021-05-19 10:00:00,10
177,267,444,48,25.5,0,Clear,6.2,2021-05-19 11:00:00,11
178,290,468,39,27.0,0,Clear,3.2,2021-05-19 12:00:00,12
237,268,505,35,28.1,0,Clear,2.0,2021-05-19 13:00:00,13
207,275,482,33,28.7,1,Mostly Clear,0.7,2021-05-19 14:00:00,14
252,316,568,32,29.0,1,Mostly Clear,1.5,2021-05-19 15:00:00,15
266,360,626,31,29.3,0,Clear,3.0,2021-05-19 16:00:00,16
396,553,949,31,29.2,0,Clear,4.3,2021-05-19 17:00:00,17
432,566,998,33,28.6,0,Clear,5.3,2021-05-19 18:00:00,18
297,471,768,39,27.1,1,Mostly Clear,5.6,2021-05-19 19:00:00,19
188,344,532,46,24.9,0,Clear,7.3,2021-05-19 20:00:00,20
147,197,344,48,22.8,1,Mostly Clear,8.8,2021-05-19 21:00:00,21
104,153,257,52,21.3,1,Mostly Clear,9.9,2021-05-19 22:00:00,22
80,83,163,57,20.1,1,Mostly Clear,9.9,2021-05-19 23:00:00,23
46,44,90,61,19.0,1,Mostly Clear,9.4,2021-05-20 00:00:00,0
10,8,18,64,18.1,0,Clear,9.0,2021-05-20 01:00:00,1
8,12,20,66,17.3,0,Clear,8.8,2021-05-20 02:00:00,2
7,4,11,63,16.5,0,Clear,9.0,2021-05-20 03:00:00,3
8,10,18,65,15.9,0,Clear,8.7,2021-05-20 04:00:00,4
16,26,42,68,15.3,0,Clear,8.4,2021-05-20 05:00:00,5
48,118,166,73,14.9,1,Mostly Clear,7.9,2021-05-20 06:00:00,6
82,258,340,76,15.7,1,Mostly Clear,9.2,2021-05-20 07:00:00,7
136,381,517,59,19.8,1,Mostly Clear,8.6,2021-05-20 08:00:00,8
124,236,360,50,23.5,1,Mostly Clear,6.4,2021-05-20 09:00:00,9
140,223,363,40,26.4,1,Mostly Clear,4.7,2021-05-20 10:00:00,10
176,199,375,35,28.3,1,Mostly Clear,3.9,2021-05-20 11:00:00,11
211,231,442,33,29.5,1,Mostly Clear,4.9,2021-05-20 12:00:00,12
223,254,477,33,30.3,1,Mostly Clear,6.8,2021-05-20 13:00:00,13
210,249,459,33,30.6,2,Partly Cloudy,8.8,2021-05-20 14:00:00,14
251,303,554,34,30.3,2,Partly Cloudy,10.1,2021-05-20 15:00:00,15
261,353,614,37,29.6,1,Mostly Clear,12.3,2021-05-20 16:00:00,16
346,574,920,40,29.1,1,Mostly Clear,13.9,2021-05-20 17:00:00,17
346,511,857,43,27.8,0,Clear,14.0,2021-05-20 18:00:00,18
282,438,720,49,25.7,1,Mostly Clear,14.5,2021-05-20 19:00:00,19
226,339,565,51,23.2,0,Clear,14.8,2021-05-20 20:00:00,20
124,218,342,50,21.2,1,Mostly Clear,12.7,2021-05-20 21:00:00,21
129,156,285,50,19.8,1,Mostly Clear,11.3,2021-05-20 22:00:00,22
102,91,193,53,18.7,1,Mostly Clear,9.7,2021-05-20 23:00:00,23
34,41,75,58,17.6,0,Clear,8.9,2021-05-21 00:00:00,0
13,17,30,65,16.5,0,Clear,7.8,2021-05-21 01:00:00,1
7,9,16,76,15.3,0,Clear,5.7,2021-05-21 02:00:00,2
4,8,12,74,15.3,0,Clear,6.6,2021-05-21 03:00:00,3
11,6,17,71,15.7,0,Clear,5.6,2021-05-21 04:00:00,4
14,30,44,73,15.5,0,Clear,4.8,2021-05-21 05:00:00,5
45,129,174,76,15.3,0,Clear,1.6,2021-05-21 06:00:00,6
98,273,371,79,15.4,0,Clear,2.8,2021-05-21 07:00:00,7
166,373,539,66,17.5,0,Clear,2.3,2021-05-21 08:00:00,8
141,299,440,53,19.5,0,Clear,2.9,2021-05-21 09:00:00,9
228,275,503,44,21.6,0,Clear,3.8,2021-05-21 10:00:00,10
224,257,481,38,23.5,0,Clear,5.0,2021-05-21 11:00:00,11
244,314,558,36,25.1,0,Clear,5.2,2021-05-21 12:00:00,12
309,309,618,35,26.4,0,Clear,4.9,2021-05-21 13:00:00,13
326,286,612,34,27.4,0,Clear,4.6,2021-05-21 14:00:00,14
358,321,679,32,28.1,0,Clear,4.7,2021-05-21 15:00:00,15
399,407,806,32,28.4,1,Mostly Clear,5.3,2021-05-21 16:00:00,16
466,542,1008,33,28.2,1,Mostly Clear,7.1,2021-05-21 17:00:00,17
391,521,912,35,27.4,1,Mostly Clear,6.7,2021-05-21 18:00:00,18
365,407,772,40,25.9,1,Mostly Clear,8.6,2021-05-21 19:00:00,19
288,297,585,48,23.7,1,Mostly Clear,8.8,2021-05-21 20:00:00,20
225,212,437,51,21.9,1,Mostly Clear,9.4,2021-05-21 21:00:00,21
199,175,374,56,20.5,1,Mostly Clear,9.2,2021-05-21 22:00:00,22
184,132,316,60,19.4,1,Mostly Clear,9.0,2021-05-21 23:00:00,23
177,138,315,65,18.5,1,Mostly Clear,8.9,2021-05-22 00:00:00,0
111,68,179,69,17.6,1,Mostly Clear,9.4,2021-05-22 01:00:00,1
58,52,110,72,17.0,1,Mostly Clear,9.7,2021-05-22 02:00:00,2
24,15,39,70,16.8,1,Mostly Clear,9.2,2021-05-22 03:00:00,3
7,8,15,71,16.3,1,Mostly Clear,9.0,2021-05-22 04:00:00,4
21,20,41,71,15.9,1,Mostly Clear,9.1,2021-05-22 05:00:00,5
23,53,76,75,15.6,1,Mostly Clear,8.0,2021-05-22 06:00:00,6
65,115,180,78,16.2,1,Mostly Clear,8.5,2021-05-22 07:00:00,7
152,198,350,61,19.8,1,Mostly Clear,7.6,2021-05-22 08:00:00,8
263,311,574,52,23.0,1,Mostly Clear,8.0,2021-05-22 09:00:00,9
412,366,778,45,26.1,1,Mostly Clear,9.0,2021-05-22 10:00:00,10
484,413,897,41,28.4,1,Mostly Clear,10.3,2021-05-22 11:00:00,11
530,430,960,37,30.3,1,Mostly Clear,12.5,2021-05-22 12:00:00,12
584,408,992,33,31.3,2,Partly Cloudy,14.0,2021-05-22 13:00:00,13
607,440,1047,31,31.9,1,Mostly Clear,13.2,2021-05-22 14:00:00,14
561,428,989,33,31.6,1,Mostly Clear,14.6,2021-05-22 15:00:00,15
505,377,882,32,31.6,1,Mostly Clear,15.3,2021-05-22 16:00:00,16
401,394,795,33,31.2,1,Mostly Clear,15.5,2021-05-22 17:00:00,17
432,337,769,35,30.4,1,Mostly Clear,12.4,2021-05-22 18:00:00,18
387,359,746,38,29.2,1,Mostly Clear,11.4,2021-05-22 19:00:00,19
284,246,530,44,27.4,1,Mostly Clear,11.4,2021-05-22 20:00:00,20
220,190,410,46,26.2,1,Mostly Clear,12.7,2021-05-22 21:00:00,21
212,145,357,48,25.5,1,Mostly Clear,13.5,2021-05-22 22:00:00,22
230,152,382,49,24.9,1,Mostly Clear,12.7,2021-05-22 23:00:00,23
183,119,302,52,24.2,2,Partly Cloudy,11.3,2021-05-23 00:00:00,0
102,83,185,55,23.6,0,Clear,10.5,2021-05-23 01:00:00,1
68,46,114,58,23.1,0,Clear,10.8,2021-05-23 02:00:00,2
23,16,39,57,22.4,0,Clear,11.1,2021-05-23 03:00:00,3
20,16,36,60,21.7,0,Clear,10.6,2021-05-23 04:00:00,4
17,25,42,62,21.1,0,Clear,10.3,2021-05-23 05:00:00,5
33,42,75,66,20.6,1,Mostly Clear,10.8,2021-05-23 06:00:00,6
56,86,142,66,21.2,1,Mostly Clear,11.1,2021-05-23 07:00:00,7
122,162,284,61,23.1,1,Mostly Clear,10.9,2021-05-23 08:00:00,8
256,264,520,53,25.4,0,Clear,12.5,2021-05-23 09:00:00,9
337,355,692,48,27.3,1,Mostly Clear,15.4,2021-05-23 10:00:00,10
431,347,778,44,29.2,1,Mostly Clear,14.3,2021-05-23 11:00:00,11
474,361,835,42,30.2,2,Partly Cloudy,14.8,2021-05-23 12:00:00,12
457,356,813,41,30.7,1,Mostly Clear,17.1,2021-05-23 13:00:00,13
412,335,747,39,31.5,1,Mostly Clear,17.1,2021-05-23 14:00:00,14
447,371,818,38,31.7,0,Clear,17.8,2021-05-23 15:00:00,15
421,342,763,36,32.4,0,Clear,18.1,2021-05-23 16:00:00,16
337,333,670,35,32.2,0,Clear,18.6,2021-05-23 17:00:00,17
302,289,591,37,31.6,0,Clear,14.0,2021-05-23 18:00:00,18
241,274,515,40,30.8,0,Clear,10.6,2021-05-23 19:00:00,19
193,204,397,46,29.2,1,Mostly Clear,9.7,2021-05-23 20:00:00,20
162,156,318,49,27.9,1,Mostly Clear,9.7,2021-05-23 21:00:00,21
127,124,251,53,26.7,1,Mostly Clear,11.4,2021-05-23 22:00:00,22
93,51,144,57,25.7,2,Partly Cloudy,12.3,2021-05-23 23:00:00,23
41,35,76,60,24.9,1,Mostly Clear,12.3,2021-05-24 00:00:00,0
17,14,31,64,24.1,1,Mostly Clear,11.6,2021-05-24 01:00:00,1
13,10,23,68,23.5,1,Mostly Clear,11.7,2021-05-24 02:00:00,2
7,7,14,68,23.9,1,Mostly Clear,12.3,2021-05-24 03:00:00,3
9,9,18,70,23.4,2,Partly Cloudy,13.0,2021-05-24 04:00:00,4
12,27,39,72,22.8,1,Mostly Clear,12.5,2021-05-24 05:00:00,5
38,79,117,78,22.0,53,Heavy Drizzle,9.0,2021-05-24 06:00:00,6
41,126,167,82,21.3,3,Cloudy,11.5,2021-05-24 07:00:00,7
73,223,296,81,20.9,3,Cloudy,13.6,2021-05-24 08:00:00,8
91,193,284,74,20.9,3,Cloudy,11.2,2021-05-24 09:00:00,9
120,178,298,68,21.2,3,Cloudy,10.2,2021-05-24 10:00:00,10
143,175,318,65,21.4,51,Light Drizzle,9.9,2021-05-24 11:00:00,11
157,225,382,61,22.2,3,Cloudy,10.7,2021-05-24 12:00:00,12
148,161,309,59,22.4,3,Cloudy,12.7,2021-05-24 13:00:00,13
81,98,179,60,21.8,3,Cloudy,12.7,2021-05-24 14:00:00,14
88,142,230,86,17.8,53,Heavy Drizzle,12.5,2021-05-24 15:00:00,15
56,102,158,87,17.0,53,Heavy Drizzle,13.4,2021-05-24 16:00:00,16
34,120,154,84,17.0,51,Light Drizzle,13.0,2021-05-24 17:00:00,17
51,131,182,89,16.4,53,Heavy Drizzle,10.0,2021-05-24 18:00:00,18
64,167,231,90,16.2,51,Light Drizzle,9.4,2021-05-24 19:00:00,19
53,99,152,90,16.2,3,Cloudy,8.3,2021-05-24 20:00:00,20
57,78,135,89,16.2,3,Cloudy,9.1,2021-05-24 21:00:00,21
55,75,130,89,16.2,3,Cloudy,9.4,2021-05-24 22:00:00,22
37,41,78,87,16.2,3,Cloudy,9.7,2021-05-24 23:00:00,23
27,26,53,87,16.2,3,Cloudy,8.8,2021-05-25 00:00:00,0
13,10,23,86,16.1,3,Cloudy,7.9,2021-05-25 01:00:00,1
6,7,13,85,16.2,3,Cloudy,7.7,2021-05-25 02:00:00,2
6,5,11,91,14.8,3,Cloudy,7.4,2021-05-25 03:00:00,3
9,10,19,89,14.8,3,Cloudy,6.7,2021-05-25 04:00:00,4
11,30,41,88,14.9,2,Partly Cloudy,6.0,2021-05-25 05:00:00,5
45,127,172,88,14.9,3,Cloudy,5.5,2021-05-25 06:00:00,6
69,261,330,86,15.2,3,Cloudy,6.1,2021-05-25 07:00:00,7
120,356,476,83,16.0,3,Cloudy,7.0,2021-05-25 08:00:00,8
111,233,344,77,17.3,3,Cloudy,8.4,2021-05-25 09:00:00,9
128,203,331,74,18.9,3,Cloudy,8.9,2021-05-25 10:00:00,10
213,230,443,69,21.0,3,Cloudy,8.4,2021-05-25 11:00:00,11
146,283,429,66,22.6,3,Cloudy,9.5,2021-05-25 12:00:00,12
199,234,433,62,24.1,3,Cloudy,9.7,2021-05-25 13:00:00,13
229,262,491,58,25.5,3,Cloudy,9.8,2021-05-25 14:00:00,14
234,302,536,62,24.8,3,Cloudy,9.8,2021-05-25 15:00:00,15
262,388,650,61,25.3,3,Cloudy,10.2,2021-05-25 16:00:00,16
334,599,933,59,26.0,3,Cloudy,10.7,2021-05-25 17:00:00,17
356,577,933,60,25.8,1,Mostly Clear,9.0,2021-05-25 18:00:00,18
299,434,733,66,24.5,0,Clear,9.8,2021-05-25 19:00:00,19
230,322,552,74,22.7,0,Clear,9.7,2021-05-25 20:00:00,20
114,202,316,79,21.4,0,Clear,10.4,2021-05-25 21:00:00,21
131,154,285,83,20.7,0,Clear,10.9,2021-05-25 22:00:00,22
81,62,143,85,20.3,0,Clear,11.3,2021-05-25 23:00:00,23
44,31,75,87,20.1,0,Clear,10.7,2021-05-26 00:00:00,0
19,15,34,88,20.0,1,Mostly Clear,10.1,2021-05-26 01:00:00,1
6,7,13,89,20.1,1,Mostly Clear,10.4,2021-05-26 02:00:00,2
2,7,9,92,19.9,0,Clear,10.6,2021-05-26 03:00:00,3
11,9,20,93,19.9,0,Clear,10.0,2021-05-26 04:00:00,4
13,36,49,94,20.0,0,Clear,10.2,2021-05-26 05:00:00,5
51,137,188,95,20.1,0,Clear,8.8,2021-05-26 06:00:00,6
55,250,305,92,21.0,1,Mostly Clear,8.9,2021-05-26 07:00:00,7
125,370,495,84,23.1,1,Mostly Clear,7.4,2021-05-26 08:00:00,8
100,266,366,74,25.5,2,Partly Cloudy,6.1,2021-05-26 09:00:00,9
135,209,344,66,27.4,1,Mostly Clear,5.2,2021-05-26 10:00:00,10
149,222,371,58,29.4,1,Mostly Clear,5.1,2021-05-26 11:00:00,11
161,259,420,49,31.5,0,Clear,5.1,2021-05-26 12:00:00,12
154,222,376,40,33.0,0,Clear,6.3,2021-05-26 13:00:00,13
192,212,404,37,33.6,0,Clear,8.1,2021-05-26 14:00:00,14
212,265,477,42,33.1,1,Mostly Clear,10.0,2021-05-26 15:00:00,15
231,324,555,39,33.5,1,Mostly Clear,11.8,2021-05-26 16:00:00,16
176,333,509,37,33.2,1,Mostly Clear,11.8,2021-05-26 17:00:00,17
227,468,695,37,33.0,1,Mostly Clear,5.7,2021-05-26 18:00:00,18
262,384,646,44,30.2,51,Light Drizzle,4.5,2021-05-26 19:00:00,19
95,173,268,47,29.2,1,Mostly Clear,4.0,2021-05-26 20:00:00,20
25,78,103,49,27.5,1,Mostly Clear,8.6,2021-05-26 21:00:00,21
69,78,147,52,26.5,2,Partly Cloudy,7.5,2021-05-26 22:00:00,22
70,64,134,55,25.5,1,Mostly Clear,6.6,2021-05-26 23:00:00,23
20,30,50,57,25.0,0,Clear,8.4,2021-05-27 00:00:00,0
11,9,20,61,24.3,0,Clear,12.5,2021-05-27 01:00:00,1
3,4,7,66,23.6,0,Clear,13.0,2021-05-27 02:00:00,2
7,3,10,87,20.6,0,Clear,11.9,2021-05-27 03:00:00,3
9,6,15,87,20.2,0,Clear,11.1,2021-05-27 04:00:00,4
13,47,60,88,19.9,0,Clear,11.0,2021-05-27 05:00:00,5
43,111,154,90,19.4,0,Clear,7.1,2021-05-27 06:00:00,6
94,227,321,89,19.8,0,Clear,9.0,2021-05-27 07:00:00,7
132,357,489,83,21.4,0,Clear,7.4,2021-05-27 08:00:00,8
123,233,356,72,22.9,1,Mostly Clear,9.2,2021-05-27 09:00:00,9
155,230,385,64,24.5,1,Mostly Clear,10.4,2021-05-27 10:00:00,10
193,211,404,56,25.9,1,Mostly Clear,10.5,2021-05-27 11:00:00,11
192,266,458,49,27.1,1,Mostly Clear,9.9,2021-05-27 12:00:00,12
197,250,447,43,28.2,1,Mostly Clear,10.5,2021-05-27 13:00:00,13
212,264,476,38,29.1,1,Mostly Clear,9.2,2021-05-27 14:00:00,14
265,262,527,38,29.3,1,Mostly Clear,8.9,2021-05-27 15:00:00,15
288,383,671,35,29.9,0,Clear,10.0,2021-05-27 16:00:00,16
350,544,894,34,29.9,1,Mostly Clear,10.5,2021-05-27 17:00:00,17
357,560,917,34,29.5,1,Mostly Clear,9.2,2021-05-27 18:00:00,18
286,406,692,39,28.3,1,Mostly Clear,6.8,2021-05-27 19:00:00,19
230,345,575,45,26.7,1,Mostly Clear,5.1,2021-05-27 20:00:00,20
182,233,415,49,25.1,1,Mostly Clear,6.6,2021-05-27 21:00:00,21
119,150,269,58,23.5,1,Mostly Clear,6.8,2021-05-27 22:00:00,22
114,89,203,60,22.4,1,Mostly Clear,6.8,2021-05-27 23:00:00,23
72,53,125,58,21.8,1,Mostly Clear,6.6,2021-05-28 00:00:00,0
23,16,39,54,21.4,1,Mostly Clear,6.5,2021-05-28 01:00:00,1
14,13,27,53,20.6,1,Mostly Clear,8.0,2021-05-28 02:00:00,2
11,6,17,72,20.1,1,Mostly Clear,10.0,2021-05-28 03:00:00,3
8,13,21,72,19.7,1,Mostly Clear,11.7,2021-05-28 04:00:00,4
9,33,42,74,19.4,1,Mostly Clear,13.1,2021-05-28 05:00:00,5
47,105,152,73,19.3,2,Partly Cloudy,13.5,2021-05-28 06:00:00,6
78,218,296,70,19.7,2,Partly Cloudy,13.4,2021-05-28 07:00:00,7
97,274,371,65,20.9,2,Partly Cloudy,14.9,2021-05-28 08:00:00,8
141,246,387,64,21.9,2,Partly Cloudy,14.2,2021-05-28 09:00:00,9
198,224,422,62,23.0,3,Cloudy,13.4,2021-05-28 10:00:00,10
236,262,498,60,24.7,3,Cloudy,13.3,2021-05-28 11:00:00,11
319,321,640,59,25.9,3,Cloudy,13.7,2021-05-28 12:00:00,12
278,258,536,56,26.9,3,Cloudy,16.2,2021-05-28 13:00:00,13
205,239,444,58,26.9,51,Light Drizzle,16.8,2021-05-28 14:00:00,14
314,336,650,76,22.4,55,Heavy Drizzle,14.8,2021-05-28 15:00:00,15
317,325,642,77,22.7,53,Heavy Drizzle,12.9,2021-05-28 16:00:00,16
245,337,582,76,23.1,53,Heavy Drizzle,12.6,2021-05-28 17:00:00,17
203,272,475,78,22.5,53,Heavy Drizzle,10.8,2021-05-28 18:00:00,18
19,36,55,85,21.5,61,Light Rain,10.9,2021-05-28 19:00:00,19
32,73,105,89,20.5,63,Rain,13.6,2021-05-28 20:00:00,20
42,54,96,94,19.8,63,Rain,15.3,2021-05-28 21:00:00,21
24,34,58,96,19.7,53,Heavy Drizzle,14.3,2021-05-28 22:00:00,22
45,74,119,97,19.6,51,Light Drizzle,14.0,2021-05-28 23:00:00,23
34,36,70,98,18.8,51,Light Drizzle,14.8,2021-05-29 00:00:00,0
24,27,51,98,16.8,51,Light Drizzle,15.1,2021-05-29 01:00:00,1
15,12,27,97,14.3,51,Light Drizzle,14.6,2021-05-29 02:00:00,2
5,2,7,98,14.0,55,Heavy Drizzle,14.9,2021-05-29 03:00:00,3
0,3,3,99,13.7,61,Light Rain,15.1,2021-05-29 04:00:00,4
6,2,8,99,13.4,63,Rain,16.4,2021-05-29 05:00:00,5
12,21,33,99,13.0,63,Rain,15.3,2021-05-29 06:00:00,6
12,26,38,98,12.6,63,Rain,14.2,2021-05-29 07:00:00,7
17,55,72,97,12.2,63,Rain,14.2,2021-05-29 08:00:00,8
37,77,114,96,11.8,63,Rain,15.3,2021-05-29 09:00:00,9
39,75,114,95,11.4,63,Rain,16.3,2021-05-29 10:00:00,10
67,105,172,95,11.2,55,Heavy Drizzle,17.0,2021-05-29 11:00:00,11
139,160,299,92,11.4,51,Light Drizzle,18.2,2021-05-29 12:00:00,12
98,121,219,90,11.6,3,Cloudy,17.4,2021-05-29 13:00:00,13
109,150,259,88,11.9,3,Cloudy,16.9,2021-05-29 14:00:00,14
132,190,322,87,11.6,51,Light Drizzle,16.4,2021-05-29 15:00:00,15
204,199,403,88,11.6,53,Heavy Drizzle,16.6,2021-05-29 16:00:00,16
191,192,383,88,11.5,51,Light Drizzle,16.7,2021-05-29 17:00:00,17
102,131,233,88,11.2,51,Light Drizzle,11.3,2021-05-29 18:00:00,18
73,121,194,87,11.2,3,Cloudy,12.7,2021-05-29 19:00:00,19
75,79,154,86,11.2,3,Cloudy,12.8,2021-05-29 20:00:00,20
65,92,157,85,11.3,3,Cloudy,14.1,2021-05-29 21:00:00,21
65,64,129,84,11.3,3,Cloudy,13.4,2021-05-29 22:00:00,22
53,63,116,82,11.3,3,Cloudy,13.5,2021-05-29 23:00:00,23
42,43,85,81,11.2,3,Cloudy,14.2,2021-05-30 00:00:00,0
35,31,66,84,10.9,55,Heavy Drizzle,13.7,2021-05-30 01:00:00,1
28,17,45,87,10.4,61,Light Rain,14.0,2021-05-30 02:00:00,2
18,11,29,96,9.7,51,Light Drizzle,13.9,2021-05-30 03:00:00,3
5,2,7,96,9.5,61,Light Rain,13.6,2021-05-30 04:00:00,4
2,6,8,95,9.5,53,Heavy Drizzle,13.6,2021-05-30 05:00:00,5
9,12,21,95,9.4,51,Light Drizzle,12.8,2021-05-30 06:00:00,6
19,36,55,94,9.5,51,Light Drizzle,13.9,2021-05-30 07:00:00,7
51,87,138,91,9.7,3,Cloudy,14.8,2021-05-30 08:00:00,8
94,114,208,89,9.9,51,Light Drizzle,17.0,2021-05-30 09:00:00,9
177,194,371,89,10.1,51,Light Drizzle,16.9,2021-05-30 10:00:00,10
384,219,603,87,10.4,3,Cloudy,13.6,2021-05-30 11:00:00,11
404,275,679,85,11.0,51,Light Drizzle,12.1,2021-05-30 12:00:00,12
432,268,700,84,11.5,51,Light Drizzle,11.9,2021-05-30 13:00:00,13
353,206,559,82,12.2,51,Light Drizzle,12.3,2021-05-30 14:00:00,14
443,230,673,78,12.3,3,Cloudy,12.5,2021-05-30 15:00:00,15
347,240,587,77,12.7,53,Heavy Drizzle,12.6,2021-05-30 16:00:00,16
286,205,491,78,12.8,53,Heavy Drizzle,12.3,2021-05-30 17:00:00,17
301,230,531,78,12.8,51,Light Drizzle,9.1,2021-05-30 18:00:00,18
192,172,364,80,12.6,3,Cloudy,8.8,2021-05-30 19:00:00,19
130,132,262,81,12.5,3,Cloudy,7.8,2021-05-30 20:00:00,20
117,103,220,81,12.5,3,Cloudy,6.7,2021-05-30 21:00:00,21
92,83,175,81,12.4,3,Cloudy,6.1,2021-05-30 22:00:00,22
100,78,178,84,11.9,3,Cloudy,6.5,2021-05-30 23:00:00,23
77,61,138,90,10.8,2,Partly Cloudy,5.5,2021-05-31 00:00:00,0
33,21,54,92,9.9,1,Mostly Clear,8.3,2021-05-31 01:00:00,1
20,8,28,93,9.4,1,Mostly Clear,9.1,2021-05-31 02:00:00,2
9,7,16,92,10.1,0,Clear,7.6,2021-05-31 03:00:00,3
7,6,13,93,9.4,0,Clear,5.9,2021-05-31 04:00:00,4
11,13,24,93,8.9,1,Mostly Clear,6.8,2021-05-31 05:00:00,5
27,46,73,93,8.9,0,Clear,7.2,2021-05-31 06:00:00,6
33,64,97,91,10.5,0,Clear,8.6,2021-05-31 07:00:00,7
111,112,223,82,12.9,0,Clear,8.1,2021-05-31 08:00:00,8
244,189,433,75,14.8,0,Clear,9.5,2021-05-31 09:00:00,9
402,266,668,68,16.7,0,Clear,10.8,2021-05-31 10:00:00,10
503,303,806,59,18.5,1,Mostly Clear,13.9,2021-05-31 11:00:00,11
610,336,946,53,19.9,2,Partly Cloudy,12.7,2021-05-31 12:00:00,12
647,419,1066,48,21.0,2,Partly Cloudy,11.2,2021-05-31 13:00:00,13
740,417,1157,46,21.5,1,Mostly Clear,9.7,2021-05-31 14:00:00,14
633,409,1042,44,22.0,0,Clear,7.6,2021-05-31 15:00:00,15
567,405,972,43,22.5,0,Clear,7.6,2021-05-31 16:00:00,16
503,404,907,43,22.7,0,Clear,7.2,2021-05-31 17:00:00,17
438,405,843,44,22.4,0,Clear,7.1,2021-05-31 18:00:00,18
304,278,582,52,21.5,0,Clear,5.1,2021-05-31 19:00:00,19
206,233,439,65,20.2,0,Clear,5.1,2021-05-31 20:00:00,20
174,167,341,71,18.0,0,Clear,5.5,2021-05-31 21:00:00,21
109,138,247,78,16.2,0,Clear,5.8,2021-05-31 22:00:00,22
74,50,124,81,15.1,0,Clear,6.4,2021-05-31 23:00:00,23
31,11,42,83,14.3,0,Clear,7.2,2021-06-01 00:00:00,0
19,10,29,84,13.7,1,Mostly Clear,7.6,2021-06-01 01:00:00,1
6,9,15,86,13.2,1,Mostly Clear,7.1,2021-06-01 02:00:00,2
5,2,7,86,12.7,1,Mostly Clear,7.2,2021-06-01 03:00:00,3
7,13,20,88,12.3,1,Mostly Clear,7.7,2021-06-01 04:00:00,4
11,37,48,90,12.1,1,Mostly Clear,7.9,2021-06-01 05:00:00,5
38,109,147,91,12.0,1,Mostly Clear,9.1,2021-06-01 06:00:00,6
68,236,304,91,13.0,1,Mostly Clear,9.7,2021-06-01 07:00:00,7
137,315,452,80,16.5,1,Mostly Clear,7.6,2021-06-01 08:00:00,8
106,241,347,72,18.8,1,Mostly Clear,7.8,2021-06-01 09:00:00,9
142,186,328,66,20.8,0,Clear,8.3,2021-06-01 10:00:00,10
198,195,393,60,22.5,1,Mostly Clear,8.8,2021-06-01 11:00:00,11
163,257,420,54,23.6,2,Partly Cloudy,10.2,2021-06-01 12:00:00,12
172,252,424,51,24.4,3,Cloudy,10.3,2021-06-01 13:00:00,13
204,255,459,49,24.9,3,Cloudy,8.8,2021-06-01 14:00:00,14
226,253,479,51,24.7,3,Cloudy,7.9,2021-06-01 15:00:00,15
273,352,625,51,24.7,2,Partly Cloudy,8.9,2021-06-01 16:00:00,16
311,544,855,54,24.2,1,Mostly Clear,11.2,2021-06-01 17:00:00,17
302,565,867,62,23.1,2,Partly Cloudy,9.4,2021-06-01 18:00:00,18
240,370,610,68,21.9,2,Partly Cloudy,9.4,2021-06-01 19:00:00,19
187,278,465,74,20.7,1,Mostly Clear,11.0,2021-06-01 20:00:00,20
131,154,285,76,19.8,1,Mostly Clear,11.3,2021-06-01 21:00:00,21
90,99,189,78,19.2,1,Mostly Clear,11.2,2021-06-01 22:00:00,22
78,73,151,79,18.7,1,Mostly Clear,10.2,2021-06-01 23:00:00,23
18,13,31,79,18.3,1,Mostly Clear,9.9,2021-06-02 00:00:00,0
17,5,22,78,18.0,2,Partly Cloudy,9.3,2021-06-02 01:00:00,1
4,1,5,79,17.6,2,Partly Cloudy,9.2,2021-06-02 02:00:00,2
4,4,8,85,17.3,3,Cloudy,8.6,2021-06-02 03:00:00,3
5,3,8,85,17.0,3,Cloudy,7.7,2021-06-02 04:00:00,4
23,44,67,85,16.9,3,Cloudy,7.6,2021-06-02 05:00:00,5
40,131,171,87,16.6,1,Mostly Clear,7.3,2021-06-02 06:00:00,6
66,250,316,87,16.9,1,Mostly Clear,7.9,2021-06-02 07:00:00,7
137,407,544,82,18.0,1,Mostly Clear,7.2,2021-06-02 08:00:00,8
117,235,352,82,18.2,2,Partly Cloudy,7.6,2021-06-02 09:00:00,9
105,215,320,77,19.7,3,Cloudy,7.2,2021-06-02 10:00:00,10
166,233,399,71,21.7,3,Cloudy,6.5,2021-06-02 11:00:00,11
202,213,415,65,23.5,2,Partly Cloudy,8.0,2021-06-02 12:00:00,12
196,234,430,58,24.9,2,Partly Cloudy,10.9,2021-06-02 13:00:00,13
223,255,478,55,25.2,2,Partly Cloudy,11.8,2021-06-02 14:00:00,14
260,297,557,55,25.2,2,Partly Cloudy,13.3,2021-06-02 15:00:00,15
255,397,652,54,25.6,2,Partly Cloudy,14.6,2021-06-02 16:00:00,16
331,561,892,56,25.1,3,Cloudy,15.5,2021-06-02 17:00:00,17
339,537,876,62,24.0,2,Partly Cloudy,12.5,2021-06-02 18:00:00,18
295,449,744,67,22.7,2,Partly Cloudy,14.0,2021-06-02 19:00:00,19
199,296,495,70,21.5,3,Cloudy,13.9,2021-06-02 20:00:00,20
131,172,303,70,20.4,3,Cloudy,12.9,2021-06-02 21:00:00,21
88,133,221,74,19.5,3,Cloudy,12.9,2021-06-02 22:00:00,22
68,67,135,78,18.9,3,Cloudy,11.8,2021-06-02 23:00:00,23
26,25,51,82,18.5,3,Cloudy,10.7,2021-06-03 00:00:00,0
12,9,21,86,18.2,3,Cloudy,11.0,2021-06-03 01:00:00,1
12,8,20,90,17.9,51,Light Drizzle,9.3,2021-06-03 02:00:00,2
5,3,8,94,18.7,3,Cloudy,8.5,2021-06-03 03:00:00,3
7,11,18,96,18.6,51,Light Drizzle,7.9,2021-06-03 04:00:00,4
17,36,53,98,18.6,3,Cloudy,7.9,2021-06-03 05:00:00,5
35,107,142,99,18.7,3,Cloudy,6.4,2021-06-03 06:00:00,6
62,222,284,98,19.1,3,Cloudy,6.6,2021-06-03 07:00:00,7
131,380,511,96,19.8,3,Cloudy,9.6,2021-06-03 08:00:00,8
126,247,373,93,20.6,3,Cloudy,10.8,2021-06-03 09:00:00,9
143,219,362,83,22.3,51,Light Drizzle,11.2,2021-06-03 10:00:00,10
196,223,419,74,24.2,3,Cloudy,12.2,2021-06-03 11:00:00,11
190,253,443,68,25.6,3,Cloudy,9.8,2021-06-03 12:00:00,12
225,242,467,66,26.7,2,Partly Cloudy,9.3,2021-06-03 13:00:00,13
250,249,499,65,27.3,2,Partly Cloudy,8.7,2021-06-03 14:00:00,14
256,309,565,69,27.5,2,Partly Cloudy,9.6,2021-06-03 15:00:00,15
241,336,577,63,28.0,51,Light Drizzle,11.4,2021-06-03 16:00:00,16
253,518,771,80,24.5,63,Rain,14.3,2021-06-03 17:00:00,17
104,191,295,86,23.4,63,Rain,11.9,2021-06-03 18:00:00,18
95,190,285,88,23.3,51,Light Drizzle,8.8,2021-06-03 19:00:00,19
110,187,297,89,22.7,2,Partly Cloudy,9.7,2021-06-03 20:00:00,20
125,158,283,92,22.1,2,Partly Cloudy,10.7,2021-06-03 21:00:00,21
70,115,185,94,21.8,3,Cloudy,11.8,2021-06-03 22:00:00,22
83,72,155,94,21.7,3,Cloudy,13.4,2021-06-03 23:00:00,23
43,43,86,95,21.6,3,Cloudy,14.0,2021-06-04 00:00:00,0
8,12,20,95,21.4,3,Cloudy,13.5,2021-06-04 01:00:00,1
15,7,22,95,21.3,3,Cloudy,13.0,2021-06-04 02:00:00,2
9,8,17,97,21.2,3,Cloudy,11.5,2021-06-04 03:00:00,3
7,7,14,97,21.2,3,Cloudy,10.9,2021-06-04 04:00:00,4
20,31,51,97,21.1,3,Cloudy,10.0,2021-06-04 05:00:00,5
42,111,153,98,20.9,3,Cloudy,7.3,2021-06-04 06:00:00,6
69,253,322,97,21.1,3,Cloudy,7.9,2021-06-04 07:00:00,7
123,351,474,93,21.9,3,Cloudy,8.7,2021-06-04 08:00:00,8
125,259,384,89,22.4,55,Heavy Drizzle,7.7,2021-06-04 09:00:00,9
170,232,402,90,22.4,61,Light Rain,8.0,2021-06-04 10:00:00,10
240,258,498,90,23.0,51,Light Drizzle,8.7,2021-06-04 11:00:00,11
186,238,424,84,24.3,51,Light Drizzle,6.5,2021-06-04 12:00:00,12
198,196,394,75,26.0,51,Light Drizzle,7.6,2021-06-04 13:00:00,13
260,263,523,59,27.5,51,Light Drizzle,8.0,2021-06-04 14:00:00,14
284,326,610,65,27.7,51,Light Drizzle,10.5,2021-06-04 15:00:00,15
301,409,710,60,28.0,1,Mostly Clear,10.9,2021-06-04 16:00:00,16
409,557,966,57,27.6,51,Light Drizzle,11.6,2021-06-04 17:00:00,17
414,537,951,55,27.0,1,Mostly Clear,11.8,2021-06-04 18:00:00,18
348,417,765,64,25.9,0,Clear,5.5,2021-06-04 19:00:00,19
301,318,619,73,25.1,0,Clear,5.6,2021-06-04 20:00:00,20
180,227,407,77,23.5,0,Clear,6.5,2021-06-04 21:00:00,21
161,173,334,81,22.1,0,Clear,6.6,2021-06-04 22:00:00,22
148,160,308,84,21.0,0,Clear,6.8,2021-06-04 23:00:00,23
149,112,261,84,20.4,0,Clear,7.2,2021-06-05 00:00:00,0
128,69,197,80,20.1,0,Clear,7.2,2021-06-05 01:00:00,1
73,44,117,77,19.8,0,Clear,7.6,2021-06-05 02:00:00,2
25,16,41,79,19.2,0,Clear,8.7,2021-06-05 03:00:00,3
22,7,29,81,18.7,0,Clear,9.1,2021-06-05 04:00:00,4
23,22,45,83,18.3,0,Clear,9.4,2021-06-05 05:00:00,5
36,44,80,84,17.9,0,Clear,9.9,2021-06-05 06:00:00,6
56,96,152,83,19.0,0,Clear,10.9,2021-06-05 07:00:00,7
145,197,342,72,22.2,0,Clear,9.5,2021-06-05 08:00:00,8
250,313,563,65,24.6,0,Clear,10.4,2021-06-05 09:00:00,9
376,374,750,59,26.7,0,Clear,11.2,2021-06-05 10:00:00,10
452,426,878,54,28.5,0,Clear,10.3,2021-06-05 11:00:00,11
512,437,949,49,30.0,0,Clear,9.2,2021-06-05 12:00:00,12
515,418,933,44,31.2,0,Clear,7.5,2021-06-05 13:00:00,13
545,366,911,41,31.8,0,Clear,7.0,2021-06-05 14:00:00,14
492,380,872,39,31.7,1,Mostly Clear,8.4,2021-06-05 15:00:00,15
498,389,887,41,31.0,1,Mostly Clear,9.4,2021-06-05 16:00:00,16
403,289,692,43,30.4,1,Mostly Clear,9.7,2021-06-05 17:00:00,17
327,331,658,47,29.7,1,Mostly Clear,11.9,2021-06-05 18:00:00,18
350,323,673,54,28.2,1,Mostly Clear,10.7,2021-06-05 19:00:00,19
288,313,601,60,26.6,1,Mostly Clear,10.5,2021-06-05 20:00:00,20
204,168,372,62,25.2,0,Clear,10.1,2021-06-05 21:00:00,21
191,176,367,66,24.1,0,Clear,10.4,2021-06-05 22:00:00,22
227,148,375,69,23.3,0,Clear,10.6,2021-06-05 23:00:00,23
176,125,301,71,22.8,0,Clear,11.3,2021-06-06 00:00:00,0
102,71,173,74,22.1,0,Clear,11.6,2021-06-06 01:00:00,1
60,42,102,76,21.6,0,Clear,10.7,2021-06-06 02:00:00,2
59,19,78,73,21.7,0,Clear,9.7,2021-06-06 03:00:00,3
16,7,23,76,20.9,0,Clear,9.2,2021-06-06 04:00:00,4
15,18,33,80,20.2,0,Clear,8.2,2021-06-06 05:00:00,5
37,23,60,84,19.5,0,Clear,6.6,2021-06-06 06:00:00,6
48,80,128,85,20.3,0,Clear,8.2,2021-06-06 07:00:00,7
106,165,271,72,23.4,0,Clear,6.2,2021-06-06 08:00:00,8
175,246,421,66,25.3,0,Clear,5.6,2021-06-06 09:00:00,9
242,337,579,61,27.3,0,Clear,4.0,2021-06-06 10:00:00,10
333,375,708,55,29.3,0,Clear,2.2,2021-06-06 11:00:00,11
353,334,687,51,30.9,0,Clear,1.0,2021-06-06 12:00:00,12
341,405,746,46,32.1,1,Mostly Clear,3.1,2021-06-06 13:00:00,13
372,319,691,42,32.3,1,Mostly Clear,5.8,2021-06-06 14:00:00,14
311,317,628,42,32.3,1,Mostly Clear,6.8,2021-06-06 15:00:00,15
324,300,624,42,32.4,0,Clear,6.6,2021-06-06 16:00:00,16
252,306,558,43,32.1,0,Clear,6.5,2021-06-06 17:00:00,17
329,289,618,44,31.8,1,Mostly Clear,5.9,2021-06-06 18:00:00,18
270,252,522,51,30.3,1,Mostly Clear,9.2,2021-06-06 19:00:00,19
230,230,460,59,28.3,1,Mostly Clear,8.3,2021-06-06 20:00:00,20
135,172,307,63,26.9,1,Mostly Clear,7.9,2021-06-06 21:00:00,21
108,91,199,67,26.0,1,Mostly Clear,8.3,2021-06-06 22:00:00,22
75,70,145,73,25.1,1,Mostly Clear,9.4,2021-06-06 23:00:00,23
56,30,86,77,24.4,1,Mostly Clear,9.2,2021-06-07 00:00:00,0
16,21,37,80,23.9,1,Mostly Clear,8.2,2021-06-07 01:00:00,1
19,6,25,81,23.5,1,Mostly Clear,8.3,2021-06-07 02:00:00,2
8,2,10,81,23.9,1,Mostly Clear,8.9,2021-06-07 03:00:00,3
13,7,20,83,23.5,1,Mostly Clear,9.2,2021-06-07 04:00:00,4
17,40,57,86,23.0,1,Mostly Clear,8.7,2021-06-07 05:00:00,5
61,132,193,90,22.6,1,Mostly Clear,7.5,2021-06-07 06:00:00,6
98,253,351,90,23.3,1,Mostly Clear,9.0,2021-06-07 07:00:00,7
126,398,524,85,25.0,1,Mostly Clear,7.6,2021-06-07 08:00:00,8
101,256,357,80,26.4,2,Partly Cloudy,6.6,2021-06-07 09:00:00,9
116,149,265,73,28.0,2,Partly Cloudy,8.0,2021-06-07 10:00:00,10
148,186,334,66,29.4,3,Cloudy,10.5,2021-06-07 11:00:00,11
181,244,425,58,30.9,2,Partly Cloudy,11.0,2021-06-07 12:00:00,12
191,208,399,53,31.6,1,Mostly Clear,10.7,2021-06-07 13:00:00,13
143,204,347,49,32.3,1,Mostly Clear,10.1,2021-06-07 14:00:00,14
145,232,377,56,31.9,1,Mostly Clear,9.9,2021-06-07 15:00:00,15
223,308,531,54,32.2,1,Mostly Clear,9.8,2021-06-07 16:00:00,16
268,512,780,54,32.1,1,Mostly Clear,9.7,2021-06-07 17:00:00,17
283,508,791,55,31.5,2,Partly Cloudy,11.9,2021-06-07 18:00:00,18
227,383,610,60,30.1,1,Mostly Clear,4.9,2021-06-07 19:00:00,19
177,292,469,67,28.8,1,Mostly Clear,6.2,2021-06-07 20:00:00,20
113,172,285,71,27.7,2,Partly Cloudy,8.3,2021-06-07 21:00:00,21
73,99,172,83,25.5,63,Rain,9.4,2021-06-07 22:00:00,22
49,45,94,88,24.6,61,Light Rain,8.9,2021-06-07 23:00:00,23
28,16,44,92,24.2,51,Light Drizzle,8.4,2021-06-08 00:00:00,0
9,6,15,94,23.9,51,Light Drizzle,9.4,2021-06-08 01:00:00,1
9,7,16,96,23.6,1,Mostly Clear,10.0,2021-06-08 02:00:00,2
6,5,11,91,24.4,1,Mostly Clear,9.5,2021-06-08 03:00:00,3
16,6,22,91,24.2,2,Partly Cloudy,9.5,2021-06-08 04:00:00,4
23,49,72,90,24.0,2,Partly Cloudy,9.3,2021-06-08 05:00:00,5
54,147,201,90,23.8,2,Partly Cloudy,6.3,2021-06-08 06:00:00,6
98,298,396,90,23.9,1,Mostly Clear,7.2,2021-06-08 07:00:00,7
135,414,549,85,24.9,1,Mostly Clear,6.7,2021-06-08 08:00:00,8
116,245,361,79,26.3,1,Mostly Clear,6.3,2021-06-08 09:00:00,9
122,184,306,75,27.5,1,Mostly Clear,5.8,2021-06-08 10:00:00,10
131,215,346,71,28.9,51,Light Drizzle,6.0,2021-06-08 11:00:00,11
166,233,399,65,30.0,51,Light Drizzle,6.5,2021-06-08 12:00:00,12
176,196,372,61,30.6,63,Rain,6.5,2021-06-08 13:00:00,13
158,213,371,61,30.8,53,Heavy Drizzle,5.4,2021-06-08 14:00:00,14
187,243,430,63,30.4,53,Heavy Drizzle,4.3,2021-06-08 15:00:00,15
194,338,532,65,30.0,51,Light Drizzle,2.4,2021-06-08 16:00:00,16
281,545,826,68,29.7,51,Light Drizzle,4.7,2021-06-08 17:00:00,17
303,593,896,72,28.9,53,Heavy Drizzle,3.3,2021-06-08 18:00:00,18
247,422,669,76,28.2,1,Mostly Clear,5.6,2021-06-08 19:00:00,19
177,301,478,82,27.1,51,Light Drizzle,5.6,2021-06-08 20:00:00,20
138,221,359,87,25.8,51,Light Drizzle,4.9,2021-06-08 21:00:00,21
75,114,189,89,25.0,2,Partly Cloudy,7.4,2021-06-08 22:00:00,22
56,52,108,91,24.3,1,Mostly Clear,7.8,2021-06-08 23:00:00,23
35,32,67,92,23.8,1,Mostly Clear,7.7,2021-06-09 00:00:00,0
17,9,26,91,23.5,1,Mostly Clear,7.1,2021-06-09 01:00:00,1
5,14,19,92,23.1,1,Mostly Clear,7.4,2021-06-09 02:00:00,2
4,3,7,94,22.9,1,Mostly Clear,7.3,2021-06-09 03:00:00,3
7,13,20,94,22.6,1,Mostly Clear,6.8,2021-06-09 04:00:00,4
23,62,85,95,22.3,1,Mostly Clear,6.6,2021-06-09 05:00:00,5
61,178,239,95,22.1,1,Mostly Clear,7.0,2021-06-09 06:00:00,6
100,281,381,94,22.8,1,Mostly Clear,7.1,2021-06-09 07:00:00,7
136,425,561,89,24.6,1,Mostly Clear,6.5,2021-06-09 08:00:00,8
127,249,376,83,26.1,1,Mostly Clear,5.4,2021-06-09 09:00:00,9
124,188,312,76,27.3,1,Mostly Clear,6.2,2021-06-09 10:00:00,10
135,212,347,71,28.2,2,Partly Cloudy,6.8,2021-06-09 11:00:00,11
176,239,415,71,27.8,51,Light Drizzle,6.6,2021-06-09 12:00:00,12
193,253,446,76,26.9,51,Light Drizzle,6.8,2021-06-09 13:00:00,13
201,220,421,77,26.9,51,Light Drizzle,5.7,2021-06-09 14:00:00,14
211,263,474,79,27.6,51,Light Drizzle,6.6,2021-06-09 15:00:00,15
226,338,564,75,28.0,2,Partly Cloudy,3.6,2021-06-09 16:00:00,16
314,519,833,78,27.5,1,Mostly Clear,5.4,2021-06-09 17:00:00,17
331,515,846,78,27.1,61,Light Rain,3.8,2021-06-09 18:00:00,18
214,445,659,79,26.8,2,Partly Cloudy,5.0,2021-06-09 19:00:00,19
181,279,460,85,26.0,3,Cloudy,5.5,2021-06-09 20:00:00,20
134,207,341,88,25.3,3,Cloudy,6.0,2021-06-09 21:00:00,21
106,132,238,93,24.5,2,Partly Cloudy,4.2,2021-06-09 22:00:00,22
81,76,157,95,23.8,3,Cloudy,3.4,2021-06-09 23:00:00,23
39,32,71,97,23.3,2,Partly Cloudy,6.6,2021-06-10 00:00:00,0
21,15,36,98,23.0,1,Mostly Clear,6.4,2021-06-10 01:00:00,1
8,5,13,98,22.7,1,Mostly Clear,4.8,2021-06-10 02:00:00,2
6,4,10,95,22.7,2,Partly Cloudy,4.7,2021-06-10 03:00:00,3
13,5,18,96,22.4,2,Partly Cloudy,5.4,2021-06-10 04:00:00,4
19,49,68,96,22.0,1,Mostly Clear,5.6,2021-06-10 05:00:00,5
48,128,176,96,21.7,1,Mostly Clear,4.2,2021-06-10 06:00:00,6
88,264,352,94,22.7,2,Partly Cloudy,2.7,2021-06-10 07:00:00,7
132,424,556,84,24.6,2,Partly Cloudy,0.8,2021-06-10 08:00:00,8
152,250,402,79,25.5,2,Partly Cloudy,1.1,2021-06-10 09:00:00,9
134,191,325,75,26.3,1,Mostly Clear,1.1,2021-06-10 10:00:00,10
179,242,421,70,27.4,1,Mostly Clear,1.5,2021-06-10 11:00:00,11
184,264,448,66,28.5,1,Mostly Clear,2.9,2021-06-10 12:00:00,12
158,225,383,60,29.9,1,Mostly Clear,4.3,2021-06-10 13:00:00,13
112,167,279,54,31.1,1,Mostly Clear,6.3,2021-06-10 14:00:00,14
167,243,410,60,30.0,53,Heavy Drizzle,5.7,2021-06-10 15:00:00,15
126,185,311,67,28.7,61,Light Rain,6.0,2021-06-10 16:00:00,16
49,86,135,77,27.1,63,Rain,8.7,2021-06-10 17:00:00,17
52,138,190,89,24.7,63,Rain,10.4,2021-06-10 18:00:00,18
67,138,205,96,23.5,63,Rain,10.3,2021-06-10 19:00:00,19
63,140,203,96,22.8,63,Rain,12.3,2021-06-10 20:00:00,20
68,110,178,98,22.2,61,Light Rain,13.8,2021-06-10 21:00:00,21
73,91,164,99,21.8,61,Light Rain,14.4,2021-06-10 22:00:00,22
44,53,97,99,21.6,53,Heavy Drizzle,13.7,2021-06-10 23:00:00,23
23,27,50,99,21.4,53,Heavy Drizzle,13.0,2021-06-11 00:00:00,0
13,22,35,99,21.2,53,Heavy Drizzle,13.4,2021-06-11 01:00:00,1
5,12,17,99,21.0,51,Light Drizzle,14.4,2021-06-11 02:00:00,2
6,9,15,99,20.2,61,Light Rain,14.5,2021-06-11 03:00:00,3
7,3,10,100,20.1,55,Heavy Drizzle,14.6,2021-06-11 04:00:00,4
12,25,37,99,20.1,61,Light Rain,14.8,2021-06-11 05:00:00,5
27,68,95,100,20.1,63,Rain,12.1,2021-06-11 06:00:00,6
28,103,131,99,20.2,63,Rain,12.6,2021-06-11 07:00:00,7
17,80,97,99,20.3,63,Rain,15.5,2021-06-11 08:00:00,8
22,82,104,99,20.6,63,Rain,18.3,2021-06-11 09:00:00,9
23,53,76,99,20.8,63,Rain,19.8,2021-06-11 10:00:00,10
19,42,61,99,21.0,63,Rain,19.3,2021-06-11 11:00:00,11
12,36,48,100,20.9,63,Rain,17.5,2021-06-11 12:00:00,12
56,102,158,100,20.7,63,Rain,15.3,2021-06-11 13:00:00,13
108,183,291,99,20.5,63,Rain,16.3,2021-06-11 14:00:00,14
104,171,275,99,20.5,63,Rain,17.2,2021-06-11 15:00:00,15
126,185,311,99,20.3,61,Light Rain,19.5,2021-06-11 16:00:00,16
157,335,492,98,20.2,51,Light Drizzle,19.6,2021-06-11 17:00:00,17
187,341,528,96,20.0,51,Light Drizzle,12.8,2021-06-11 18:00:00,18
127,266,393,96,19.6,51,Light Drizzle,11.8,2021-06-11 19:00:00,19
111,206,317,96,19.4,51,Light Drizzle,12.5,2021-06-11 20:00:00,20
102,148,250,96,19.2,51,Light Drizzle,13.8,2021-06-11 21:00:00,21
132,114,246,96,19.2,51,Light Drizzle,14.3,2021-06-11 22:00:00,22
128,116,244,96,19.2,51,Light Drizzle,13.5,2021-06-11 23:00:00,23
115,90,205,96,19.2,51,Light Drizzle,13.0,2021-06-12 00:00:00,0
106,70,176,96,19.2,51,Light Drizzle,12.5,2021-06-12 01:00:00,1
101,80,181,96,19.2,3,Cloudy,11.7,2021-06-12 02:00:00,2
89,59,148,98,18.6,51,Light Drizzle,11.0,2021-06-12 03:00:00,3
30,13,43,98,18.4,3,Cloudy,11.3,2021-06-12 04:00:00,4
18,16,34,97,18.2,3,Cloudy,11.3,2021-06-12 05:00:00,5
29,45,74,96,18.0,3,Cloudy,7.2,2021-06-12 06:00:00,6
56,117,173,95,18.0,3,Cloudy,8.3,2021-06-12 07:00:00,7
128,176,304,93,18.2,3,Cloudy,11.2,2021-06-12 08:00:00,8
187,267,454,91,18.5,3,Cloudy,9.3,2021-06-12 09:00:00,9
306,330,636,88,18.9,3,Cloudy,8.1,2021-06-12 10:00:00,10
408,412,820,85,19.7,3,Cloudy,7.2,2021-06-12 11:00:00,11
542,429,971,81,20.8,3,Cloudy,6.7,2021-06-12 12:00:00,12
605,472,1077,76,22.1,3,Cloudy,5.0,2021-06-12 13:00:00,13
610,479,1089,73,23.2,3,Cloudy,4.7,2021-06-12 14:00:00,14
573,387,960,75,22.4,3,Cloudy,4.1,2021-06-12 15:00:00,15
518,436,954,72,23.2,3,Cloudy,2.9,2021-06-12 16:00:00,16
505,455,960,72,23.3,3,Cloudy,3.7,2021-06-12 17:00:00,17
410,464,874,73,23.4,2,Partly Cloudy,4.2,2021-06-12 18:00:00,18
394,362,756,75,23.3,2,Partly Cloudy,2.5,2021-06-12 19:00:00,19
334,282,616,80,22.7,2,Partly Cloudy,3.3,2021-06-12 20:00:00,20
263,255,518,88,21.7,1,Mostly Clear,6.4,2021-06-12 21:00:00,21
273,196,469,88,21.3,0,Clear,8.0,2021-06-12 22:00:00,22
367,200,567,91,20.4,0,Clear,7.6,2021-06-12 23:00:00,23
309,180,489,93,19.9,0,Clear,6.9,2021-06-13 00:00:00,0
191,103,294,92,19.8,0,Clear,6.3,2021-06-13 01:00:00,1
207,100,307,97,18.4,0,Clear,6.9,2021-06-13 02:00:00,2
122,52,174,94,18.4,0,Clear,6.6,2021-06-13 03:00:00,3
27,15,42,95,18.4,0,Clear,7.1,2021-06-13 04:00:00,4
17,19,36,95,18.3,1,Mostly Clear,7.2,2021-06-13 05:00:00,5
31,34,65,96,18.1,3,Cloudy,4.9,2021-06-13 06:00:00,6
62,78,140,94,19.2,3,Cloudy,6.0,2021-06-13 07:00:00,7
127,143,270,85,20.9,3,Cloudy,5.5,2021-06-13 08:00:00,8
209,234,443,81,21.7,3,Cloudy,6.9,2021-06-13 09:00:00,9
369,290,659,75,23.0,3,Cloudy,7.9,2021-06-13 10:00:00,10
396,357,753,69,24.3,3,Cloudy,9.4,2021-06-13 11:00:00,11
458,387,845,64,25.4,3,Cloudy,10.0,2021-06-13 12:00:00,12
475,372,847,61,26.3,3,Cloudy,10.0,2021-06-13 13:00:00,13
391,306,697,60,26.9,3,Cloudy,10.0,2021-06-13 14:00:00,14
293,223,516,67,26.5,3,Cloudy,9.8,2021-06-13 15:00:00,15
379,298,677,69,26.0,51,Light Drizzle,9.1,2021-06-13 16:00:00,16
383,342,725,67,26.2,3,Cloudy,9.0,2021-06-13 17:00:00,17
316,309,625,70,25.9,3,Cloudy,6.1,2021-06-13 18:00:00,18
293,286,579,74,25.4,3,Cloudy,7.9,2021-06-13 19:00:00,19
203,202,405,78,24.5,2,Partly Cloudy,9.2,2021-06-13 20:00:00,20
144,149,293,79,23.7,2,Partly Cloudy,11.2,2021-06-13 21:00:00,21
140,109,249,79,22.9,51,Light Drizzle,11.3,2021-06-13 22:00:00,22
85,56,141,80,22.3,51,Light Drizzle,10.3,2021-06-13 23:00:00,23
28,26,54,79,21.7,51,Light Drizzle,10.2,2021-06-14 00:00:00,0
21,14,35,80,21.0,51,Light Drizzle,9.7,2021-06-14 01:00:00,1
16,4,20,82,20.4,51,Light Drizzle,8.8,2021-06-14 02:00:00,2
7,5,12,81,20.5,1,Mostly Clear,9.6,2021-06-14 03:00:00,3
11,12,23,82,20.2,1,Mostly Clear,9.1,2021-06-14 04:00:00,4
16,38,54,84,19.9,1,Mostly Clear,7.6,2021-06-14 05:00:00,5
37,140,177,87,19.7,1,Mostly Clear,8.2,2021-06-14 06:00:00,6
76,242,318,87,20.1,0,Clear,8.6,2021-06-14 07:00:00,7
157,375,532,83,21.4,0,Clear,7.9,2021-06-14 08:00:00,8
131,196,327,80,22.6,0,Clear,6.9,2021-06-14 09:00:00,9
151,191,342,78,24.0,1,Mostly Clear,6.2,2021-06-14 10:00:00,10
180,187,367,76,25.5,1,Mostly Clear,6.5,2021-06-14 11:00:00,11
201,263,464,74,26.1,51,Light Drizzle,4.8,2021-06-14 12:00:00,12
224,227,451,66,27.3,0,Clear,5.6,2021-06-14 13:00:00,13
241,207,448,54,28.3,1,Mostly Clear,6.2,2021-06-14 14:00:00,14
244,226,470,58,29.4,1,Mostly Clear,6.8,2021-06-14 15:00:00,15
295,333,628,53,29.5,1,Mostly Clear,7.3,2021-06-14 16:00:00,16
343,543,886,50,29.7,1,Mostly Clear,7.7,2021-06-14 17:00:00,17
362,568,930,53,29.1,0,Clear,5.9,2021-06-14 18:00:00,18
334,401,735,59,28.5,1,Mostly Clear,7.2,2021-06-14 19:00:00,19
220,300,520,68,26.9,1,Mostly Clear,6.9,2021-06-14 20:00:00,20
123,183,306,72,25.2,1,Mostly Clear,3.6,2021-06-14 21:00:00,21
108,107,215,83,24.0,1,Mostly Clear,2.9,2021-06-14 22:00:00,22
8,12,20,82,23.3,61,Light Rain,9.0,2021-06-14 23:00:00,23
8,14,22,85,22.1,53,Heavy Drizzle,9.1,2021-06-15 00:00:00,0
11,8,19,86,21.4,1,Mostly Clear,10.1,2021-06-15 01:00:00,1
4,6,10,86,20.7,1,Mostly Clear,10.7,2021-06-15 02:00:00,2
7,4,11,95,20.1,1,Mostly Clear,8.6,2021-06-15 03:00:00,3
10,9,19,96,19.5,0,Clear,7.9,2021-06-15 04:00:00,4
23,51,74,96,19.0,0,Clear,7.5,2021-06-15 05:00:00,5
52,151,203,96,18.6,0,Clear,7.4,2021-06-15 06:00:00,6
74,294,368,94,19.1,0,Clear,9.4,2021-06-15 07:00:00,7
142,469,611,89,20.0,0,Clear,8.4,2021-06-15 08:00:00,8
119,284,403,81,20.9,0,Clear,11.2,2021-06-15 09:00:00,9
154,193,347,70,22.3,0,Clear,13.0,2021-06-15 10:00:00,10
186,229,415,59,23.6,1,Mostly Clear,13.6,2021-06-15 11:00:00,11
224,271,495,55,24.3,1,Mostly Clear,13.1,2021-06-15 12:00:00,12
254,250,504,53,24.8,1,Mostly Clear,13.0,2021-06-15 13:00:00,13
252,244,496,50,25.3,1,Mostly Clear,13.2,2021-06-15 14:00:00,14
277,251,528,47,25.1,1,Mostly Clear,13.0,2021-06-15 15:00:00,15
286,378,664,47,25.4,1,Mostly Clear,12.7,2021-06-15 16:00:00,16
375,664,1039,47,25.4,0,Clear,12.8,2021-06-15 17:00:00,17
406,626,1032,49,25.0,1,Mostly Clear,12.5,2021-06-15 18:00:00,18
229,338,567,55,24.3,0,Clear,9.6,2021-06-15 19:00:00,19
283,350,633,60,23.2,0,Clear,9.0,2021-06-15 20:00:00,20
221,260,481,61,21.9,1,Mostly Clear,11.4,2021-06-15 21:00:00,21
217,172,389,63,21.3,1,Mostly Clear,12.6,2021-06-15 22:00:00,22
110,73,183,64,20.7,0,Clear,12.7,2021-06-15 23:00:00,23
45,25,70,65,20.1,0,Clear,13.6,2021-06-16 00:00:00,0
21,8,29,66,19.8,0,Clear,13.5,2021-06-16 01:00:00,1
18,10,28,68,19.2,0,Clear,12.8,2021-06-16 02:00:00,2
4,6,10,68,19.3,1,Mostly Clear,12.0,2021-06-16 03:00:00,3
7,4,11,69,18.8,1,Mostly Clear,11.2,2021-06-16 04:00:00,4
28,45,73,71,18.1,1,Mostly Clear,11.7,2021-06-16 05:00:00,5
55,144,199,71,17.9,0,Clear,10.3,2021-06-16 06:00:00,6
94,303,397,72,17.8,0,Clear,12.1,2021-06-16 07:00:00,7
158,419,577,67,18.6,0,Clear,12.0,2021-06-16 08:00:00,8
143,253,396,60,19.8,0,Clear,12.2,2021-06-16 09:00:00,9
149,210,359,54,21.2,0,Clear,11.2,2021-06-16 10:00:00,10
169,240,409,49,22.4,0,Clear,10.7,2021-06-16 11:00:00,11
200,270,470,44,23.4,0,Clear,12.2,2021-06-16 12:00:00,12
227,278,505,41,24.1,0,Clear,12.7,2021-06-16 13:00:00,13
231,246,477,38,24.7,0,Clear,11.7,2021-06-16 14:00:00,14
288,309,597,36,25.3,0,Clear,11.5,2021-06-16 15:00:00,15
270,429,699,35,25.5,0,Clear,11.2,2021-06-16 16:00:00,16
364,628,992,36,25.4,0,Clear,10.9,2021-06-16 17:00:00,17
427,686,1113,37,25.0,0,Clear,10.2,2021-06-16 18:00:00,18
386,522,908,43,24.1,0,Clear,7.7,2021-06-16 19:00:00,19
293,362,655,54,22.8,0,Clear,6.1,2021-06-16 20:00:00,20
208,247,455,54,21.1,0,Clear,8.1,2021-06-16 21:00:00,21
143,177,320,56,19.8,0,Clear,9.2,2021-06-16 22:00:00,22
80,101,181,56,19.0,1,Mostly Clear,9.5,2021-06-16 23:00:00,23
39,27,66,56,18.4,1,Mostly Clear,10.6,2021-06-17 00:00:00,0
21,8,29,56,18.1,1,Mostly Clear,11.5,2021-06-17 01:00:00,1
9,10,19,55,17.9,2,Partly Cloudy,13.1,2021-06-17 02:00:00,2
5,7,12,54,17.7,1,Mostly Clear,12.4,2021-06-17 03:00:00,3
9,10,19,56,16.9,0,Clear,10.8,2021-06-17 04:00:00,4
32,44,76,59,16.0,0,Clear,11.0,2021-06-17 05:00:00,5
49,137,186,64,15.3,0,Clear,9.7,2021-06-17 06:00:00,6
80,286,366,68,15.4,0,Clear,11.1,2021-06-17 07:00:00,7
141,456,597,62,17.2,0,Clear,9.4,2021-06-17 08:00:00,8
124,261,385,56,19.0,0,Clear,9.8,2021-06-17 09:00:00,9
161,180,341,49,20.6,0,Clear,9.2,2021-06-17 10:00:00,10
211,234,445,43,21.9,0,Clear,7.8,2021-06-17 11:00:00,11
217,251,468,40,22.8,0,Clear,7.4,2021-06-17 12:00:00,12
271,258,529,38,23.6,0,Clear,8.0,2021-06-17 13:00:00,13
283,260,543,37,24.3,0,Clear,8.7,2021-06-17 14:00:00,14
323,326,649,33,24.8,0,Clear,8.5,2021-06-17 15:00:00,15
355,400,755,32,25.1,0,Clear,8.7,2021-06-17 16:00:00,16
406,674,1080,32,25.1,0,Clear,8.7,2021-06-17 17:00:00,17
397,595,992,33,24.8,0,Clear,8.1,2021-06-17 18:00:00,18
369,501,870,39,23.9,0,Clear,5.5,2021-06-17 19:00:00,19
343,396,739,50,22.6,0,Clear,4.4,2021-06-17 20:00:00,20
221,241,462,58,21.3,0,Clear,6.1,2021-06-17 21:00:00,21
184,204,388,68,19.2,0,Clear,6.9,2021-06-17 22:00:00,22
146,139,285,75,17.2,0,Clear,6.8,2021-06-17 23:00:00,23
78,51,129,76,16.4,0,Clear,7.5,2021-06-18 00:00:00,0
58,51,109,79,15.8,0,Clear,7.4,2021-06-18 01:00:00,1
39,8,47,83,15.3,0,Clear,7.7,2021-06-18 02:00:00,2
19,7,26,76,14.8,0,Clear,8.9,2021-06-18 03:00:00,3
14,11,25,77,14.4,0,Clear,8.4,2021-06-18 04:00:00,4
18,44,62,78,14.0,0,Clear,7.4,2021-06-18 05:00:00,5
43,99,142,79,13.7,0,Clear,8.7,2021-06-18 06:00:00,6
66,184,250,78,15.2,1,Mostly Clear,10.2,2021-06-18 07:00:00,7
124,309,433,64,18.8,1,Mostly Clear,9.0,2021-06-18 08:00:00,8
183,278,461,54,21.3,1,Mostly Clear,8.2,2021-06-18 09:00:00,9
263,289,552,48,23.6,0,Clear,9.0,2021-06-18 10:00:00,10
363,373,736,43,25.4,1,Mostly Clear,9.2,2021-06-18 11:00:00,11
416,350,766,38,27.1,1,Mostly Clear,11.0,2021-06-18 12:00:00,12
430,337,767,35,28.3,1,Mostly Clear,11.8,2021-06-18 13:00:00,13
435,398,833,33,29.2,1,Mostly Clear,12.5,2021-06-18 14:00:00,14
451,410,861,37,29.4,1,Mostly Clear,12.0,2021-06-18 15:00:00,15
451,399,850,35,30.0,1,Mostly Clear,11.0,2021-06-18 16:00:00,16
475,537,1012,35,30.1,1,Mostly Clear,10.0,2021-06-18 17:00:00,17
513,465,978,39,29.5,1,Mostly Clear,11.8,2021-06-18 18:00:00,18
341,413,754,44,28.1,2,Partly Cloudy,8.3,2021-06-18 19:00:00,19
328,288,616,52,26.0,2,Partly Cloudy,8.3,2021-06-18 20:00:00,20
281,232,513,56,24.5,1,Mostly Clear,9.7,2021-06-18 21:00:00,21
245,193,438,58,23.9,1,Mostly Clear,11.5,2021-06-18 22:00:00,22
239,179,418,56,23.7,1,Mostly Clear,12.8,2021-06-18 23:00:00,23
165,119,284,54,24.2,1,Mostly Clear,15.0,2021-06-19 00:00:00,0
131,77,208,56,24.4,1,Mostly Clear,14.2,2021-06-19 01:00:00,1
120,72,192,59,24.0,1,Mostly Clear,14.6,2021-06-19 02:00:00,2
49,28,77,57,23.4,1,Mostly Clear,14.4,2021-06-19 03:00:00,3
21,17,38,59,23.2,1,Mostly Clear,12.2,2021-06-19 04:00:00,4
22,30,52,63,22.6,1,Mostly Clear,11.5,2021-06-19 05:00:00,5
38,59,97,67,22.1,2,Partly Cloudy,10.9,2021-06-19 06:00:00,6
70,94,164,70,22.4,3,Cloudy,10.7,2021-06-19 07:00:00,7
110,202,312,70,23.7,3,Cloudy,9.7,2021-06-19 08:00:00,8
215,286,501,66,25.3,3,Cloudy,10.1,2021-06-19 09:00:00,9
401,346,747,63,27.1,3,Cloudy,10.9,2021-06-19 10:00:00,10
549,438,987,64,27.7,2,Partly Cloudy,9.0,2021-06-19 11:00:00,11
462,373,835,62,28.6,1,Mostly Clear,9.4,2021-06-19 12:00:00,12
558,350,908,63,28.4,2,Partly Cloudy,12.4,2021-06-19 13:00:00,13
611,357,968,61,28.8,3,Cloudy,14.6,2021-06-19 14:00:00,14
575,393,968,80,26.5,63,Rain,11.6,2021-06-19 15:00:00,15
536,367,903,83,26.1,53,Heavy Drizzle,7.6,2021-06-19 16:00:00,16
441,359,800,83,26.2,1,Mostly Clear,5.6,2021-06-19 17:00:00,17
374,338,712,77,27.0,1,Mostly Clear,4.3,2021-06-19 18:00:00,18
353,289,642,78,26.9,2,Partly Cloudy,3.3,2021-06-19 19:00:00,19
307,270,577,83,26.2,1,Mostly Clear,4.3,2021-06-19 20:00:00,20
226,172,398,91,24.7,51,Light Drizzle,3.9,2021-06-19 21:00:00,21
220,209,429,94,23.4,51,Light Drizzle,4.6,2021-06-19 22:00:00,22
200,166,366,96,22.8,1,Mostly Clear,3.4,2021-06-19 23:00:00,23
138,94,232,97,22.2,51,Light Drizzle,5.4,2021-06-20 00:00:00,0
97,70,167,94,22.7,51,Light Drizzle,4.7,2021-06-20 01:00:00,1
88,54,142,96,22.4,1,Mostly Clear,3.9,2021-06-20 02:00:00,2
61,19,80,94,21.6,51,Light Drizzle,5.0,2021-06-20 03:00:00,3
25,17,42,93,21.8,1,Mostly Clear,5.8,2021-06-20 04:00:00,4
19,17,36,94,21.3,1,Mostly Clear,5.9,2021-06-20 05:00:00,5
41,31,72,95,20.7,1,Mostly Clear,1.8,2021-06-20 06:00:00,6
49,72,121,93,21.9,1,Mostly Clear,5.6,2021-06-20 07:00:00,7
143,169,312,87,23.8,1,Mostly Clear,3.4,2021-06-20 08:00:00,8
215,242,457,78,25.6,2,Partly Cloudy,5.5,2021-06-20 09:00:00,9
347,304,651,66,27.7,1,Mostly Clear,6.8,2021-06-20 10:00:00,10
453,335,788,58,29.3,0,Clear,8.5,2021-06-20 11:00:00,11
397,365,762,53,30.6,0,Clear,8.5,2021-06-20 12:00:00,12
444,347,791,49,31.5,0,Clear,7.9,2021-06-20 13:00:00,13
484,389,873,47,32.3,1,Mostly Clear,8.2,2021-06-20 14:00:00,14
448,344,792,51,32.0,1,Mostly Clear,8.7,2021-06-20 15:00:00,15
424,321,745,51,32.0,1,Mostly Clear,9.0,2021-06-20 16:00:00,16
330,317,647,54,31.2,1,Mostly Clear,10.5,2021-06-20 17:00:00,17
327,344,671,57,30.5,51,Light Drizzle,10.4,2021-06-20 18:00:00,18
277,279,556,63,29.6,1,Mostly Clear,9.4,2021-06-20 19:00:00,19
263,232,495,67,28.3,1,Mostly Clear,10.7,2021-06-20 20:00:00,20
179,167,346,69,27.1,1,Mostly Clear,10.2,2021-06-20 21:00:00,21
140,129,269,72,26.1,1,Mostly Clear,9.6,2021-06-20 22:00:00,22
80,72,152,76,25.3,1,Mostly Clear,10.8,2021-06-20 23:00:00,23
32,31,63,78,24.6,1,Mostly Clear,9.7,2021-06-21 00:00:00,0
23,14,37,81,24.1,0,Clear,10.5,2021-06-21 01:00:00,1
13,10,23,85,23.7,0,Clear,10.7,2021-06-21 02:00:00,2
5,5,10,94,23.1,1,Mostly Clear,9.9,2021-06-21 03:00:00,3
13,14,27,95,22.8,1,Mostly Clear,8.9,2021-06-21 04:00:00,4
24,48,72,96,22.6,1,Mostly Clear,8.0,2021-06-21 05:00:00,5
55,125,180,97,22.4,2,Partly Cloudy,5.4,2021-06-21 06:00:00,6
78,267,345,96,22.9,3,Cloudy,7.6,2021-06-21 07:00:00,7
157,357,514,89,24.3,3,Cloudy,9.6,2021-06-21 08:00:00,8
113,261,374,83,25.7,3,Cloudy,8.6,2021-06-21 09:00:00,9
153,176,329,75,27.4,3,Cloudy,6.8,2021-06-21 10:00:00,10
196,199,395,67,29.4,2,Partly Cloudy,7.2,2021-06-21 11:00:00,11
196,259,455,61,30.5,1,Mostly Clear,7.9,2021-06-21 12:00:00,12
212,215,427,58,31.3,1,Mostly Clear,8.7,2021-06-21 13:00:00,13
211,210,421,54,32.3,1,Mostly Clear,10.6,2021-06-21 14:00:00,14
200,219,419,54,32.7,0,Clear,11.9,2021-06-21 15:00:00,15
231,313,544,51,33.3,1,Mostly Clear,12.1,2021-06-21 16:00:00,16
277,561,838,51,32.9,53,Heavy Drizzle,11.4,2021-06-21 17:00:00,17
217,376,593,51,32.1,2,Partly Cloudy,7.9,2021-06-21 18:00:00,18
155,308,463,61,30.6,1,Mostly Clear,2.7,2021-06-21 19:00:00,19
146,246,392,67,29.6,1,Mostly Clear,1.8,2021-06-21 20:00:00,20
124,143,267,70,28.1,1,Mostly Clear,3.1,2021-06-21 21:00:00,21
77,106,183,76,26.6,1,Mostly Clear,3.0,2021-06-21 22:00:00,22
26,39,65,77,25.8,1,Mostly Clear,2.9,2021-06-21 23:00:00,23
31,25,56,77,25.4,1,Mostly Clear,5.8,2021-06-22 00:00:00,0
13,18,31,77,24.7,1,Mostly Clear,4.2,2021-06-22 01:00:00,1
5,8,13,81,24.1,0,Clear,1.1,2021-06-22 02:00:00,2
2,3,5,89,23.2,1,Mostly Clear,3.1,2021-06-22 03:00:00,3
9,8,17,92,22.7,2,Partly Cloudy,4.8,2021-06-22 04:00:00,4
31,49,80,95,21.8,1,Mostly Clear,5.6,2021-06-22 05:00:00,5
52,150,202,93,22.0,51,Light Drizzle,2.5,2021-06-22 06:00:00,6
76,251,327,92,22.3,61,Light Rain,9.4,2021-06-22 07:00:00,7
88,335,423,93,22.1,61,Light Rain,10.5,2021-06-22 08:00:00,8
78,215,293,94,21.5,55,Heavy Drizzle,12.0,2021-06-22 09:00:00,9
70,81,151,91,21.2,53,Heavy Drizzle,16.8,2021-06-22 10:00:00,10
58,114,172,91,20.9,61,Light Rain,15.9,2021-06-22 11:00:00,11
23,45,68,92,20.9,61,Light Rain,15.4,2021-06-22 12:00:00,12
38,62,100,94,20.2,61,Light Rain,12.4,2021-06-22 13:00:00,13
71,118,189,94,19.5,61,Light Rain,10.5,2021-06-22 14:00:00,14
87,165,252,95,19.4,53,Heavy Drizzle,10.6,2021-06-22 15:00:00,15
215,280,495,93,19.3,2,Partly Cloudy,13.1,2021-06-22 16:00:00,16
278,581,859,85,20.2,1,Mostly Clear,14.5,2021-06-22 17:00:00,17
305,555,860,74,21.0,3,Cloudy,17.1,2021-06-22 18:00:00,18
266,439,705,63,21.0,2,Partly Cloudy,10.7,2021-06-22 19:00:00,19
188,335,523,61,20.4,1,Mostly Clear,5.8,2021-06-22 20:00:00,20
160,191,351,57,19.5,2,Partly Cloudy,4.6,2021-06-22 21:00:00,21
113,150,263,57,18.6,2,Partly Cloudy,6.9,2021-06-22 22:00:00,22
74,77,151,57,17.9,1,Mostly Clear,6.6,2021-06-22 23:00:00,23
29,20,49,57,17.3,0,Clear,9.4,2021-06-23 00:00:00,0
16,11,27,58,16.6,0,Clear,10.7,2021-06-23 01:00:00,1
8,13,21,60,15.8,0,Clear,10.1,2021-06-23 02:00:00,2
3,3,6,68,14.8,0,Clear,9.2,2021-06-23 03:00:00,3
7,12,19,71,14.1,0,Clear,7.7,2021-06-23 04:00:00,4
17,55,72,76,13.2,0,Clear,6.6,2021-06-23 05:00:00,5
42,161,203,82,12.4,0,Clear,7.5,2021-06-23 06:00:00,6
105,336,441,83,13.4,0,Clear,8.4,2021-06-23 07:00:00,7
155,456,611,65,16.5,0,Clear,6.8,2021-06-23 08:00:00,8
151,302,453,55,18.3,0,Clear,6.6,2021-06-23 09:00:00,9
180,226,406,46,19.6,0,Clear,6.0,2021-06-23 10:00:00,10
240,264,504,43,20.7,0,Clear,5.3,2021-06-23 11:00:00,11
254,279,533,41,21.7,0,Clear,5.0,2021-06-23 12:00:00,12
256,318,574,40,22.5,0,Clear,4.8,2021-06-23 13:00:00,13
264,304,568,39,23.1,1,Mostly Clear,5.6,2021-06-23 14:00:00,14
317,317,634,38,23.4,2,Partly Cloudy,5.1,2021-06-23 15:00:00,15
339,392,731,38,23.7,2,Partly Cloudy,4.4,2021-06-23 16:00:00,16
438,687,1125,37,23.7,2,Partly Cloudy,3.6,2021-06-23 17:00:00,17
429,721,1150,39,23.2,1,Mostly Clear,2.4,2021-06-23 18:00:00,18
398,541,939,42,22.9,0,Clear,5.6,2021-06-23 19:00:00,19
298,375,673,53,21.5,0,Clear,6.6,2021-06-23 20:00:00,20
232,287,519,57,19.9,0,Clear,7.0,2021-06-23 21:00:00,21
155,168,323,65,18.6,0,Clear,7.1,2021-06-23 22:00:00,22
96,95,191,73,17.4,0,Clear,6.6,2021-06-23 23:00:00,23
28,32,60,77,16.6,0,Clear,7.6,2021-06-24 00:00:00,0
20,12,32,74,16.9,0,Clear,7.1,2021-06-24 01:00:00,1
15,8,23,68,18.1,0,Clear,6.6,2021-06-24 02:00:00,2
4,3,7,87,14.8,0,Clear,6.1,2021-06-24 03:00:00,3
10,7,17,88,15.0,0,Clear,6.6,2021-06-24 04:00:00,4
21,57,78,88,15.3,0,Clear,6.8,2021-06-24 05:00:00,5
44,154,198,89,15.1,0,Clear,5.2,2021-06-24 06:00:00,6
86,289,375,91,15.4,0,Clear,4.6,2021-06-24 07:00:00,7
170,409,579,78,18.4,0,Clear,2.8,2021-06-24 08:00:00,8
149,293,442,63,20.7,0,Clear,1.1,2021-06-24 09:00:00,9
195,215,410,52,22.3,0,Clear,7.3,2021-06-24 10:00:00,10
247,272,519,48,23.3,2,Partly Cloudy,9.6,2021-06-24 11:00:00,11
246,287,533,45,24.1,3,Cloudy,8.8,2021-06-24 12:00:00,12
266,257,523,44,24.8,2,Partly Cloudy,10.2,2021-06-24 13:00:00,13
286,268,554,43,25.2,0,Clear,11.3,2021-06-24 14:00:00,14
285,314,599,44,25.1,0,Clear,11.0,2021-06-24 15:00:00,15
321,390,711,44,25.0,0,Clear,9.6,2021-06-24 16:00:00,16
459,652,1111,44,24.8,0,Clear,9.2,2021-06-24 17:00:00,17
445,676,1121,45,24.3,0,Clear,7.0,2021-06-24 18:00:00,18
361,552,913,47,23.4,0,Clear,7.9,2021-06-24 19:00:00,19
330,406,736,56,22.1,0,Clear,7.4,2021-06-24 20:00:00,20
196,287,483,59,20.5,0,Clear,7.6,2021-06-24 21:00:00,21
176,198,374,65,19.4,0,Clear,7.6,2021-06-24 22:00:00,22
133,115,248,69,18.4,0,Clear,8.7,2021-06-24 23:00:00,23
67,62,129,74,17.6,0,Clear,10.5,2021-06-25 00:00:00,0
52,43,95,79,16.8,0,Clear,8.9,2021-06-25 01:00:00,1
29,13,42,85,16.0,0,Clear,6.1,2021-06-25 02:00:00,2
15,7,22,89,15.5,0,Clear,6.3,2021-06-25 03:00:00,3
10,7,17,91,14.9,0,Clear,6.6,2021-06-25 04:00:00,4
20,46,66,90,15.6,0,Clear,7.2,2021-06-25 05:00:00,5
48,107,155,89,17.0,0,Clear,2.9,2021-06-25 06:00:00,6
91,269,360,91,16.7,0,Clear,2.3,2021-06-25 07:00:00,7
137,357,494,83,18.9,1,Mostly Clear,2.8,2021-06-25 08:00:00,8
180,282,462,74,20.5,1,Mostly Clear,3.3,2021-06-25 09:00:00,9
221,225,446,63,22.1,1,Mostly Clear,3.4,2021-06-25 10:00:00,10
326,276,602,55,23.5,2,Partly Cloudy,5.4,2021-06-25 11:00:00,11
253,251,504,50,24.8,1,Mostly Clear,6.8,2021-06-25 12:00:00,12
224,76,300,48,25.9,1,Mostly Clear,7.2,2021-06-25 13:00:00,13
377,306,683,46,26.8,1,Mostly Clear,8.4,2021-06-25 14:00:00,14
329,310,639,47,26.7,2,Partly Cloudy,9.0,2021-06-25 15:00:00,15
411,473,884,48,26.5,1,Mostly Clear,8.6,2021-06-25 16:00:00,16
383,538,921,49,26.8,0,Clear,10.5,2021-06-25 17:00:00,17
418,548,966,52,26.6,1,Mostly Clear,10.9,2021-06-25 18:00:00,18
386,462,848,57,25.8,1,Mostly Clear,10.2,2021-06-25 19:00:00,19
362,333,695,65,24.4,0,Clear,10.1,2021-06-25 20:00:00,20
224,199,423,72,23.1,0,Clear,12.0,2021-06-25 21:00:00,21
243,186,429,80,22.3,0,Clear,10.9,2021-06-25 22:00:00,22
218,177,395,86,21.8,0,Clear,12.0,2021-06-25 23:00:00,23
153,104,257,91,21.4,1,Mostly Clear,12.1,2021-06-26 00:00:00,0
126,75,201,94,21.0,2,Partly Cloudy,11.9,2021-06-26 01:00:00,1
122,68,190,96,20.8,3,Cloudy,12.3,2021-06-26 02:00:00,2
72,31,103,96,21.5,3,Cloudy,11.7,2021-06-26 03:00:00,3
20,11,31,95,21.7,3,Cloudy,10.4,2021-06-26 04:00:00,4
12,18,30,96,21.7,3,Cloudy,8.0,2021-06-26 05:00:00,5
18,39,57,96,21.7,3,Cloudy,5.4,2021-06-26 06:00:00,6
21,45,66,95,21.9,3,Cloudy,5.1,2021-06-26 07:00:00,7
86,165,251,90,22.6,3,Cloudy,5.2,2021-06-26 08:00:00,8
195,292,487,84,23.7,51,Light Drizzle,7.3,2021-06-26 09:00:00,9
375,350,725,79,24.8,51,Light Drizzle,8.5,2021-06-26 10:00:00,10
448,412,860,74,25.9,51,Light Drizzle,9.4,2021-06-26 11:00:00,11
494,395,889,70,26.9,53,Heavy Drizzle,10.1,2021-06-26 12:00:00,12
558,365,923,68,27.8,51,Light Drizzle,11.6,2021-06-26 13:00:00,13
539,396,935,67,28.1,51,Light Drizzle,16.4,2021-06-26 14:00:00,14
570,388,958,66,28.5,51,Light Drizzle,18.3,2021-06-26 15:00:00,15
457,317,774,62,28.9,3,Cloudy,18.1,2021-06-26 16:00:00,16
547,340,887,63,28.6,2,Partly Cloudy,17.6,2021-06-26 17:00:00,17
416,372,788,64,28.3,2,Partly Cloudy,7.6,2021-06-26 18:00:00,18
427,320,747,70,27.5,2,Partly Cloudy,10.8,2021-06-26 19:00:00,19
338,255,593,76,26.3,2,Partly Cloudy,13.4,2021-06-26 20:00:00,20
264,191,455,80,25.3,2,Partly Cloudy,12.6,2021-06-26 21:00:00,21
181,171,352,83,24.6,2,Partly Cloudy,11.3,2021-06-26 22:00:00,22
207,151,358,85,24.1,2,Partly Cloudy,11.9,2021-06-26 23:00:00,23
183,134,317,87,23.8,1,Mostly Clear,12.2,2021-06-27 00:00:00,0
136,99,235,89,23.4,1,Mostly Clear,12.6,2021-06-27 01:00:00,1
121,60,181,91,23.1,1,Mostly Clear,12.4,2021-06-27 02:00:00,2
82,30,112,95,23.1,1,Mostly Clear,12.1,2021-06-27 03:00:00,3
17,13,30,95,22.9,2,Partly Cloudy,12.1,2021-06-27 04:00:00,4
20,12,32,95,22.6,2,Partly Cloudy,11.9,2021-06-27 05:00:00,5
24,41,65,95,22.4,3,Cloudy,10.5,2021-06-27 06:00:00,6
64,79,143,93,22.9,3,Cloudy,12.1,2021-06-27 07:00:00,7
126,175,301,85,24.3,3,Cloudy,13.9,2021-06-27 08:00:00,8
224,266,490,79,25.4,3,Cloudy,13.4,2021-06-27 09:00:00,9
297,272,569,73,26.8,3,Cloudy,13.4,2021-06-27 10:00:00,10
392,345,737,64,28.5,3,Cloudy,12.8,2021-06-27 11:00:00,11
430,341,771,59,29.7,3,Cloudy,13.8,2021-06-27 12:00:00,12
365,332,697,56,30.8,1,Mostly Clear,14.5,2021-06-27 13:00:00,13
469,341,810,53,31.5,1,Mostly Clear,14.3,2021-06-27 14:00:00,14
396,324,720,57,31.9,1,Mostly Clear,14.0,2021-06-27 15:00:00,15
351,324,675,56,32.2,1,Mostly Clear,14.3,2021-06-27 16:00:00,16
293,319,612,56,31.7,1,Mostly Clear,14.5,2021-06-27 17:00:00,17
279,280,559,61,29.5,51,Light Drizzle,11.4,2021-06-27 18:00:00,18
287,287,574,64,29.1,1,Mostly Clear,7.8,2021-06-27 19:00:00,19
264,252,516,69,28.2,1,Mostly Clear,6.2,2021-06-27 20:00:00,20
165,168,333,71,27.1,1,Mostly Clear,8.9,2021-06-27 21:00:00,21
108,88,196,74,26.3,1,Mostly Clear,10.7,2021-06-27 22:00:00,22
67,79,146,76,25.7,0,Clear,11.3,2021-06-27 23:00:00,23
45,25,70,79,25.2,0,Clear,11.6,2021-06-28 00:00:00,0
33,18,51,80,24.7,0,Clear,11.5,2021-06-28 01:00:00,1
6,6,12,81,24.4,0,Clear,11.7,2021-06-28 02:00:00,2
12,6,18,82,24.4,0,Clear,11.8,2021-06-28 03:00:00,3
9,4,13,82,24.2,0,Clear,12.0,2021-06-28 04:00:00,4
21,36,57,83,23.8,0,Clear,11.7,2021-06-28 05:00:00,5
41,128,169,85,23.5,0,Clear,10.8,2021-06-28 06:00:00,6
81,255,336,84,23.9,0,Clear,10.2,2021-06-28 07:00:00,7
120,356,476,79,25.1,0,Clear,10.6,2021-06-28 08:00:00,8
140,241,381,72,26.9,0,Clear,10.2,2021-06-28 09:00:00,9
163,201,364,66,28.8,0,Clear,8.9,2021-06-28 10:00:00,10
175,211,386,60,30.5,0,Clear,8.0,2021-06-28 11:00:00,11
203,242,445,55,31.9,0,Clear,6.8,2021-06-28 12:00:00,12
202,203,405,51,32.8,0,Clear,7.9,2021-06-28 13:00:00,13
205,215,420,49,33.6,1,Mostly Clear,9.9,2021-06-28 14:00:00,14
206,228,434,55,32.6,1,Mostly Clear,11.4,2021-06-28 15:00:00,15
258,323,581,52,32.9,1,Mostly Clear,13.8,2021-06-28 16:00:00,16
270,477,747,51,32.8,1,Mostly Clear,13.4,2021-06-28 17:00:00,17
365,517,882,51,32.0,51,Light Drizzle,9.8,2021-06-28 18:00:00,18
240,377,617,53,31.3,0,Clear,9.5,2021-06-28 19:00:00,19
230,311,541,60,29.8,0,Clear,9.2,2021-06-28 20:00:00,20
140,239,379,65,28.2,0,Clear,11.1,2021-06-28 21:00:00,21
132,139,271,70,27.2,0,Clear,11.5,2021-06-28 22:00:00,22
96,63,159,75,26.5,0,Clear,11.3,2021-06-28 23:00:00,23
30,35,65,77,25.9,0,Clear,11.2,2021-06-29 00:00:00,0
25,14,39,78,25.5,0,Clear,10.2,2021-06-29 01:00:00,1
10,7,17,78,25.2,0,Clear,10.6,2021-06-29 02:00:00,2
6,9,15,81,24.7,0,Clear,10.6,2021-06-29 03:00:00,3
16,8,24,83,24.3,0,Clear,10.3,2021-06-29 04:00:00,4
23,53,76,85,23.9,0,Clear,10.1,2021-06-29 05:00:00,5
50,159,209,88,23.6,0,Clear,9.0,2021-06-29 06:00:00,6
88,323,411,87,24.2,0,Clear,9.7,2021-06-29 07:00:00,7
138,437,575,80,26.1,0,Clear,9.2,2021-06-29 08:00:00,8
124,283,407,72,27.9,0,Clear,9.2,2021-06-29 09:00:00,9
148,210,358,63,29.9,0,Clear,9.0,2021-06-29 10:00:00,10
150,212,362,55,31.6,1,Mostly Clear,7.8,2021-06-29 11:00:00,11
151,234,385,49,33.1,0,Clear,8.4,2021-06-29 12:00:00,12
121,200,321,45,34.1,0,Clear,9.1,2021-06-29 13:00:00,13
151,200,351,40,34.9,0,Clear,9.8,2021-06-29 14:00:00,14
181,229,410,44,34.8,0,Clear,9.9,2021-06-29 15:00:00,15
258,383,641,44,34.4,0,Clear,10.3,2021-06-29 16:00:00,16
305,515,820,44,34.3,0,Clear,11.7,2021-06-29 17:00:00,17
341,569,910,45,33.7,0,Clear,10.5,2021-06-29 18:00:00,18
294,405,699,49,32.6,0,Clear,11.9,2021-06-29 19:00:00,19
197,340,537,55,31.2,0,Clear,11.0,2021-06-29 20:00:00,20
196,233,429,59,29.8,0,Clear,10.7,2021-06-29 21:00:00,21
148,160,308,63,28.8,0,Clear,10.5,2021-06-29 22:00:00,22
71,86,157,66,28.1,0,Clear,11.4,2021-06-29 23:00:00,23
40,23,63,67,27.5,0,Clear,11.5,2021-06-30 00:00:00,0
24,14,38,67,27.1,0,Clear,11.9,2021-06-30 01:00:00,1
8,12,20,66,26.7,0,Clear,11.3,2021-06-30 02:00:00,2
2,4,6,65,26.3,0,Clear,10.8,2021-06-30 03:00:00,3
11,8,19,66,25.6,0,Clear,10.6,2021-06-30 04:00:00,4
17,56,73,67,25.1,0,Clear,10.6,2021-06-30 05:00:00,5
64,159,223,69,24.6,0,Clear,7.9,2021-06-30 06:00:00,6
109,304,413,71,24.7,0,Clear,8.7,2021-06-30 07:00:00,7
155,413,568,63,26.5,0,Clear,8.4,2021-06-30 08:00:00,8
139,276,415,57,28.5,1,Mostly Clear,8.0,2021-06-30 09:00:00,9
150,195,345,50,30.7,0,Clear,7.2,2021-06-30 10:00:00,10
168,201,369,45,32.7,1,Mostly Clear,7.5,2021-06-30 11:00:00,11
191,204,395,40,34.2,1,Mostly Clear,7.2,2021-06-30 12:00:00,12
186,243,429,37,35.2,0,Clear,5.9,2021-06-30 13:00:00,13
143,248,391,35,35.7,0,Clear,6.1,2021-06-30 14:00:00,14
190,276,466,43,35.3,1,Mostly Clear,8.8,2021-06-30 15:00:00,15
207,322,529,41,35.7,0,Clear,11.3,2021-06-30 16:00:00,16
293,503,796,42,35.5,1,Mostly Clear,12.5,2021-06-30 17:00:00,17
302,511,813,43,35.0,1,Mostly Clear,12.4,2021-06-30 18:00:00,18
271,403,674,47,33.3,51,Light Drizzle,11.9,2021-06-30 19:00:00,19
168,251,419,58,30.2,51,Light Drizzle,14.3,2021-06-30 20:00:00,20
136,174,310,63,29.2,1,Mostly Clear,6.4,2021-06-30 21:00:00,21
67,78,145,68,28.5,51,Light Drizzle,4.4,2021-06-30 22:00:00,22
61,75,136,73,27.3,1,Mostly Clear,5.1,2021-06-30 23:00:00,23
43,45,88,79,26.1,0,Clear,4.9,2021-07-01 00:00:00,0
13,17,30,82,25.4,0,Clear,6.0,2021-07-01 01:00:00,1
21,10,31,85,24.8,0,Clear,5.9,2021-07-01 02:00:00,2
9,7,16,85,24.1,0,Clear,4.7,2021-07-01 03:00:00,3
11,16,27,85,24.0,1,Mostly Clear,4.7,2021-07-01 04:00:00,4
24,58,82,87,23.7,1,Mostly Clear,5.6,2021-07-01 05:00:00,5
41,130,171,83,24.1,2,Partly Cloudy,0.8,2021-07-01 06:00:00,6
110,266,376,91,24.0,1,Mostly Clear,3.3,2021-07-01 07:00:00,7
148,427,575,80,25.9,2,Partly Cloudy,6.6,2021-07-01 08:00:00,8
177,269,446,69,27.9,2,Partly Cloudy,3.9,2021-07-01 09:00:00,9
152,243,395,63,29.4,1,Mostly Clear,1.8,2021-07-01 10:00:00,10
173,239,412,58,30.7,1,Mostly Clear,1.1,2021-07-01 11:00:00,11
223,254,477,54,31.9,1,Mostly Clear,3.5,2021-07-01 12:00:00,12
171,228,399,48,33.0,3,Cloudy,6.6,2021-07-01 13:00:00,13
235,246,481,53,32.0,53,Heavy Drizzle,6.9,2021-07-01 14:00:00,14
61,80,141,74,28.5,63,Rain,6.1,2021-07-01 15:00:00,15
171,265,436,81,26.7,65,Heavy Rain,12.1,2021-07-01 16:00:00,16
244,442,686,93,24.8,63,Rain,7.2,2021-07-01 17:00:00,17
280,431,711,90,25.1,51,Light Drizzle,6.4,2021-07-01 18:00:00,18
192,343,535,90,25.4,3,Cloudy,5.1,2021-07-01 19:00:00,19
141,247,388,90,25.1,53,Heavy Drizzle,5.5,2021-07-01 20:00:00,20
26,67,93,95,23.7,65,Heavy Rain,1.8,2021-07-01 21:00:00,21
54,70,124,96,22.9,63,Rain,6.3,2021-07-01 22:00:00,22
60,50,110,95,22.6,61,Light Rain,8.4,2021-07-01 23:00:00,23
41,34,75,95,22.4,61,Light Rain,6.5,2021-07-02 00:00:00,0
18,28,46,96,22.4,61,Light Rain,6.3,2021-07-02 01:00:00,1
12,10,22,96,22.3,55,Heavy Drizzle,9.7,2021-07-02 02:00:00,2
2,7,9,97,21.5,63,Rain,12.5,2021-07-02 03:00:00,3
13,13,26,96,21.4,63,Rain,7.3,2021-07-02 04:00:00,4
7,42,49,96,21.3,61,Light Rain,2.9,2021-07-02 05:00:00,5
27,67,94,97,21.2,53,Heavy Drizzle,8.1,2021-07-02 06:00:00,6
32,133,165,96,21.3,51,Light Drizzle,6.6,2021-07-02 07:00:00,7
66,225,291,95,21.6,55,Heavy Drizzle,7.3,2021-07-02 08:00:00,8
96,204,300,93,21.6,53,Heavy Drizzle,8.2,2021-07-02 09:00:00,9
183,233,416,91,21.7,51,Light Drizzle,7.9,2021-07-02 10:00:00,10
259,254,513,84,22.5,2,Partly Cloudy,10.2,2021-07-02 11:00:00,11
263,280,543,76,23.5,2,Partly Cloudy,10.9,2021-07-02 12:00:00,12
348,336,684,66,24.7,2,Partly Cloudy,10.5,2021-07-02 13:00:00,13
359,360,719,58,25.3,2,Partly Cloudy,11.0,2021-07-02 14:00:00,14
394,358,752,62,25.6,51,Light Drizzle,11.9,2021-07-02 15:00:00,15
460,413,873,52,26.2,2,Partly Cloudy,12.9,2021-07-02 16:00:00,16
482,504,986,45,26.3,1,Mostly Clear,13.2,2021-07-02 17:00:00,17
412,502,914,44,25.8,0,Clear,14.5,2021-07-02 18:00:00,18
383,422,805,48,25.1,0,Clear,11.2,2021-07-02 19:00:00,19
298,296,594,53,23.8,0,Clear,10.7,2021-07-02 20:00:00,20
214,214,428,51,22.5,0,Clear,10.0,2021-07-02 21:00:00,21
247,204,451,53,21.5,0,Clear,11.3,2021-07-02 22:00:00,22
178,154,332,54,20.7,0,Clear,12.2,2021-07-02 23:00:00,23
153,145,298,56,20.1,1,Mostly Clear,12.6,2021-07-03 00:00:00,0
91,84,175,59,19.5,0,Clear,12.6,2021-07-03 01:00:00,1
92,68,160,64,18.9,0,Clear,13.4,2021-07-03 02:00:00,2
62,29,91,66,18.6,0,Clear,13.7,2021-07-03 03:00:00,3
20,7,27,71,18.1,0,Clear,13.3,2021-07-03 04:00:00,4
27,26,53,74,17.7,0,Clear,12.7,2021-07-03 05:00:00,5
40,46,86,78,17.4,0,Clear,9.4,2021-07-03 06:00:00,6
64,101,165,81,17.6,0,Clear,8.9,2021-07-03 07:00:00,7
122,168,290,76,18.9,0,Clear,10.0,2021-07-03 08:00:00,8
262,292,554,71,20.2,0,Clear,10.6,2021-07-03 09:00:00,9
370,358,728,65,21.3,1,Mostly Clear,11.4,2021-07-03 10:00:00,10
580,396,976,59,22.4,1,Mostly Clear,14.2,2021-07-03 11:00:00,11
661,436,1097,56,23.2,51,Light Drizzle,14.1,2021-07-03 12:00:00,12
685,414,1099,54,24.4,1,Mostly Clear,13.8,2021-07-03 13:00:00,13
751,406,1157,54,24.9,2,Partly Cloudy,14.6,2021-07-03 14:00:00,14
653,359,1012,56,24.4,51,Light Drizzle,13.0,2021-07-03 15:00:00,15
755,333,1088,55,24.7,1,Mostly Clear,12.4,2021-07-03 16:00:00,16
623,337,960,53,24.8,0,Clear,11.2,2021-07-03 17:00:00,17
519,391,910,53,24.8,1,Mostly Clear,7.5,2021-07-03 18:00:00,18
527,297,824,60,24.1,1,Mostly Clear,4.6,2021-07-03 19:00:00,19
264,193,457,62,23.5,1,Mostly Clear,3.1,2021-07-03 20:00:00,20
130,135,265,61,22.5,1,Mostly Clear,3.0,2021-07-03 21:00:00,21
190,121,311,64,21.5,1,Mostly Clear,5.4,2021-07-03 22:00:00,22
206,154,360,69,20.7,1,Mostly Clear,5.0,2021-07-03 23:00:00,23
217,104,321,77,19.9,1,Mostly Clear,5.9,2021-07-04 00:00:00,0
148,96,244,81,18.8,1,Mostly Clear,5.0,2021-07-04 01:00:00,1
87,61,148,83,18.1,0,Clear,7.0,2021-07-04 02:00:00,2
66,35,101,85,18.0,0,Clear,7.2,2021-07-04 03:00:00,3
23,8,31,85,17.6,0,Clear,7.6,2021-07-04 04:00:00,4
20,20,40,84,17.3,0,Clear,7.8,2021-07-04 05:00:00,5
42,37,79,84,17.0,0,Clear,8.7,2021-07-04 06:00:00,6
75,69,144,85,17.7,0,Clear,10.2,2021-07-04 07:00:00,7
142,131,273,75,20.3,1,Mostly Clear,8.7,2021-07-04 08:00:00,8
297,228,525,69,22.0,1,Mostly Clear,7.8,2021-07-04 09:00:00,9
554,330,884,64,23.6,0,Clear,7.2,2021-07-04 10:00:00,10
705,329,1034,58,24.8,0,Clear,6.8,2021-07-04 11:00:00,11
718,318,1036,54,26.0,0,Clear,5.5,2021-07-04 12:00:00,12
771,266,1037,53,26.9,1,Mostly Clear,4.7,2021-07-04 13:00:00,13
823,363,1186,52,27.4,1,Mostly Clear,5.4,2021-07-04 14:00:00,14
868,337,1205,49,27.3,1,Mostly Clear,5.0,2021-07-04 15:00:00,15
869,317,1186,48,27.6,1,Mostly Clear,4.0,2021-07-04 16:00:00,16
777,272,1049,47,27.4,0,Clear,3.6,2021-07-04 17:00:00,17
789,281,1070,48,27.2,2,Partly Cloudy,2.3,2021-07-04 18:00:00,18
876,324,1200,53,26.7,1,Mostly Clear,3.4,2021-07-04 19:00:00,19
958,326,1284,67,25.6,1,Mostly Clear,6.2,2021-07-04 20:00:00,20
787,288,1075,69,24.2,0,Clear,5.9,2021-07-04 21:00:00,21
702,301,1003,73,23.2,0,Clear,6.3,2021-07-04 22:00:00,22
501,227,728,75,22.8,0,Clear,6.8,2021-07-04 23:00:00,23
404,153,557,76,22.5,0,Clear,7.3,2021-07-05 00:00:00,0
201,88,289,81,21.9,0,Clear,8.8,2021-07-05 01:00:00,1
91,53,144,83,21.6,1,Mostly Clear,7.9,2021-07-05 02:00:00,2
42,28,70,88,21.0,1,Mostly Clear,7.3,2021-07-05 03:00:00,3
21,19,40,86,21.2,1,Mostly Clear,6.1,2021-07-05 04:00:00,4
27,32,59,85,21.4,1,Mostly Clear,5.7,2021-07-05 05:00:00,5
43,58,101,89,20.8,1,Mostly Clear,3.3,2021-07-05 06:00:00,6
48,64,112,89,21.5,1,Mostly Clear,3.4,2021-07-05 07:00:00,7
116,136,252,84,23.1,1,Mostly Clear,1.8,2021-07-05 08:00:00,8
244,200,444,73,24.9,1,Mostly Clear,3.1,2021-07-05 09:00:00,9
355,249,604,65,26.5,1,Mostly Clear,4.7,2021-07-05 10:00:00,10
463,285,748,58,28.0,2,Partly Cloudy,6.6,2021-07-05 11:00:00,11
515,303,818,51,29.3,2,Partly Cloudy,8.0,2021-07-05 12:00:00,12
534,330,864,48,30.0,2,Partly Cloudy,8.9,2021-07-05 13:00:00,13
521,327,848,47,30.3,2,Partly Cloudy,10.0,2021-07-05 14:00:00,14
529,330,859,49,30.1,1,Mostly Clear,10.0,2021-07-05 15:00:00,15
471,341,812,47,30.6,2,Partly Cloudy,9.4,2021-07-05 16:00:00,16
493,353,846,46,30.8,1,Mostly Clear,8.1,2021-07-05 17:00:00,17
440,355,795,48,30.4,1,Mostly Clear,9.8,2021-07-05 18:00:00,18
332,288,620,54,29.3,1,Mostly Clear,8.7,2021-07-05 19:00:00,19
323,268,591,62,27.5,1,Mostly Clear,9.9,2021-07-05 20:00:00,20
203,164,367,64,26.0,1,Mostly Clear,10.5,2021-07-05 21:00:00,21
136,132,268,68,25.0,0,Clear,11.2,2021-07-05 22:00:00,22
91,62,153,71,24.4,0,Clear,11.6,2021-07-05 23:00:00,23
37,23,60,74,23.8,0,Clear,11.4,2021-07-06 00:00:00,0
32,12,44,77,23.4,0,Clear,10.8,2021-07-06 01:00:00,1
24,11,35,79,23.0,0,Clear,10.5,2021-07-06 02:00:00,2
9,9,18,83,23.0,0,Clear,10.3,2021-07-06 03:00:00,3
13,14,27,84,22.6,0,Clear,9.7,2021-07-06 04:00:00,4
20,67,87,86,22.2,0,Clear,9.2,2021-07-06 05:00:00,5
46,123,169,88,21.8,0,Clear,7.7,2021-07-06 06:00:00,6
78,294,372,87,22.3,0,Clear,9.2,2021-07-06 07:00:00,7
129,414,543,80,24.3,0,Clear,7.6,2021-07-06 08:00:00,8
147,258,405,72,26.3,0,Clear,7.1,2021-07-06 09:00:00,9
191,215,406,64,28.5,1,Mostly Clear,6.6,2021-07-06 10:00:00,10
224,196,420,57,30.6,1,Mostly Clear,5.9,2021-07-06 11:00:00,11
248,232,480,53,32.3,0,Clear,5.9,2021-07-06 12:00:00,12
234,245,479,49,33.5,0,Clear,7.6,2021-07-06 13:00:00,13
251,231,482,45,34.3,0,Clear,8.9,2021-07-06 14:00:00,14
215,254,469,50,33.7,0,Clear,10.5,2021-07-06 15:00:00,15
269,355,624,49,33.8,0,Clear,12.6,2021-07-06 16:00:00,16
272,484,756,48,33.9,0,Clear,13.1,2021-07-06 17:00:00,17
325,544,869,50,33.3,0,Clear,12.5,2021-07-06 18:00:00,18
298,407,705,60,32.0,0,Clear,8.8,2021-07-06 19:00:00,19
248,318,566,65,29.7,0,Clear,10.7,2021-07-06 20:00:00,20
171,188,359,69,28.1,0,Clear,12.1,2021-07-06 21:00:00,21
128,136,264,75,27.0,1,Mostly Clear,8.7,2021-07-06 22:00:00,22
62,68,130,82,25.9,1,Mostly Clear,6.0,2021-07-06 23:00:00,23
36,24,60,83,25.1,0,Clear,7.9,2021-07-07 00:00:00,0
24,10,34,85,24.6,0,Clear,8.4,2021-07-07 01:00:00,1
8,5,13,85,24.2,0,Clear,7.9,2021-07-07 02:00:00,2
11,7,18,84,24.1,0,Clear,6.9,2021-07-07 03:00:00,3
9,7,16,87,23.5,0,Clear,5.9,2021-07-07 04:00:00,4
23,68,91,90,22.9,0,Clear,6.6,2021-07-07 05:00:00,5
61,140,201,91,22.5,0,Clear,5.9,2021-07-07 06:00:00,6
78,328,406,90,23.4,0,Clear,7.5,2021-07-07 07:00:00,7
132,457,589,79,26.0,0,Clear,5.4,2021-07-07 08:00:00,8
142,285,427,71,28.0,0,Clear,5.2,2021-07-07 09:00:00,9
154,189,343,64,29.9,0,Clear,5.0,2021-07-07 10:00:00,10
151,206,357,58,31.5,0,Clear,4.0,2021-07-07 11:00:00,11
165,238,403,52,32.9,0,Clear,3.9,2021-07-07 12:00:00,12
205,251,456,46,34.0,0,Clear,4.9,2021-07-07 13:00:00,13
218,224,442,44,34.3,0,Clear,7.1,2021-07-07 14:00:00,14
199,263,462,49,34.5,1,Mostly Clear,8.7,2021-07-07 15:00:00,15
229,341,570,50,34.4,1,Mostly Clear,10.4,2021-07-07 16:00:00,16
288,544,832,52,33.5,61,Light Rain,11.9,2021-07-07 17:00:00,17
317,606,923,51,33.4,51,Light Drizzle,5.0,2021-07-07 18:00:00,18
259,438,697,56,31.4,0,Clear,8.3,2021-07-07 19:00:00,19
228,348,576,71,29.7,1,Mostly Clear,6.3,2021-07-07 20:00:00,20
179,207,386,64,28.9,1,Mostly Clear,5.8,2021-07-07 21:00:00,21
134,144,278,67,27.7,1,Mostly Clear,7.3,2021-07-07 22:00:00,22
86,80,166,66,27.0,0,Clear,8.4,2021-07-07 23:00:00,23
29,39,68,63,26.6,0,Clear,7.9,2021-07-08 00:00:00,0
19,18,37,63,26.1,0,Clear,7.1,2021-07-08 01:00:00,1
11,11,22,63,25.9,1,Mostly Clear,7.7,2021-07-08 02:00:00,2
8,16,24,74,25.3,1,Mostly Clear,7.2,2021-07-08 03:00:00,3
13,10,23,73,25.2,1,Mostly Clear,7.9,2021-07-08 04:00:00,4
24,71,95,74,24.7,0,Clear,8.5,2021-07-08 05:00:00,5
49,147,196,78,24.1,1,Mostly Clear,3.6,2021-07-08 06:00:00,6
83,294,377,82,24.2,1,Mostly Clear,4.4,2021-07-08 07:00:00,7
138,430,568,72,26.2,1,Mostly Clear,3.7,2021-07-08 08:00:00,8
177,278,455,68,27.3,3,Cloudy,4.0,2021-07-08 09:00:00,9
163,215,378,65,28.2,3,Cloudy,2.8,2021-07-08 10:00:00,10
190,210,400,61,29.6,1,Mostly Clear,3.3,2021-07-08 11:00:00,11
224,257,481,56,31.1,1,Mostly Clear,8.3,2021-07-08 12:00:00,12
202,243,445,54,31.9,3,Cloudy,14.1,2021-07-08 13:00:00,13
134,186,320,52,32.3,2,Partly Cloudy,11.5,2021-07-08 14:00:00,14
155,161,316,72,28.6,2,Partly Cloudy,14.1,2021-07-08 15:00:00,15
206,341,547,78,26.2,63,Rain,17.4,2021-07-08 16:00:00,16
276,509,785,89,25.3,61,Light Rain,11.2,2021-07-08 17:00:00,17
234,420,654,92,24.8,55,Heavy Drizzle,5.4,2021-07-08 18:00:00,18
80,229,309,94,24.3,53,Heavy Drizzle,5.2,2021-07-08 19:00:00,19
54,136,190,90,23.8,51,Light Drizzle,5.2,2021-07-08 20:00:00,20
42,69,111,92,22.9,51,Light Drizzle,11.2,2021-07-08 21:00:00,21
59,86,145,93,22.4,53,Heavy Drizzle,13.7,2021-07-08 22:00:00,22
63,79,142,95,22.1,53,Heavy Drizzle,14.8,2021-07-08 23:00:00,23
17,43,60,95,22.1,61,Light Rain,16.6,2021-07-09 00:00:00,0
12,13,25,96,21.9,61,Light Rain,18.9,2021-07-09 01:00:00,1
6,6,12,95,21.8,53,Heavy Drizzle,18.5,2021-07-09 02:00:00,2
10,6,16,92,21.2,65,Heavy Rain,15.8,2021-07-09 03:00:00,3
7,10,17,94,21.0,61,Light Rain,12.8,2021-07-09 04:00:00,4
18,54,72,94,21.0,3,Cloudy,10.4,2021-07-09 05:00:00,5
52,135,187,94,20.8,0,Clear,8.1,2021-07-09 06:00:00,6
98,252,350,94,21.2,0,Clear,6.8,2021-07-09 07:00:00,7
149,381,530,90,22.6,1,Mostly Clear,8.6,2021-07-09 08:00:00,8
153,263,416,82,24.5,1,Mostly Clear,9.6,2021-07-09 09:00:00,9
198,217,415,73,26.4,2,Partly Cloudy,11.9,2021-07-09 10:00:00,10
247,239,486,68,27.6,2,Partly Cloudy,11.9,2021-07-09 11:00:00,11
297,277,574,64,28.8,2,Partly Cloudy,11.2,2021-07-09 12:00:00,12
253,283,536,61,29.8,2,Partly Cloudy,9.8,2021-07-09 13:00:00,13
282,302,584,60,30.3,2,Partly Cloudy,8.4,2021-07-09 14:00:00,14
289,324,613,58,31.0,2,Partly Cloudy,7.4,2021-07-09 15:00:00,15
142,172,314,55,31.4,2,Partly Cloudy,8.7,2021-07-09 16:00:00,16
133,271,404,55,31.3,2,Partly Cloudy,7.8,2021-07-09 17:00:00,17
221,414,635,62,29.7,53,Heavy Drizzle,3.2,2021-07-09 18:00:00,18
274,358,632,70,28.1,53,Heavy Drizzle,5.1,2021-07-09 19:00:00,19
279,288,567,82,26.2,53,Heavy Drizzle,4.7,2021-07-09 20:00:00,20
189,199,388,86,25.2,0,Clear,4.0,2021-07-09 21:00:00,21
151,169,320,89,24.7,1,Mostly Clear,4.9,2021-07-09 22:00:00,22
172,142,314,92,24.2,2,Partly Cloudy,8.3,2021-07-09 23:00:00,23
123,86,209,93,23.8,1,Mostly Clear,9.8,2021-07-10 00:00:00,0
112,81,193,90,23.7,1,Mostly Clear,12.5,2021-07-10 01:00:00,1
103,62,165,84,23.3,1,Mostly Clear,14.2,2021-07-10 02:00:00,2
57,26,83,73,23.0,1,Mostly Clear,14.1,2021-07-10 03:00:00,3
22,15,37,71,22.4,0,Clear,12.7,2021-07-10 04:00:00,4
21,35,56,72,21.7,0,Clear,11.2,2021-07-10 05:00:00,5
32,68,100,74,21.0,1,Mostly Clear,9.3,2021-07-10 06:00:00,6
69,115,184,76,20.7,0,Clear,10.7,2021-07-10 07:00:00,7
151,206,357,71,21.3,1,Mostly Clear,12.3,2021-07-10 08:00:00,8
318,317,635,67,22.2,1,Mostly Clear,10.3,2021-07-10 09:00:00,9
396,396,792,64,23.5,3,Cloudy,10.5,2021-07-10 10:00:00,10
503,431,934,59,24.9,3,Cloudy,9.4,2021-07-10 11:00:00,11
516,438,954,55,25.9,3,Cloudy,8.7,2021-07-10 12:00:00,12
632,453,1085,51,27.1,2,Partly Cloudy,9.0,2021-07-10 13:00:00,13
540,429,969,49,27.9,1,Mostly Clear,7.6,2021-07-10 14:00:00,14
627,453,1080,47,28.4,1,Mostly Clear,7.7,2021-07-10 15:00:00,15
605,376,981,46,28.7,0,Clear,7.7,2021-07-10 16:00:00,16
542,345,887,44,28.8,0,Clear,7.1,2021-07-10 17:00:00,17
545,419,964,45,28.7,0,Clear,6.6,2021-07-10 18:00:00,18
451,387,838,51,27.7,0,Clear,4.2,2021-07-10 19:00:00,19
367,260,627,61,26.1,0,Clear,0.4,2021-07-10 20:00:00,20
293,197,490,65,24.7,1,Mostly Clear,3.2,2021-07-10 21:00:00,21
237,212,449,70,23.9,1,Mostly Clear,4.7,2021-07-10 22:00:00,22
236,174,410,74,23.1,1,Mostly Clear,4.3,2021-07-10 23:00:00,23
161,136,297,77,22.8,1,Mostly Clear,6.4,2021-07-11 00:00:00,0
164,115,279,78,22.7,1,Mostly Clear,7.2,2021-07-11 01:00:00,1
119,73,192,79,22.6,1,Mostly Clear,7.7,2021-07-11 02:00:00,2
80,32,112,80,22.3,2,Partly Cloudy,7.0,2021-07-11 03:00:00,3
26,18,44,81,22.2,1,Mostly Clear,6.8,2021-07-11 04:00:00,4
24,16,40,82,22.1,1,Mostly Clear,7.7,2021-07-11 05:00:00,5
30,36,66,84,21.9,2,Partly Cloudy,6.1,2021-07-11 06:00:00,6
75,81,156,85,22.6,3,Cloudy,6.9,2021-07-11 07:00:00,7
139,164,303,80,24.3,3,Cloudy,6.8,2021-07-11 08:00:00,8
226,211,437,76,25.9,3,Cloudy,6.9,2021-07-11 09:00:00,9
370,315,685,74,27.3,3,Cloudy,8.6,2021-07-11 10:00:00,10
386,402,788,71,28.8,51,Light Drizzle,10.8,2021-07-11 11:00:00,11
443,369,812,69,29.9,3,Cloudy,12.5,2021-07-11 12:00:00,12
403,388,791,67,30.7,1,Mostly Clear,11.1,2021-07-11 13:00:00,13
542,446,988,67,30.9,0,Clear,10.9,2021-07-11 14:00:00,14
391,310,701,63,30.8,1,Mostly Clear,12.6,2021-07-11 15:00:00,15
342,287,629,76,28.3,61,Light Rain,14.0,2021-07-11 16:00:00,16
299,308,607,79,27.8,51,Light Drizzle,16.2,2021-07-11 17:00:00,17
402,389,791,80,27.6,1,Mostly Clear,8.8,2021-07-11 18:00:00,18
370,317,687,82,27.1,1,Mostly Clear,10.2,2021-07-11 19:00:00,19
294,267,561,85,26.6,1,Mostly Clear,6.9,2021-07-11 20:00:00,20
200,158,358,88,25.9,1,Mostly Clear,7.5,2021-07-11 21:00:00,21
108,134,242,91,25.4,1,Mostly Clear,10.0,2021-07-11 22:00:00,22
74,64,138,93,25.2,1,Mostly Clear,11.9,2021-07-11 23:00:00,23
20,31,51,92,25.1,0,Clear,13.4,2021-07-12 00:00:00,0
21,18,39,91,24.9,1,Mostly Clear,14.2,2021-07-12 01:00:00,1
7,13,20,91,24.8,1,Mostly Clear,14.2,2021-07-12 02:00:00,2
4,10,14,91,24.8,0,Clear,12.9,2021-07-12 03:00:00,3
12,11,23,92,24.6,0,Clear,12.1,2021-07-12 04:00:00,4
16,58,74,92,24.4,0,Clear,11.3,2021-07-12 05:00:00,5
39,135,174,93,24.3,0,Clear,6.6,2021-07-12 06:00:00,6
71,332,403,92,24.6,0,Clear,7.5,2021-07-12 07:00:00,7
136,406,542,87,25.9,1,Mostly Clear,11.0,2021-07-12 08:00:00,8
133,297,430,79,27.6,2,Partly Cloudy,11.2,2021-07-12 09:00:00,9
231,163,394,72,29.1,2,Partly Cloudy,9.5,2021-07-12 10:00:00,10
245,209,454,68,30.4,0,Clear,7.1,2021-07-12 11:00:00,11
189,224,413,65,31.6,0,Clear,6.3,2021-07-12 12:00:00,12
242,246,488,62,32.5,2,Partly Cloudy,7.1,2021-07-12 13:00:00,13
218,215,433,60,33.0,1,Mostly Clear,9.1,2021-07-12 14:00:00,14
233,230,463,64,31.9,53,Heavy Drizzle,10.1,2021-07-12 15:00:00,15
252,317,569,63,32.1,51,Light Drizzle,11.2,2021-07-12 16:00:00,16
304,539,843,61,32.2,51,Light Drizzle,10.1,2021-07-12 17:00:00,17
296,604,900,61,31.8,1,Mostly Clear,10.5,2021-07-12 18:00:00,18
286,395,681,63,31.3,1,Mostly Clear,0.7,2021-07-12 19:00:00,19
223,318,541,69,30.0,2,Partly Cloudy,3.6,2021-07-12 20:00:00,20
153,190,343,70,29.0,51,Light Drizzle,7.2,2021-07-12 21:00:00,21
126,127,253,70,28.4,3,Cloudy,6.9,2021-07-12 22:00:00,22
56,57,113,70,27.9,2,Partly Cloudy,3.6,2021-07-12 23:00:00,23
31,26,57,72,27.3,2,Partly Cloudy,5.1,2021-07-13 00:00:00,0
22,12,34,75,26.6,1,Mostly Clear,6.1,2021-07-13 01:00:00,1
9,11,20,78,26.0,0,Clear,5.0,2021-07-13 02:00:00,2
10,7,17,94,25.3,0,Clear,5.9,2021-07-13 03:00:00,3
11,16,27,93,25.1,0,Clear,5.8,2021-07-13 04:00:00,4
21,68,89,92,24.9,0,Clear,6.5,2021-07-13 05:00:00,5
42,162,204,92,24.6,0,Clear,5.3,2021-07-13 06:00:00,6
104,336,440,92,24.8,0,Clear,4.3,2021-07-13 07:00:00,7
143,465,608,87,26.1,0,Clear,5.5,2021-07-13 08:00:00,8
174,271,445,79,27.6,0,Clear,7.5,2021-07-13 09:00:00,9
165,177,342,71,29.1,0,Clear,7.7,2021-07-13 10:00:00,10
154,242,396,63,30.8,0,Clear,6.7,2021-07-13 11:00:00,11
203,251,454,55,32.3,0,Clear,6.5,2021-07-13 12:00:00,12
161,248,409,50,33.5,0,Clear,9.0,2021-07-13 13:00:00,13
171,252,423,46,34.3,0,Clear,11.8,2021-07-13 14:00:00,14
193,225,418,49,34.1,0,Clear,14.5,2021-07-13 15:00:00,15
240,353,593,45,34.0,1,Mostly Clear,16.4,2021-07-13 16:00:00,16
332,576,908,45,33.2,0,Clear,17.2,2021-07-13 17:00:00,17
347,637,984,49,32.5,0,Clear,15.9,2021-07-13 18:00:00,18
322,482,804,51,31.7,0,Clear,15.5,2021-07-13 19:00:00,19
251,332,583,55,30.4,0,Clear,13.8,2021-07-13 20:00:00,20
164,235,399,56,29.2,0,Clear,14.2,2021-07-13 21:00:00,21
142,162,304,60,28.3,0,Clear,13.6,2021-07-13 22:00:00,22
76,96,172,64,27.4,0,Clear,13.7,2021-07-13 23:00:00,23
39,26,65,66,26.9,0,Clear,13.3,2021-07-14 00:00:00,0
26,18,44,67,26.6,1,Mostly Clear,11.9,2021-07-14 01:00:00,1
22,13,35,68,26.3,0,Clear,11.0,2021-07-14 02:00:00,2
13,3,16,74,26.0,0,Clear,9.8,2021-07-14 03:00:00,3
11,8,19,76,25.5,0,Clear,8.9,2021-07-14 04:00:00,4
22,62,84,78,24.9,0,Clear,7.9,2021-07-14 05:00:00,5
58,156,214,82,24.4,0,Clear,5.1,2021-07-14 06:00:00,6
87,375,462,85,24.5,0,Clear,7.2,2021-07-14 07:00:00,7
158,483,641,74,26.5,0,Clear,5.1,2021-07-14 08:00:00,8
134,284,418,69,27.8,0,Clear,4.6,2021-07-14 09:00:00,9
161,215,376,61,29.4,1,Mostly Clear,6.8,2021-07-14 10:00:00,10
192,227,419,52,30.7,1,Mostly Clear,7.6,2021-07-14 11:00:00,11
197,239,436,48,31.8,0,Clear,7.0,2021-07-14 12:00:00,12
208,242,450,46,32.8,1,Mostly Clear,7.1,2021-07-14 13:00:00,13
200,246,446,45,33.3,3,Cloudy,6.8,2021-07-14 14:00:00,14
212,262,474,45,32.8,2,Partly Cloudy,6.0,2021-07-14 15:00:00,15
219,337,556,67,28.3,63,Rain,1.8,2021-07-14 16:00:00,16
237,483,720,76,27.1,61,Light Rain,5.4,2021-07-14 17:00:00,17
273,494,767,75,27.3,1,Mostly Clear,11.3,2021-07-14 18:00:00,18
254,463,717,75,27.3,1,Mostly Clear,10.9,2021-07-14 19:00:00,19
260,328,588,79,26.8,1,Mostly Clear,11.0,2021-07-14 20:00:00,20
193,241,434,82,26.0,0,Clear,10.3,2021-07-14 21:00:00,21
147,212,359,86,25.4,0,Clear,9.5,2021-07-14 22:00:00,22
105,110,215,90,24.6,0,Clear,8.1,2021-07-14 23:00:00,23
59,47,106,93,24.1,0,Clear,9.2,2021-07-15 00:00:00,0
32,31,63,94,23.6,0,Clear,8.9,2021-07-15 01:00:00,1
13,17,30,96,23.2,0,Clear,7.1,2021-07-15 02:00:00,2
3,8,11,92,22.4,0,Clear,5.7,2021-07-15 03:00:00,3
14,15,29,93,22.1,0,Clear,4.2,2021-07-15 04:00:00,4
29,61,90,95,21.7,0,Clear,3.6,2021-07-15 05:00:00,5
47,144,191,96,21.5,3,Cloudy,4.1,2021-07-15 06:00:00,6
83,310,393,96,22.3,2,Partly Cloudy,4.2,2021-07-15 07:00:00,7
164,481,645,87,24.7,1,Mostly Clear,2.5,2021-07-15 08:00:00,8
155,313,468,78,26.8,1,Mostly Clear,2.4,2021-07-15 09:00:00,9
176,204,380,68,28.7,1,Mostly Clear,2.8,2021-07-15 10:00:00,10
195,195,390,59,30.2,1,Mostly Clear,3.1,2021-07-15 11:00:00,11
214,224,438,54,31.3,1,Mostly Clear,3.2,2021-07-15 12:00:00,12
222,258,480,51,31.8,2,Partly Cloudy,2.5,2021-07-15 13:00:00,13
249,223,472,49,32.6,2,Partly Cloudy,3.1,2021-07-15 14:00:00,14
268,273,541,54,32.2,1,Mostly Clear,4.5,2021-07-15 15:00:00,15
304,385,689,53,32.4,1,Mostly Clear,5.4,2021-07-15 16:00:00,16
386,573,959,52,32.4,2,Partly Cloudy,6.2,2021-07-15 17:00:00,17
450,570,1020,59,30.7,51,Light Drizzle,7.9,2021-07-15 18:00:00,18
336,504,840,66,29.3,1,Mostly Clear,9.2,2021-07-15 19:00:00,19
274,399,673,75,27.9,1,Mostly Clear,10.0,2021-07-15 20:00:00,20
207,267,474,79,26.9,1,Mostly Clear,9.7,2021-07-15 21:00:00,21
178,179,357,82,26.3,1,Mostly Clear,9.2,2021-07-15 22:00:00,22
120,118,238,85,25.9,1,Mostly Clear,7.1,2021-07-15 23:00:00,23
53,42,95,88,25.5,1,Mostly Clear,8.2,2021-07-16 00:00:00,0
39,42,81,88,25.3,0,Clear,7.9,2021-07-16 01:00:00,1
25,18,43,89,25.0,1,Mostly Clear,6.9,2021-07-16 02:00:00,2
11,8,19,89,24.9,0,Clear,6.2,2021-07-16 03:00:00,3
15,9,24,91,24.3,0,Clear,5.6,2021-07-16 04:00:00,4
33,57,90,93,23.6,0,Clear,4.9,2021-07-16 05:00:00,5
47,135,182,94,23.0,1,Mostly Clear,5.1,2021-07-16 06:00:00,6
80,285,365,92,23.8,1,Mostly Clear,5.9,2021-07-16 07:00:00,7
154,406,560,81,26.2,0,Clear,4.3,2021-07-16 08:00:00,8
171,285,456,69,28.3,0,Clear,4.3,2021-07-16 09:00:00,9
249,231,480,60,30.0,0,Clear,5.2,2021-07-16 10:00:00,10
260,218,478,53,31.2,1,Mostly Clear,4.6,2021-07-16 11:00:00,11
245,248,493,50,31.7,0,Clear,5.4,2021-07-16 12:00:00,12
241,252,493,48,32.4,0,Clear,5.8,2021-07-16 13:00:00,13
270,300,570,45,33.1,1,Mostly Clear,7.5,2021-07-16 14:00:00,14
287,289,576,43,33.3,1,Mostly Clear,7.4,2021-07-16 15:00:00,15
283,411,694,43,33.5,1,Mostly Clear,7.2,2021-07-16 16:00:00,16
366,543,909,44,33.6,0,Clear,8.1,2021-07-16 17:00:00,17
384,518,902,46,33.0,1,Mostly Clear,10.3,2021-07-16 18:00:00,18
403,394,797,51,32.0,1,Mostly Clear,9.4,2021-07-16 19:00:00,19
318,332,650,58,30.5,0,Clear,8.5,2021-07-16 20:00:00,20
265,251,516,62,29.3,0,Clear,9.5,2021-07-16 21:00:00,21
272,185,457,67,28.5,0,Clear,8.5,2021-07-16 22:00:00,22
252,207,459,70,27.9,0,Clear,8.3,2021-07-16 23:00:00,23
218,158,376,70,27.5,1,Mostly Clear,8.7,2021-07-17 00:00:00,0
137,106,243,72,27.2,1,Mostly Clear,9.1,2021-07-17 01:00:00,1
160,68,228,74,26.7,1,Mostly Clear,9.4,2021-07-17 02:00:00,2
50,23,73,78,26.4,0,Clear,8.3,2021-07-17 03:00:00,3
20,14,34,80,26.0,0,Clear,6.4,2021-07-17 04:00:00,4
22,17,39,83,25.6,0,Clear,6.7,2021-07-17 05:00:00,5
48,69,117,87,25.2,0,Clear,2.6,2021-07-17 06:00:00,6
69,126,195,88,25.4,0,Clear,2.6,2021-07-17 07:00:00,7
154,202,356,81,27.1,0,Clear,3.4,2021-07-17 08:00:00,8
267,299,566,75,28.5,0,Clear,4.0,2021-07-17 09:00:00,9
374,377,751,72,29.5,0,Clear,5.0,2021-07-17 10:00:00,10
478,366,844,67,31.0,0,Clear,6.7,2021-07-17 11:00:00,11
484,393,877,61,32.3,0,Clear,9.0,2021-07-17 12:00:00,12
460,345,805,56,33.3,1,Mostly Clear,11.3,2021-07-17 13:00:00,13
509,288,797,53,34.0,1,Mostly Clear,12.9,2021-07-17 14:00:00,14
463,323,786,59,32.3,53,Heavy Drizzle,13.4,2021-07-17 15:00:00,15
358,313,671,59,32.2,61,Light Rain,12.6,2021-07-17 16:00:00,16
300,253,553,61,31.7,51,Light Drizzle,11.2,2021-07-17 17:00:00,17
322,298,620,83,27.5,63,Rain,3.8,2021-07-17 18:00:00,18
285,255,540,87,26.6,61,Light Rain,2.9,2021-07-17 19:00:00,19
262,233,495,88,26.1,3,Cloudy,6.5,2021-07-17 20:00:00,20
201,194,395,90,25.5,3,Cloudy,5.8,2021-07-17 21:00:00,21
243,173,416,92,25.1,2,Partly Cloudy,7.6,2021-07-17 22:00:00,22
224,140,364,93,24.9,1,Mostly Clear,9.6,2021-07-17 23:00:00,23
186,105,291,93,24.9,1,Mostly Clear,10.1,2021-07-18 00:00:00,0
166,69,235,92,24.8,0,Clear,10.0,2021-07-18 01:00:00,1
103,64,167,92,24.7,0,Clear,9.9,2021-07-18 02:00:00,2
77,39,116,94,23.6,0,Clear,9.8,2021-07-18 03:00:00,3
25,22,47,94,23.3,1,Mostly Clear,9.1,2021-07-18 04:00:00,4
16,20,36,94,23.2,1,Mostly Clear,10.1,2021-07-18 05:00:00,5
30,34,64,93,23.0,1,Mostly Clear,10.7,2021-07-18 06:00:00,6
71,82,153,88,22.5,0,Clear,12.4,2021-07-18 07:00:00,7
120,147,267,79,22.4,0,Clear,14.9,2021-07-18 08:00:00,8
240,286,526,70,23.2,0,Clear,18.1,2021-07-18 09:00:00,9
393,340,733,64,24.6,2,Partly Cloudy,19.3,2021-07-18 10:00:00,10
447,326,773,59,26.0,3,Cloudy,19.0,2021-07-18 11:00:00,11
464,403,867,55,27.0,2,Partly Cloudy,18.7,2021-07-18 12:00:00,12
498,399,897,49,28.4,1,Mostly Clear,18.2,2021-07-18 13:00:00,13
539,360,899,46,29.2,1,Mostly Clear,17.7,2021-07-18 14:00:00,14
575,354,929,51,28.1,2,Partly Cloudy,17.4,2021-07-18 15:00:00,15
525,372,897,49,28.7,3,Cloudy,18.4,2021-07-18 16:00:00,16
488,390,878,48,28.7,1,Mostly Clear,17.8,2021-07-18 17:00:00,17
404,385,789,49,28.0,3,Cloudy,14.3,2021-07-18 18:00:00,18
315,310,625,51,27.3,1,Mostly Clear,9.9,2021-07-18 19:00:00,19
270,230,500,69,26.0,1,Mostly Clear,5.6,2021-07-18 20:00:00,20
162,183,345,54,26.4,1,Mostly Clear,3.6,2021-07-18 21:00:00,21
107,123,230,74,23.6,1,Mostly Clear,6.5,2021-07-18 22:00:00,22
76,74,150,72,23.9,1,Mostly Clear,7.9,2021-07-18 23:00:00,23
61,24,85,72,24.1,1,Mostly Clear,8.4,2021-07-19 00:00:00,0
19,24,43,84,21.9,1,Mostly Clear,9.2,2021-07-19 01:00:00,1
12,37,49,84,21.5,1,Mostly Clear,9.7,2021-07-19 02:00:00,2
6,31,37,73,21.8,1,Mostly Clear,10.5,2021-07-19 03:00:00,3
9,8,17,70,21.8,1,Mostly Clear,10.3,2021-07-19 04:00:00,4
11,53,64,71,21.6,1,Mostly Clear,9.9,2021-07-19 05:00:00,5
51,132,183,76,21.1,1,Mostly Clear,6.9,2021-07-19 06:00:00,6
79,291,370,82,20.9,1,Mostly Clear,7.1,2021-07-19 07:00:00,7
137,433,570,74,22.8,1,Mostly Clear,4.4,2021-07-19 08:00:00,8
155,258,413,68,24.6,1,Mostly Clear,4.0,2021-07-19 09:00:00,9
184,190,374,61,26.5,1,Mostly Clear,4.0,2021-07-19 10:00:00,10
203,191,394,54,27.9,1,Mostly Clear,4.0,2021-07-19 11:00:00,11
249,228,477,47,29.0,2,Partly Cloudy,4.2,2021-07-19 12:00:00,12
271,194,465,43,30.1,1,Mostly Clear,3.5,2021-07-19 13:00:00,13
280,204,484,41,30.4,1,Mostly Clear,3.4,2021-07-19 14:00:00,14
234,244,478,43,30.4,1,Mostly Clear,3.5,2021-07-19 15:00:00,15
260,331,591,41,30.9,0,Clear,4.3,2021-07-19 16:00:00,16
355,575,930,40,30.8,0,Clear,3.5,2021-07-19 17:00:00,17
366,656,1022,42,30.4,1,Mostly Clear,4.3,2021-07-19 18:00:00,18
272,445,717,48,29.5,1,Mostly Clear,2.4,2021-07-19 19:00:00,19
228,329,557,56,27.9,0,Clear,2.5,2021-07-19 20:00:00,20
157,230,387,61,26.2,0,Clear,5.0,2021-07-19 21:00:00,21
133,172,305,66,25.1,0,Clear,4.5,2021-07-19 22:00:00,22
72,72,144,71,24.1,0,Clear,7.2,2021-07-19 23:00:00,23
31,25,56,75,23.3,0,Clear,7.2,2021-07-20 00:00:00,0
21,20,41,79,22.6,0,Clear,5.6,2021-07-20 01:00:00,1
13,8,21,81,21.9,0,Clear,5.5,2021-07-20 02:00:00,2
6,8,14,90,21.9,0,Clear,5.5,2021-07-20 03:00:00,3
6,14,20,91,21.6,0,Clear,5.5,2021-07-20 04:00:00,4
25,74,99,92,21.1,0,Clear,5.8,2021-07-20 05:00:00,5
64,164,228,91,20.8,0,Clear,6.4,2021-07-20 06:00:00,6
95,370,465,90,21.4,0,Clear,7.6,2021-07-20 07:00:00,7
157,548,705,76,24.5,0,Clear,5.8,2021-07-20 08:00:00,8
128,256,384,68,26.5,0,Clear,6.4,2021-07-20 09:00:00,9
150,174,324,61,28.2,0,Clear,6.5,2021-07-20 10:00:00,10
157,202,359,55,29.4,0,Clear,4.3,2021-07-20 11:00:00,11
188,242,430,50,30.5,1,Mostly Clear,3.3,2021-07-20 12:00:00,12
214,230,444,46,31.4,0,Clear,2.7,2021-07-20 13:00:00,13
209,225,434,42,32.2,1,Mostly Clear,2.0,2021-07-20 14:00:00,14
227,257,484,44,31.9,1,Mostly Clear,2.2,2021-07-20 15:00:00,15
264,399,663,43,32.1,0,Clear,2.6,2021-07-20 16:00:00,16
378,668,1046,42,32.0,0,Clear,2.6,2021-07-20 17:00:00,17
376,653,1029,42,31.9,1,Mostly Clear,5.8,2021-07-20 18:00:00,18
314,462,776,47,30.9,1,Mostly Clear,1.8,2021-07-20 19:00:00,19
234,390,624,56,29.2,1,Mostly Clear,3.6,2021-07-20 20:00:00,20
180,228,408,63,27.5,1,Mostly Clear,4.7,2021-07-20 21:00:00,21
125,157,282,68,26.5,1,Mostly Clear,6.5,2021-07-20 22:00:00,22
101,103,204,72,25.9,0,Clear,9.0,2021-07-20 23:00:00,23
64,50,114,74,25.5,1,Mostly Clear,9.8,2021-07-21 00:00:00,0
26,16,42,74,25.2,0,Clear,9.7,2021-07-21 01:00:00,1
9,10,19,73,24.9,0,Clear,9.2,2021-07-21 02:00:00,2
8,6,14,72,24.2,0,Clear,8.1,2021-07-21 03:00:00,3
10,8,18,74,23.5,0,Clear,7.2,2021-07-21 04:00:00,4
30,60,90,76,22.9,0,Clear,7.1,2021-07-21 05:00:00,5
53,135,188,80,22.3,0,Clear,7.8,2021-07-21 06:00:00,6
108,342,450,80,22.8,0,Clear,8.6,2021-07-21 07:00:00,7
164,533,697,68,25.5,0,Clear,8.5,2021-07-21 08:00:00,8
161,355,516,61,27.5,0,Clear,10.1,2021-07-21 09:00:00,9
159,200,359,54,29.3,0,Clear,10.3,2021-07-21 10:00:00,10
199,205,404,49,30.5,0,Clear,10.0,2021-07-21 11:00:00,11
202,233,435,47,31.3,1,Mostly Clear,10.5,2021-07-21 12:00:00,12
155,203,358,42,32.1,1,Mostly Clear,10.7,2021-07-21 13:00:00,13
226,220,446,40,32.4,1,Mostly Clear,10.8,2021-07-21 14:00:00,14
223,261,484,53,30.2,53,Heavy Drizzle,11.9,2021-07-21 15:00:00,15
260,352,612,49,30.9,51,Light Drizzle,13.5,2021-07-21 16:00:00,16
354,609,963,50,30.2,2,Partly Cloudy,13.0,2021-07-21 17:00:00,17
344,585,929,57,28.4,51,Light Drizzle,8.2,2021-07-21 18:00:00,18
322,423,745,60,28.0,1,Mostly Clear,1.9,2021-07-21 19:00:00,19
238,335,573,65,27.1,1,Mostly Clear,6.4,2021-07-21 20:00:00,20
211,274,485,68,25.8,1,Mostly Clear,13.5,2021-07-21 21:00:00,21
194,195,389,69,25.1,1,Mostly Clear,13.6,2021-07-21 22:00:00,22
106,110,216,70,24.3,1,Mostly Clear,11.2,2021-07-21 23:00:00,23
40,39,79,71,23.5,0,Clear,10.8,2021-07-22 00:00:00,0
19,24,43,71,23.0,0,Clear,10.5,2021-07-22 01:00:00,1
14,22,36,72,22.4,0,Clear,10.2,2021-07-22 02:00:00,2
8,23,31,70,21.4,0,Clear,9.5,2021-07-22 03:00:00,3
16,33,49,71,20.7,0,Clear,9.3,2021-07-22 04:00:00,4
16,67,83,73,20.0,0,Clear,9.4,2021-07-22 05:00:00,5
58,127,185,75,19.4,0,Clear,8.6,2021-07-22 06:00:00,6
101,346,447,77,19.4,0,Clear,8.7,2021-07-22 07:00:00,7
149,428,577,67,21.2,0,Clear,8.4,2021-07-22 08:00:00,8
154,290,444,57,23.0,0,Clear,10.1,2021-07-22 09:00:00,9
140,183,323,49,24.3,0,Clear,11.2,2021-07-22 10:00:00,10
172,208,380,45,25.5,1,Mostly Clear,11.5,2021-07-22 11:00:00,11
204,258,462,41,26.5,1,Mostly Clear,11.9,2021-07-22 12:00:00,12
158,268,426,39,27.4,1,Mostly Clear,10.5,2021-07-22 13:00:00,13
198,247,445,37,28.1,1,Mostly Clear,8.7,2021-07-22 14:00:00,14
234,275,509,37,28.0,0,Clear,8.1,2021-07-22 15:00:00,15
301,364,665,34,28.7,1,Mostly Clear,9.6,2021-07-22 16:00:00,16
447,680,1127,34,28.6,1,Mostly Clear,8.9,2021-07-22 17:00:00,17
472,630,1102,36,28.2,0,Clear,7.2,2021-07-22 18:00:00,18
371,485,856,40,27.5,0,Clear,7.2,2021-07-22 19:00:00,19
276,353,629,49,25.9,0,Clear,4.3,2021-07-22 20:00:00,20
232,234,466,54,24.4,0,Clear,4.5,2021-07-22 21:00:00,21
157,161,318,62,23.3,0,Clear,3.5,2021-07-22 22:00:00,22
123,109,232,73,22.1,1,Mostly Clear,1.8,2021-07-22 23:00:00,23
64,37,101,63,23.4,1,Mostly Clear,4.0,2021-07-23 00:00:00,0
46,24,70,75,21.5,1,Mostly Clear,5.2,2021-07-23 01:00:00,1
24,16,40,82,20.2,1,Mostly Clear,5.9,2021-07-23 02:00:00,2
11,12,23,74,19.3,1,Mostly Clear,5.7,2021-07-23 03:00:00,3
13,14,27,76,18.7,0,Clear,6.4,2021-07-23 04:00:00,4
18,39,57,73,18.4,0,Clear,7.7,2021-07-23 05:00:00,5
61,145,206,73,18.4,0,Clear,7.2,2021-07-23 06:00:00,6
91,270,361,75,18.7,1,Mostly Clear,8.3,2021-07-23 07:00:00,7
152,383,535,63,21.4,1,Mostly Clear,6.9,2021-07-23 08:00:00,8
133,276,409,59,23.0,1,Mostly Clear,7.3,2021-07-23 09:00:00,9
161,207,368,53,25.0,1,Mostly Clear,7.4,2021-07-23 10:00:00,10
234,265,499,46,26.4,0,Clear,8.2,2021-07-23 11:00:00,11
280,275,555,42,27.5,1,Mostly Clear,8.1,2021-07-23 12:00:00,12
308,287,595,39,28.4,1,Mostly Clear,7.4,2021-07-23 13:00:00,13
346,265,611,36,29.2,1,Mostly Clear,6.5,2021-07-23 14:00:00,14
313,319,632,36,29.1,2,Partly Cloudy,6.4,2021-07-23 15:00:00,15
380,412,792,35,29.4,2,Partly Cloudy,6.6,2021-07-23 16:00:00,16
418,573,991,37,28.6,1,Mostly Clear,8.2,2021-07-23 17:00:00,17
406,552,958,41,27.6,1,Mostly Clear,4.9,2021-07-23 18:00:00,18
426,487,913,44,26.7,1,Mostly Clear,4.4,2021-07-23 19:00:00,19
348,336,684,51,25.4,1,Mostly Clear,4.7,2021-07-23 20:00:00,20
239,241,480,54,24.1,0,Clear,5.1,2021-07-23 21:00:00,21
212,186,398,60,23.2,0,Clear,6.0,2021-07-23 22:00:00,22
163,151,314,69,22.5,0,Clear,7.1,2021-07-23 23:00:00,23
202,128,330,70,22.4,0,Clear,5.8,2021-07-24 00:00:00,0
136,133,269,62,23.1,0,Clear,5.2,2021-07-24 01:00:00,1
111,77,188,62,23.1,0,Clear,5.2,2021-07-24 02:00:00,2
68,42,110,77,21.1,0,Clear,6.3,2021-07-24 03:00:00,3
22,13,35,73,21.9,0,Clear,4.3,2021-07-24 04:00:00,4
22,20,42,75,21.6,0,Clear,3.3,2021-07-24 05:00:00,5
39,43,82,78,21.3,1,Mostly Clear,1.5,2021-07-24 06:00:00,6
57,107,164,82,21.2,1,Mostly Clear,2.6,2021-07-24 07:00:00,7
123,213,336,74,23.0,2,Partly Cloudy,3.8,2021-07-24 08:00:00,8
219,306,525,61,25.1,2,Partly Cloudy,4.4,2021-07-24 09:00:00,9
413,347,760,54,26.6,2,Partly Cloudy,7.0,2021-07-24 10:00:00,10
477,418,895,49,28.0,1,Mostly Clear,9.7,2021-07-24 11:00:00,11
533,384,917,45,29.1,1,Mostly Clear,9.7,2021-07-24 12:00:00,12
532,390,922,43,30.0,1,Mostly Clear,9.8,2021-07-24 13:00:00,13
583,380,963,43,30.4,3,Cloudy,9.9,2021-07-24 14:00:00,14
641,353,994,51,28.8,3,Cloudy,10.9,2021-07-24 15:00:00,15
578,350,928,54,28.4,2,Partly Cloudy,10.9,2021-07-24 16:00:00,16
443,334,777,60,27.4,51,Light Drizzle,12.6,2021-07-24 17:00:00,17
339,291,630,65,26.4,3,Cloudy,10.9,2021-07-24 18:00:00,18
187,201,388,67,25.7,2,Partly Cloudy,11.8,2021-07-24 19:00:00,19
197,206,403,69,25.2,2,Partly Cloudy,12.9,2021-07-24 20:00:00,20
178,184,362,68,24.8,2,Partly Cloudy,13.2,2021-07-24 21:00:00,21
152,123,275,69,24.5,2,Partly Cloudy,13.2,2021-07-24 22:00:00,22
188,134,322,69,24.1,2,Partly Cloudy,14.6,2021-07-24 23:00:00,23
142,90,232,69,23.9,1,Mostly Clear,15.5,2021-07-25 00:00:00,0
192,93,285,69,23.8,1,Mostly Clear,15.2,2021-07-25 01:00:00,1
115,46,161,70,23.6,1,Mostly Clear,15.5,2021-07-25 02:00:00,2
56,32,88,75,23.6,1,Mostly Clear,15.6,2021-07-25 03:00:00,3
25,30,55,75,23.4,1,Mostly Clear,14.8,2021-07-25 04:00:00,4
18,22,40,76,23.3,1,Mostly Clear,14.5,2021-07-25 05:00:00,5
23,45,68,78,23.2,1,Mostly Clear,11.0,2021-07-25 06:00:00,6
62,79,141,79,23.4,1,Mostly Clear,10.6,2021-07-25 07:00:00,7
132,132,264,76,24.7,1,Mostly Clear,11.0,2021-07-25 08:00:00,8
202,250,452,71,26.4,2,Partly Cloudy,12.0,2021-07-25 09:00:00,9
272,306,578,65,27.9,1,Mostly Clear,10.2,2021-07-25 10:00:00,10
377,368,745,57,29.8,1,Mostly Clear,9.2,2021-07-25 11:00:00,11
398,366,764,52,31.2,2,Partly Cloudy,9.5,2021-07-25 12:00:00,12
425,339,764,46,32.8,2,Partly Cloudy,9.8,2021-07-25 13:00:00,13
435,340,775,43,33.7,1,Mostly Clear,9.5,2021-07-25 14:00:00,14
431,292,723,50,32.7,1,Mostly Clear,9.7,2021-07-25 15:00:00,15
386,339,725,47,33.3,1,Mostly Clear,10.0,2021-07-25 16:00:00,16
303,361,664,47,33.0,1,Mostly Clear,11.0,2021-07-25 17:00:00,17
318,284,602,49,32.3,2,Partly Cloudy,9.6,2021-07-25 18:00:00,18
291,284,575,52,31.5,1,Mostly Clear,6.1,2021-07-25 19:00:00,19
227,213,440,59,30.2,51,Light Drizzle,6.6,2021-07-25 20:00:00,20
156,136,292,62,29.1,1,Mostly Clear,8.6,2021-07-25 21:00:00,21
139,143,282,63,28.2,1,Mostly Clear,9.0,2021-07-25 22:00:00,22
87,70,157,65,27.6,1,Mostly Clear,9.4,2021-07-25 23:00:00,23
45,20,65,66,27.4,0,Clear,9.2,2021-07-26 00:00:00,0
22,6,28,68,27.1,1,Mostly Clear,9.2,2021-07-26 01:00:00,1
18,11,29,70,26.6,1,Mostly Clear,9.2,2021-07-26 02:00:00,2
12,5,17,82,25.5,1,Mostly Clear,8.3,2021-07-26 03:00:00,3
15,16,31,84,25.0,1,Mostly Clear,7.0,2021-07-26 04:00:00,4
16,51,67,85,24.6,1,Mostly Clear,7.1,2021-07-26 05:00:00,5
39,133,172,87,24.1,1,Mostly Clear,7.5,2021-07-26 06:00:00,6
48,295,343,89,23.9,1,Mostly Clear,7.9,2021-07-26 07:00:00,7
140,456,596,79,25.8,1,Mostly Clear,6.9,2021-07-26 08:00:00,8
119,292,411,71,27.5,1,Mostly Clear,6.8,2021-07-26 09:00:00,9
122,149,271,58,29.5,1,Mostly Clear,5.7,2021-07-26 10:00:00,10
182,171,353,50,30.8,1,Mostly Clear,4.7,2021-07-26 11:00:00,11
190,232,422,46,31.5,1,Mostly Clear,3.3,2021-07-26 12:00:00,12
172,236,408,44,32.1,1,Mostly Clear,3.1,2021-07-26 13:00:00,13
185,213,398,43,32.9,1,Mostly Clear,3.0,2021-07-26 14:00:00,14
205,219,424,43,33.6,0,Clear,2.9,2021-07-26 15:00:00,15
211,316,527,42,33.9,1,Mostly Clear,3.6,2021-07-26 16:00:00,16
307,565,872,46,32.8,1,Mostly Clear,3.7,2021-07-26 17:00:00,17
326,597,923,52,31.2,51,Light Drizzle,8.7,2021-07-26 18:00:00,18
123,269,392,62,29.3,2,Partly Cloudy,5.6,2021-07-26 19:00:00,19
116,212,328,69,28.4,1,Mostly Clear,2.5,2021-07-26 20:00:00,20
106,142,248,73,27.7,1,Mostly Clear,4.5,2021-07-26 21:00:00,21
92,115,207,76,27.1,1,Mostly Clear,6.2,2021-07-26 22:00:00,22
49,50,99,80,26.5,0,Clear,4.3,2021-07-26 23:00:00,23
27,13,40,84,25.8,0,Clear,4.2,2021-07-27 00:00:00,0
10,7,17,88,25.0,0,Clear,4.5,2021-07-27 01:00:00,1
8,13,21,93,24.2,0,Clear,4.3,2021-07-27 02:00:00,2
2,4,6,97,23.1,0,Clear,4.6,2021-07-27 03:00:00,3
13,17,30,98,22.8,0,Clear,4.7,2021-07-27 04:00:00,4
18,56,74,98,22.5,0,Clear,5.7,2021-07-27 05:00:00,5
45,150,195,99,22.0,0,Clear,3.4,2021-07-27 06:00:00,6
77,348,425,97,22.9,0,Clear,4.6,2021-07-27 07:00:00,7
153,521,674,90,24.7,0,Clear,4.0,2021-07-27 08:00:00,8
133,261,394,80,26.8,0,Clear,4.3,2021-07-27 09:00:00,9
125,171,296,67,29.0,0,Clear,4.0,2021-07-27 10:00:00,10
147,206,353,55,30.8,1,Mostly Clear,2.5,2021-07-27 11:00:00,11
167,216,383,47,32.1,1,Mostly Clear,1.6,2021-07-27 12:00:00,12
171,220,391,43,32.9,0,Clear,1.3,2021-07-27 13:00:00,13
185,196,381,40,33.7,1,Mostly Clear,0.0,2021-07-27 14:00:00,14
207,237,444,40,33.3,0,Clear,1.8,2021-07-27 15:00:00,15
212,365,577,37,34.1,0,Clear,2.5,2021-07-27 16:00:00,16
298,594,892,36,34.0,0,Clear,3.4,2021-07-27 17:00:00,17
319,603,922,38,33.7,0,Clear,5.4,2021-07-27 18:00:00,18
303,434,737,44,32.6,0,Clear,3.7,2021-07-27 19:00:00,19
221,382,603,56,30.6,0,Clear,1.4,2021-07-27 20:00:00,20
171,207,378,64,29.0,0,Clear,3.6,2021-07-27 21:00:00,21
127,140,267,71,28.0,0,Clear,2.9,2021-07-27 22:00:00,22
71,82,153,76,27.2,0,Clear,1.6,2021-07-27 23:00:00,23
42,25,67,80,26.5,0,Clear,3.2,2021-07-28 00:00:00,0
8,10,18,82,25.9,0,Clear,4.8,2021-07-28 01:00:00,1
4,11,15,85,25.4,0,Clear,6.2,2021-07-28 02:00:00,2
8,2,10,68,24.0,0,Clear,6.6,2021-07-28 03:00:00,3
10,14,24,66,23.4,0,Clear,8.4,2021-07-28 04:00:00,4
20,51,71,63,23.2,0,Clear,9.8,2021-07-28 05:00:00,5
41,138,179,61,23.4,0,Clear,10.0,2021-07-28 06:00:00,6
90,366,456,64,23.5,0,Clear,10.7,2021-07-28 07:00:00,7
160,527,687,62,25.4,0,Clear,7.9,2021-07-28 08:00:00,8
138,315,453,56,27.6,0,Clear,7.3,2021-07-28 09:00:00,9
125,195,320,50,29.3,0,Clear,8.0,2021-07-28 10:00:00,10
189,212,401,45,30.5,0,Clear,9.0,2021-07-28 11:00:00,11
157,261,418,42,31.6,1,Mostly Clear,9.1,2021-07-28 12:00:00,12
161,222,383,38,32.4,1,Mostly Clear,8.4,2021-07-28 13:00:00,13
196,226,422,37,32.8,1,Mostly Clear,6.6,2021-07-28 14:00:00,14
201,261,462,38,32.4,1,Mostly Clear,4.7,2021-07-28 15:00:00,15
246,400,646,35,33.0,0,Clear,4.3,2021-07-28 16:00:00,16
340,620,960,35,33.0,1,Mostly Clear,3.3,2021-07-28 17:00:00,17
359,598,957,38,31.6,1,Mostly Clear,9.5,2021-07-28 18:00:00,18
332,450,782,44,30.6,1,Mostly Clear,12.1,2021-07-28 19:00:00,19
261,307,568,54,28.9,1,Mostly Clear,6.7,2021-07-28 20:00:00,20
160,273,433,60,27.5,1,Mostly Clear,6.5,2021-07-28 21:00:00,21
40,96,136,66,26.7,1,Mostly Clear,11.5,2021-07-28 22:00:00,22
46,65,111,71,26.0,1,Mostly Clear,10.5,2021-07-28 23:00:00,23
33,39,72,76,25.4,1,Mostly Clear,8.2,2021-07-29 00:00:00,0
36,29,65,81,24.9,1,Mostly Clear,5.9,2021-07-29 01:00:00,1
12,11,23,85,24.5,1,Mostly Clear,4.1,2021-07-29 02:00:00,2
7,7,14,90,23.5,51,Light Drizzle,4.3,2021-07-29 03:00:00,3
16,13,29,90,23.5,51,Light Drizzle,5.1,2021-07-29 04:00:00,4
28,42,70,92,23.5,1,Mostly Clear,7.1,2021-07-29 05:00:00,5
48,146,194,95,23.4,2,Partly Cloudy,1.9,2021-07-29 06:00:00,6
63,296,359,96,23.5,3,Cloudy,1.6,2021-07-29 07:00:00,7
136,488,624,92,24.4,2,Partly Cloudy,5.1,2021-07-29 08:00:00,8
141,289,430,85,25.7,3,Cloudy,4.3,2021-07-29 09:00:00,9
151,200,351,78,27.6,2,Partly Cloudy,5.6,2021-07-29 10:00:00,10
207,222,429,72,29.1,51,Light Drizzle,7.3,2021-07-29 11:00:00,11
189,279,468,65,30.3,3,Cloudy,7.4,2021-07-29 12:00:00,12
211,252,463,53,31.9,2,Partly Cloudy,7.5,2021-07-29 13:00:00,13
208,268,476,46,33.1,2,Partly Cloudy,7.7,2021-07-29 14:00:00,14
261,265,526,47,32.2,3,Cloudy,9.6,2021-07-29 15:00:00,15
272,376,648,44,33.0,3,Cloudy,9.9,2021-07-29 16:00:00,16
237,475,712,41,33.3,3,Cloudy,10.5,2021-07-29 17:00:00,17
346,488,834,39,32.9,3,Cloudy,8.1,2021-07-29 18:00:00,18
290,416,706,42,32.2,1,Mostly Clear,9.4,2021-07-29 19:00:00,19
210,318,528,54,30.8,1,Mostly Clear,8.6,2021-07-29 20:00:00,20
190,245,435,49,29.4,1,Mostly Clear,9.6,2021-07-29 21:00:00,21
154,139,293,50,28.5,1,Mostly Clear,9.4,2021-07-29 22:00:00,22
91,106,197,51,28.0,51,Light Drizzle,9.2,2021-07-29 23:00:00,23
54,38,92,58,27.2,1,Mostly Clear,9.0,2021-07-30 00:00:00,0
39,25,64,61,26.7,1,Mostly Clear,9.1,2021-07-30 01:00:00,1
23,14,37,63,26.3,0,Clear,9.5,2021-07-30 02:00:00,2
13,8,21,81,24.6,1,Mostly Clear,9.2,2021-07-30 03:00:00,3
12,11,23,80,24.6,1,Mostly Clear,11.1,2021-07-30 04:00:00,4
18,38,56,82,24.4,0,Clear,12.5,2021-07-30 05:00:00,5
50,124,174,84,24.1,0,Clear,8.8,2021-07-30 06:00:00,6
82,298,380,85,24.1,0,Clear,8.6,2021-07-30 07:00:00,7
145,422,567,80,25.0,1,Mostly Clear,7.5,2021-07-30 08:00:00,8
181,264,445,74,26.1,1,Mostly Clear,11.5,2021-07-30 09:00:00,9
192,209,401,67,27.4,1,Mostly Clear,13.0,2021-07-30 10:00:00,10
218,254,472,58,28.5,51,Light Drizzle,12.8,2021-07-30 11:00:00,11
231,280,511,48,30.0,1,Mostly Clear,13.8,2021-07-30 12:00:00,12
244,246,490,42,31.1,0,Clear,14.5,2021-07-30 13:00:00,13
302,290,592,39,31.9,1,Mostly Clear,15.0,2021-07-30 14:00:00,14
311,306,617,38,32.3,0,Clear,15.0,2021-07-30 15:00:00,15
317,433,750,35,32.5,1,Mostly Clear,15.0,2021-07-30 16:00:00,16
379,571,950,31,32.3,1,Mostly Clear,14.2,2021-07-30 17:00:00,17
396,548,944,30,31.7,1,Mostly Clear,13.6,2021-07-30 18:00:00,18
326,375,701,31,30.8,0,Clear,12.2,2021-07-30 19:00:00,19
226,312,538,36,29.2,0,Clear,9.1,2021-07-30 20:00:00,20
212,246,458,37,27.5,0,Clear,8.6,2021-07-30 21:00:00,21
210,211,421,39,26.4,0,Clear,8.1,2021-07-30 22:00:00,22
212,164,376,41,25.3,1,Mostly Clear,10.2,2021-07-30 23:00:00,23
160,133,293,44,24.2,1,Mostly Clear,11.2,2021-07-31 00:00:00,0
127,93,220,48,23.3,1,Mostly Clear,12.1,2021-07-31 01:00:00,1
144,70,214,53,22.5,1,Mostly Clear,11.2,2021-07-31 02:00:00,2
73,33,106,58,22.1,1,Mostly Clear,9.3,2021-07-31 03:00:00,3
19,22,41,60,21.6,1,Mostly Clear,8.1,2021-07-31 04:00:00,4
23,15,38,62,21.0,0,Clear,7.4,2021-07-31 05:00:00,5
33,47,80,66,20.3,2,Partly Cloudy,7.1,2021-07-31 06:00:00,6
52,88,140,68,20.6,3,Cloudy,7.9,2021-07-31 07:00:00,7
138,213,351,62,21.2,3,Cloudy,8.9,2021-07-31 08:00:00,8
234,290,524,57,22.0,3,Cloudy,8.1,2021-07-31 09:00:00,9
353,357,710,52,23.4,3,Cloudy,6.2,2021-07-31 10:00:00,10
413,369,782,49,24.4,3,Cloudy,5.0,2021-07-31 11:00:00,11
482,407,889,46,25.8,1,Mostly Clear,4.3,2021-07-31 12:00:00,12
534,364,898,43,27.4,3,Cloudy,3.5,2021-07-31 13:00:00,13
539,362,901,39,28.7,3,Cloudy,4.6,2021-07-31 14:00:00,14
640,385,1025,41,28.0,3,Cloudy,6.9,2021-07-31 15:00:00,15
551,378,929,39,28.6,2,Partly Cloudy,8.3,2021-07-31 16:00:00,16
538,416,954,37,28.8,2,Partly Cloudy,8.1,2021-07-31 17:00:00,17
425,343,768,39,28.7,1,Mostly Clear,4.7,2021-07-31 18:00:00,18
359,339,698,45,27.4,1,Mostly Clear,5.8,2021-07-31 19:00:00,19
305,208,513,55,25.9,1,Mostly Clear,5.4,2021-07-31 20:00:00,20
251,181,432,62,24.7,1,Mostly Clear,9.2,2021-07-31 21:00:00,21
286,193,479,66,24.0,1,Mostly Clear,10.3,2021-07-31 22:00:00,22
223,144,367,69,23.6,2,Partly Cloudy,9.5,2021-07-31 23:00:00,23
146,104,250,71,23.6,2,Partly Cloudy,9.7,2021-08-01 00:00:00,0
115,83,198,75,23.2,51,Light Drizzle,10.5,2021-08-01 01:00:00,1
77,44,121,80,22.9,2,Partly Cloudy,10.1,2021-08-01 02:00:00,2
61,21,82,82,22.3,51,Light Drizzle,10.2,2021-08-01 03:00:00,3
23,14,37,87,21.7,51,Light Drizzle,9.5,2021-08-01 04:00:00,4
9,12,21,92,21.2,51,Light Drizzle,8.0,2021-08-01 05:00:00,5
8,15,23,94,21.1,51,Light Drizzle,3.6,2021-08-01 06:00:00,6
16,46,62,94,21.3,61,Light Rain,4.6,2021-08-01 07:00:00,7
52,94,146,94,21.7,53,Heavy Drizzle,4.7,2021-08-01 08:00:00,8
168,176,344,92,22.2,51,Light Drizzle,5.9,2021-08-01 09:00:00,9
234,248,482,85,23.7,51,Light Drizzle,6.4,2021-08-01 10:00:00,10
203,221,424,80,24.5,51,Light Drizzle,9.6,2021-08-01 11:00:00,11
269,242,511,75,25.7,51,Light Drizzle,9.2,2021-08-01 12:00:00,12
89,90,179,70,26.2,51,Light Drizzle,6.4,2021-08-01 13:00:00,13
130,161,291,69,26.5,3,Cloudy,6.0,2021-08-01 14:00:00,14
272,282,554,85,24.1,61,Light Rain,6.6,2021-08-01 15:00:00,15
333,326,659,74,25.6,2,Partly Cloudy,5.5,2021-08-01 16:00:00,16
328,326,654,68,26.2,1,Mostly Clear,4.3,2021-08-01 17:00:00,17
299,300,599,65,26.2,0,Clear,2.7,2021-08-01 18:00:00,18
277,305,582,68,25.6,0,Clear,3.3,2021-08-01 19:00:00,19
235,225,460,73,24.9,0,Clear,6.6,2021-08-01 20:00:00,20
112,132,244,80,23.9,1,Mostly Clear,2.5,2021-08-01 21:00:00,21
59,62,121,83,23.0,51,Light Drizzle,7.9,2021-08-01 22:00:00,22
78,55,133,83,22.6,1,Mostly Clear,6.5,2021-08-01 23:00:00,23
24,35,59,80,22.3,1,Mostly Clear,5.2,2021-08-02 00:00:00,0
23,9,32,77,21.8,1,Mostly Clear,6.9,2021-08-02 01:00:00,1
22,4,26,74,21.3,0,Clear,7.7,2021-08-02 02:00:00,2
9,10,19,89,19.8,0,Clear,9.2,2021-08-02 03:00:00,3
11,12,23,87,19.1,0,Clear,10.0,2021-08-02 04:00:00,4
22,43,65,87,18.6,0,Clear,11.0,2021-08-02 05:00:00,5
48,160,208,88,18.1,0,Clear,7.7,2021-08-02 06:00:00,6
80,275,355,89,18.0,0,Clear,8.9,2021-08-02 07:00:00,7
107,410,517,84,19.2,0,Clear,7.9,2021-08-02 08:00:00,8
156,294,450,75,20.6,1,Mostly Clear,13.4,2021-08-02 09:00:00,9
164,181,345,66,22.1,1,Mostly Clear,12.8,2021-08-02 10:00:00,10
218,226,444,56,23.8,1,Mostly Clear,11.8,2021-08-02 11:00:00,11
258,248,506,49,25.1,1,Mostly Clear,11.5,2021-08-02 12:00:00,12
297,242,539,44,26.1,2,Partly Cloudy,11.6,2021-08-02 13:00:00,13
287,222,509,39,27.2,2,Partly Cloudy,10.5,2021-08-02 14:00:00,14
296,259,555,41,27.0,2,Partly Cloudy,8.8,2021-08-02 15:00:00,15
341,358,699,41,26.9,1,Mostly Clear,8.4,2021-08-02 16:00:00,16
416,602,1018,42,26.7,2,Partly Cloudy,7.6,2021-08-02 17:00:00,17
367,668,1035,44,26.5,1,Mostly Clear,6.9,2021-08-02 18:00:00,18
321,447,768,48,25.7,1,Mostly Clear,5.6,2021-08-02 19:00:00,19
215,327,542,56,24.4,0,Clear,4.8,2021-08-02 20:00:00,20
179,183,362,62,23.1,0,Clear,5.2,2021-08-02 21:00:00,21
127,157,284,68,22.2,1,Mostly Clear,5.7,2021-08-02 22:00:00,22
67,83,150,74,21.2,1,Mostly Clear,5.4,2021-08-02 23:00:00,23
31,25,56,81,20.4,0,Clear,5.4,2021-08-03 00:00:00,0
25,10,35,84,19.9,1,Mostly Clear,7.9,2021-08-03 01:00:00,1
14,6,20,83,20.1,1,Mostly Clear,6.1,2021-08-03 02:00:00,2
8,3,11,86,19.9,1,Mostly Clear,5.4,2021-08-03 03:00:00,3
13,9,22,82,21.0,1,Mostly Clear,4.3,2021-08-03 04:00:00,4
23,59,82,83,21.2,1,Mostly Clear,4.1,2021-08-03 05:00:00,5
48,150,198,88,20.2,1,Mostly Clear,1.1,2021-08-03 06:00:00,6
86,361,447,93,19.0,1,Mostly Clear,4.2,2021-08-03 07:00:00,7
165,472,637,84,20.9,1,Mostly Clear,5.5,2021-08-03 08:00:00,8
167,284,451,71,22.9,1,Mostly Clear,5.6,2021-08-03 09:00:00,9
170,176,346,60,24.3,1,Mostly Clear,5.8,2021-08-03 10:00:00,10
173,213,386,51,25.6,1,Mostly Clear,5.6,2021-08-03 11:00:00,11
230,300,530,45,26.5,2,Partly Cloudy,6.6,2021-08-03 12:00:00,12
238,286,524,44,26.8,1,Mostly Clear,8.0,2021-08-03 13:00:00,13
252,289,541,43,26.9,2,Partly Cloudy,9.4,2021-08-03 14:00:00,14
296,263,559,48,26.3,2,Partly Cloudy,9.7,2021-08-03 15:00:00,15
311,385,696,48,26.3,2,Partly Cloudy,9.4,2021-08-03 16:00:00,16
417,664,1081,49,25.9,2,Partly Cloudy,10.0,2021-08-03 17:00:00,17
402,670,1072,52,25.5,2,Partly Cloudy,8.8,2021-08-03 18:00:00,18
299,450,749,56,24.9,2,Partly Cloudy,9.5,2021-08-03 19:00:00,19
255,351,606,62,24.0,1,Mostly Clear,8.0,2021-08-03 20:00:00,20
178,248,426,68,22.9,1,Mostly Clear,4.8,2021-08-03 21:00:00,21
121,109,230,74,21.9,0,Clear,4.8,2021-08-03 22:00:00,22
63,81,144,79,21.0,1,Mostly Clear,5.5,2021-08-03 23:00:00,23
44,30,74,85,20.0,0,Clear,5.5,2021-08-04 00:00:00,0
18,16,34,86,19.7,0,Clear,4.1,2021-08-04 01:00:00,1
15,16,31,88,19.3,1,Mostly Clear,3.9,2021-08-04 02:00:00,2
10,5,15,95,18.8,1,Mostly Clear,5.9,2021-08-04 03:00:00,3
9,15,24,94,18.9,1,Mostly Clear,7.0,2021-08-04 04:00:00,4
27,57,84,93,19.1,1,Mostly Clear,7.8,2021-08-04 05:00:00,5
44,130,174,93,19.1,1,Mostly Clear,7.0,2021-08-04 06:00:00,6
87,319,406,92,19.4,1,Mostly Clear,8.1,2021-08-04 07:00:00,7
154,452,606,89,20.4,1,Mostly Clear,8.1,2021-08-04 08:00:00,8
138,300,438,83,21.6,1,Mostly Clear,8.7,2021-08-04 09:00:00,9
155,208,363,75,22.7,1,Mostly Clear,10.4,2021-08-04 10:00:00,10
237,253,490,63,24.0,1,Mostly Clear,11.7,2021-08-04 11:00:00,11
241,254,495,56,24.6,1,Mostly Clear,13.7,2021-08-04 12:00:00,12
247,272,519,52,25.1,1,Mostly Clear,14.5,2021-08-04 13:00:00,13
294,255,549,48,25.8,0,Clear,15.0,2021-08-04 14:00:00,14
295,287,582,47,26.7,0,Clear,14.2,2021-08-04 15:00:00,15
289,382,671,45,26.9,1,Mostly Clear,13.5,2021-08-04 16:00:00,16
404,647,1051,45,26.7,3,Cloudy,12.8,2021-08-04 17:00:00,17
423,593,1016,47,26.2,3,Cloudy,10.3,2021-08-04 18:00:00,18
341,449,790,52,25.3,0,Clear,8.6,2021-08-04 19:00:00,19
254,384,638,60,24.1,0,Clear,6.8,2021-08-04 20:00:00,20
176,206,382,66,22.8,0,Clear,5.2,2021-08-04 21:00:00,21
169,183,352,73,21.7,0,Clear,5.1,2021-08-04 22:00:00,22
112,102,214,81,20.5,0,Clear,4.9,2021-08-04 23:00:00,23
36,32,68,75,21.4,0,Clear,4.4,2021-08-05 00:00:00,0
19,23,42,76,21.3,0,Clear,4.3,2021-08-05 01:00:00,1
11,14,25,90,18.5,0,Clear,4.4,2021-08-05 02:00:00,2
7,4,11,91,18.2,0,Clear,3.8,2021-08-05 03:00:00,3
10,11,21,94,17.6,0,Clear,4.0,2021-08-05 04:00:00,4
24,47,71,95,17.2,0,Clear,4.4,2021-08-05 05:00:00,5
50,159,209,95,17.3,0,Clear,3.2,2021-08-05 06:00:00,6
80,308,388,92,18.5,2,Partly Cloudy,2.3,2021-08-05 07:00:00,7
161,437,598,83,20.6,0,Clear,1.8,2021-08-05 08:00:00,8
160,272,432,68,23.1,0,Clear,3.6,2021-08-05 09:00:00,9
154,192,346,58,24.9,0,Clear,4.5,2021-08-05 10:00:00,10
243,254,497,50,26.4,0,Clear,3.8,2021-08-05 11:00:00,11
249,267,516,45,27.7,2,Partly Cloudy,6.5,2021-08-05 12:00:00,12
244,299,543,39,29.1,1,Mostly Clear,6.5,2021-08-05 13:00:00,13
262,264,526,36,30.1,1,Mostly Clear,6.6,2021-08-05 14:00:00,14
261,289,550,37,30.5,0,Clear,5.8,2021-08-05 15:00:00,15
317,353,670,37,30.6,0,Clear,4.0,2021-08-05 16:00:00,16
435,640,1075,38,30.4,1,Mostly Clear,2.3,2021-08-05 17:00:00,17
408,640,1048,39,29.9,1,Mostly Clear,3.8,2021-08-05 18:00:00,18
390,449,839,43,28.9,1,Mostly Clear,5.7,2021-08-05 19:00:00,19
299,363,662,51,27.2,1,Mostly Clear,4.6,2021-08-05 20:00:00,20
201,280,481,59,25.5,1,Mostly Clear,4.8,2021-08-05 21:00:00,21
170,179,349,64,24.5,0,Clear,5.4,2021-08-05 22:00:00,22
103,94,197,68,23.7,0,Clear,7.0,2021-08-05 23:00:00,23
45,37,82,73,23.0,0,Clear,8.6,2021-08-06 00:00:00,0
38,26,64,76,22.4,0,Clear,9.0,2021-08-06 01:00:00,1
24,12,36,78,21.9,0,Clear,9.5,2021-08-06 02:00:00,2
8,7,15,83,21.5,0,Clear,8.6,2021-08-06 03:00:00,3
12,10,22,84,21.0,0,Clear,7.8,2021-08-06 04:00:00,4
19,34,53,86,20.5,0,Clear,7.3,2021-08-06 05:00:00,5
58,136,194,88,20.1,0,Clear,5.3,2021-08-06 06:00:00,6
93,285,378,88,20.2,0,Clear,7.6,2021-08-06 07:00:00,7
131,388,519,77,22.3,0,Clear,6.6,2021-08-06 08:00:00,8
156,277,433,67,24.5,0,Clear,6.8,2021-08-06 09:00:00,9
184,204,388,57,27.0,0,Clear,7.2,2021-08-06 10:00:00,10
264,220,484,48,29.3,0,Clear,9.2,2021-08-06 11:00:00,11
265,273,538,42,30.8,1,Mostly Clear,8.8,2021-08-06 12:00:00,12
273,283,556,38,31.8,1,Mostly Clear,8.6,2021-08-06 13:00:00,13
304,301,605,37,32.1,2,Partly Cloudy,9.8,2021-08-06 14:00:00,14
303,322,625,41,31.7,2,Partly Cloudy,10.6,2021-08-06 15:00:00,15
344,393,737,42,31.3,2,Partly Cloudy,11.3,2021-08-06 16:00:00,16
452,579,1031,45,30.6,1,Mostly Clear,12.0,2021-08-06 17:00:00,17
421,486,907,48,30.0,2,Partly Cloudy,11.4,2021-08-06 18:00:00,18
346,392,738,52,28.8,2,Partly Cloudy,12.6,2021-08-06 19:00:00,19
287,292,579,57,27.4,1,Mostly Clear,13.8,2021-08-06 20:00:00,20
218,211,429,59,26.3,1,Mostly Clear,13.6,2021-08-06 21:00:00,21
192,149,341,62,25.3,1,Mostly Clear,13.0,2021-08-06 22:00:00,22
150,144,294,63,24.5,1,Mostly Clear,11.2,2021-08-06 23:00:00,23
95,91,186,65,23.8,1,Mostly Clear,8.6,2021-08-07 00:00:00,0
114,81,195,68,23.0,1,Mostly Clear,6.2,2021-08-07 01:00:00,1
73,53,126,73,22.2,1,Mostly Clear,6.5,2021-08-07 02:00:00,2
46,18,64,81,21.1,1,Mostly Clear,6.6,2021-08-07 03:00:00,3
19,16,35,86,20.5,1,Mostly Clear,7.2,2021-08-07 04:00:00,4
16,22,38,91,19.9,1,Mostly Clear,7.3,2021-08-07 05:00:00,5
33,46,79,92,19.4,1,Mostly Clear,4.1,2021-08-07 06:00:00,6
54,92,146,93,19.7,1,Mostly Clear,3.4,2021-08-07 07:00:00,7
135,200,335,84,22.0,1,Mostly Clear,3.9,2021-08-07 08:00:00,8
241,312,553,77,23.5,1,Mostly Clear,2.6,2021-08-07 09:00:00,9
391,336,727,69,25.3,1,Mostly Clear,4.1,2021-08-07 10:00:00,10
310,275,585,62,26.9,1,Mostly Clear,8.3,2021-08-07 11:00:00,11
160,151,311,56,27.8,2,Partly Cloudy,6.2,2021-08-07 12:00:00,12
99,96,195,56,27.3,2,Partly Cloudy,6.4,2021-08-07 13:00:00,13
130,142,272,62,26.0,2,Partly Cloudy,6.5,2021-08-07 14:00:00,14
236,219,455,78,23.1,53,Heavy Drizzle,7.2,2021-08-07 15:00:00,15
282,248,530,82,22.7,51,Light Drizzle,8.2,2021-08-07 16:00:00,16
385,321,706,80,22.5,51,Light Drizzle,9.0,2021-08-07 17:00:00,17
390,308,698,80,22.3,3,Cloudy,4.0,2021-08-07 18:00:00,18
330,272,602,81,22.0,3,Cloudy,0.4,2021-08-07 19:00:00,19
212,204,416,83,21.7,3,Cloudy,2.0,2021-08-07 20:00:00,20
174,138,312,84,21.3,2,Partly Cloudy,5.1,2021-08-07 21:00:00,21
167,132,299,85,20.9,1,Mostly Clear,7.1,2021-08-07 22:00:00,22
155,112,267,86,20.5,1,Mostly Clear,4.6,2021-08-07 23:00:00,23
148,92,240,88,20.1,0,Clear,5.1,2021-08-08 00:00:00,0
103,62,165,89,19.7,0,Clear,6.7,2021-08-08 01:00:00,1
64,46,110,89,19.6,0,Clear,5.4,2021-08-08 02:00:00,2
61,32,93,95,19.8,0,Clear,4.7,2021-08-08 03:00:00,3
20,16,36,96,19.4,0,Clear,4.7,2021-08-08 04:00:00,4
10,16,26,96,19.3,0,Clear,4.7,2021-08-08 05:00:00,5
36,31,67,96,19.0,0,Clear,5.9,2021-08-08 06:00:00,6
60,81,141,97,19.3,1,Mostly Clear,5.2,2021-08-08 07:00:00,7
132,147,279,91,21.0,0,Clear,4.8,2021-08-08 08:00:00,8
265,224,489,81,22.8,0,Clear,3.6,2021-08-08 09:00:00,9
361,303,664,76,24.1,0,Clear,2.9,2021-08-08 10:00:00,10
516,376,892,68,25.8,0,Clear,3.5,2021-08-08 11:00:00,11
507,358,865,60,27.4,0,Clear,3.7,2021-08-08 12:00:00,12
522,377,899,54,28.9,0,Clear,4.7,2021-08-08 13:00:00,13
481,343,824,50,30.0,0,Clear,5.2,2021-08-08 14:00:00,14
458,333,791,40,31.6,0,Clear,4.6,2021-08-08 15:00:00,15
448,334,782,40,31.8,0,Clear,4.4,2021-08-08 16:00:00,16
456,360,816,41,31.8,0,Clear,4.8,2021-08-08 17:00:00,17
409,312,721,45,30.8,0,Clear,8.5,2021-08-08 18:00:00,18
371,306,677,55,29.3,0,Clear,10.4,2021-08-08 19:00:00,19
290,221,511,65,27.3,0,Clear,11.4,2021-08-08 20:00:00,20
176,157,333,71,25.8,0,Clear,11.3,2021-08-08 21:00:00,21
212,143,355,74,25.0,0,Clear,9.5,2021-08-08 22:00:00,22
156,65,221,75,24.4,1,Mostly Clear,8.6,2021-08-08 23:00:00,23
62,26,88,77,23.9,1,Mostly Clear,8.6,2021-08-09 00:00:00,0
26,20,46,80,23.5,1,Mostly Clear,7.9,2021-08-09 01:00:00,1
9,7,16,83,22.8,1,Mostly Clear,6.8,2021-08-09 02:00:00,2
4,6,10,86,22.9,1,Mostly Clear,6.1,2021-08-09 03:00:00,3
14,11,25,88,22.6,1,Mostly Clear,4.9,2021-08-09 04:00:00,4
22,41,63,91,22.1,53,Heavy Drizzle,3.9,2021-08-09 05:00:00,5
51,116,167,89,22.4,55,Heavy Drizzle,2.3,2021-08-09 06:00:00,6
80,269,349,95,21.6,53,Heavy Drizzle,6.4,2021-08-09 07:00:00,7
142,417,559,94,22.7,2,Partly Cloudy,5.6,2021-08-09 08:00:00,8
133,271,404,89,24.0,3,Cloudy,5.5,2021-08-09 09:00:00,9
150,184,334,80,25.9,3,Cloudy,2.5,2021-08-09 10:00:00,10
165,193,358,69,28.1,2,Partly Cloudy,4.0,2021-08-09 11:00:00,11
258,178,436,62,29.6,2,Partly Cloudy,6.8,2021-08-09 12:00:00,12
219,209,428,56,31.1,1,Mostly Clear,7.6,2021-08-09 13:00:00,13
230,190,420,54,32.0,1,Mostly Clear,9.4,2021-08-09 14:00:00,14
255,270,525,60,31.8,0,Clear,11.3,2021-08-09 15:00:00,15
234,330,564,62,30.9,61,Light Rain,13.5,2021-08-09 16:00:00,16
293,525,818,76,28.3,63,Rain,10.6,2021-08-09 17:00:00,17
232,509,741,77,28.2,51,Light Drizzle,8.2,2021-08-09 18:00:00,18
183,300,483,81,27.3,53,Heavy Drizzle,9.7,2021-08-09 19:00:00,19
148,226,374,84,26.6,2,Partly Cloudy,7.0,2021-08-09 20:00:00,20
119,150,269,84,25.9,1,Mostly Clear,6.0,2021-08-09 21:00:00,21
105,88,193,85,25.4,1,Mostly Clear,9.0,2021-08-09 22:00:00,22
67,83,150,85,25.0,0,Clear,10.2,2021-08-09 23:00:00,23
24,24,48,86,24.8,1,Mostly Clear,10.1,2021-08-10 00:00:00,0
13,7,20,87,24.6,1,Mostly Clear,10.1,2021-08-10 01:00:00,1
14,10,24,88,24.5,0,Clear,10.8,2021-08-10 02:00:00,2
7,6,13,94,24.0,0,Clear,11.6,2021-08-10 03:00:00,3
13,8,21,94,23.9,0,Clear,11.0,2021-08-10 04:00:00,4
17,52,69,94,23.7,0,Clear,10.4,2021-08-10 05:00:00,5
42,150,192,94,23.4,1,Mostly Clear,8.0,2021-08-10 06:00:00,6
78,331,409,94,23.4,1,Mostly Clear,7.2,2021-08-10 07:00:00,7
162,469,631,90,24.5,1,Mostly Clear,7.9,2021-08-10 08:00:00,8
136,281,417,84,25.9,2,Partly Cloudy,9.9,2021-08-10 09:00:00,9
150,201,351,75,27.9,2,Partly Cloudy,7.1,2021-08-10 10:00:00,10
178,248,426,67,29.9,0,Clear,5.8,2021-08-10 11:00:00,11
207,261,468,58,31.8,0,Clear,6.1,2021-08-10 12:00:00,12
192,232,424,52,33.0,0,Clear,7.2,2021-08-10 13:00:00,13
198,211,409,48,34.0,0,Clear,9.8,2021-08-10 14:00:00,14
194,245,439,52,33.9,0,Clear,11.7,2021-08-10 15:00:00,15
217,354,571,50,34.3,0,Clear,12.4,2021-08-10 16:00:00,16
228,466,694,50,33.7,1,Mostly Clear,12.9,2021-08-10 17:00:00,17
36,121,157,58,31.2,53,Heavy Drizzle,10.6,2021-08-10 18:00:00,18
99,214,313,64,29.9,3,Cloudy,4.3,2021-08-10 19:00:00,19
113,209,322,69,28.8,1,Mostly Clear,8.0,2021-08-10 20:00:00,20
92,124,216,73,28.0,1,Mostly Clear,8.9,2021-08-10 21:00:00,21
83,113,196,78,27.4,1,Mostly Clear,6.7,2021-08-10 22:00:00,22
60,56,116,81,27.0,0,Clear,6.8,2021-08-10 23:00:00,23
37,31,68,84,26.6,0,Clear,6.7,2021-08-11 00:00:00,0
12,28,40,86,26.4,1,Mostly Clear,6.8,2021-08-11 01:00:00,1
10,4,14,86,26.0,1,Mostly Clear,8.3,2021-08-11 02:00:00,2
11,8,19,92,24.2,1,Mostly Clear,8.6,2021-08-11 03:00:00,3
14,16,30,94,24.1,0,Clear,7.1,2021-08-11 04:00:00,4
25,50,75,95,23.9,0,Clear,6.7,2021-08-11 05:00:00,5
50,151,201,96,23.7,0,Clear,5.0,2021-08-11 06:00:00,6
86,343,429,96,23.8,0,Clear,6.6,2021-08-11 07:00:00,7
129,442,571,90,25.2,1,Mostly Clear,5.1,2021-08-11 08:00:00,8
139,307,446,83,26.9,1,Mostly Clear,5.7,2021-08-11 09:00:00,9
177,184,361,76,28.9,1,Mostly Clear,3.9,2021-08-11 10:00:00,10
165,210,375,67,31.0,0,Clear,4.8,2021-08-11 11:00:00,11
153,261,414,59,32.8,0,Clear,5.7,2021-08-11 12:00:00,12
178,233,411,55,34.1,0,Clear,5.8,2021-08-11 13:00:00,13
125,228,353,50,34.8,51,Light Drizzle,7.0,2021-08-11 14:00:00,14
198,241,439,49,35.2,0,Clear,8.6,2021-08-11 15:00:00,15
193,383,576,51,34.6,1,Mostly Clear,7.5,2021-08-11 16:00:00,16
152,354,506,50,34.5,1,Mostly Clear,5.6,2021-08-11 17:00:00,17
167,343,510,61,31.8,61,Light Rain,8.2,2021-08-11 18:00:00,18
173,286,459,65,31.1,2,Partly Cloudy,5.4,2021-08-11 19:00:00,19
160,216,376,70,30.0,3,Cloudy,3.5,2021-08-11 20:00:00,20
113,184,297,73,29.1,1,Mostly Clear,4.8,2021-08-11 21:00:00,21
110,117,227,75,28.4,1,Mostly Clear,4.4,2021-08-11 22:00:00,22
70,67,137,78,27.6,2,Partly Cloudy,4.6,2021-08-11 23:00:00,23
35,51,86,80,26.9,1,Mostly Clear,4.7,2021-08-12 00:00:00,0
13,22,35,82,26.4,0,Clear,7.9,2021-08-12 01:00:00,1
11,7,18,83,25.9,0,Clear,7.1,2021-08-12 02:00:00,2
7,4,11,87,24.5,0,Clear,5.7,2021-08-12 03:00:00,3
17,13,30,89,24.3,0,Clear,5.6,2021-08-12 04:00:00,4
26,54,80,90,24.2,0,Clear,6.0,2021-08-12 05:00:00,5
70,142,212,92,23.9,0,Clear,3.0,2021-08-12 06:00:00,6
85,320,405,93,23.9,0,Clear,4.3,2021-08-12 07:00:00,7
144,441,585,87,25.7,1,Mostly Clear,4.1,2021-08-12 08:00:00,8
160,262,422,79,27.6,0,Clear,4.1,2021-08-12 09:00:00,9
138,186,324,70,29.9,1,Mostly Clear,6.6,2021-08-12 10:00:00,10
160,194,354,59,32.2,0,Clear,6.2,2021-08-12 11:00:00,11
192,236,428,50,34.2,0,Clear,6.1,2021-08-12 12:00:00,12
195,221,416,44,35.5,0,Clear,5.6,2021-08-12 13:00:00,13
158,206,364,40,36.4,0,Clear,6.8,2021-08-12 14:00:00,14
200,206,406,45,35.7,0,Clear,8.6,2021-08-12 15:00:00,15
225,308,533,44,36.0,0,Clear,10.2,2021-08-12 16:00:00,16
294,497,791,43,36.0,0,Clear,12.0,2021-08-12 17:00:00,17
331,478,809,44,35.5,0,Clear,11.5,2021-08-12 18:00:00,18
323,371,694,49,34.1,0,Clear,12.2,2021-08-12 19:00:00,19
257,291,548,57,32.2,0,Clear,11.6,2021-08-12 20:00:00,20
203,197,400,61,31.2,1,Mostly Clear,10.6,2021-08-12 21:00:00,21
134,164,298,63,30.5,1,Mostly Clear,9.9,2021-08-12 22:00:00,22
103,88,191,64,29.9,1,Mostly Clear,10.6,2021-08-12 23:00:00,23
53,52,105,64,29.2,1,Mostly Clear,9.6,2021-08-13 00:00:00,0
26,24,50,64,28.6,1,Mostly Clear,8.5,2021-08-13 01:00:00,1
32,21,53,66,27.9,1,Mostly Clear,9.2,2021-08-13 02:00:00,2
7,9,16,80,27.4,1,Mostly Clear,8.6,2021-08-13 03:00:00,3
15,15,30,83,26.8,1,Mostly Clear,7.1,2021-08-13 04:00:00,4
17,43,60,88,25.9,1,Mostly Clear,5.5,2021-08-13 05:00:00,5
49,124,173,91,25.3,1,Mostly Clear,5.1,2021-08-13 06:00:00,6
77,255,332,92,25.2,0,Clear,3.1,2021-08-13 07:00:00,7
141,377,518,80,27.6,0,Clear,3.1,2021-08-13 08:00:00,8
150,231,381,68,29.8,0,Clear,3.1,2021-08-13 09:00:00,9
184,187,371,61,31.7,1,Mostly Clear,3.3,2021-08-13 10:00:00,10
218,249,467,55,33.2,2,Partly Cloudy,2.5,2021-08-13 11:00:00,11
272,267,539,52,34.0,2,Partly Cloudy,1.1,2021-08-13 12:00:00,12
211,265,476,49,34.9,1,Mostly Clear,3.6,2021-08-13 13:00:00,13
239,208,447,48,35.5,0,Clear,4.7,2021-08-13 14:00:00,14
241,280,521,46,35.7,0,Clear,7.7,2021-08-13 15:00:00,15
272,329,601,46,35.7,1,Mostly Clear,10.7,2021-08-13 16:00:00,16
245,427,672,57,32.6,61,Light Rain,6.1,2021-08-13 17:00:00,17
104,202,306,78,28.9,63,Rain,8.4,2021-08-13 18:00:00,18
72,128,200,83,27.6,53,Heavy Drizzle,6.5,2021-08-13 19:00:00,19
48,82,130,83,27.4,2,Partly Cloudy,8.3,2021-08-13 20:00:00,20
71,115,186,84,27.0,2,Partly Cloudy,7.4,2021-08-13 21:00:00,21
104,111,215,85,26.6,1,Mostly Clear,6.4,2021-08-13 22:00:00,22
115,96,211,86,26.3,1,Mostly Clear,7.0,2021-08-13 23:00:00,23
104,69,173,87,26.0,1,Mostly Clear,7.5,2021-08-14 00:00:00,0
99,82,181,88,25.8,2,Partly Cloudy,7.0,2021-08-14 01:00:00,1
69,53,122,90,25.5,2,Partly Cloudy,8.1,2021-08-14 02:00:00,2
31,10,41,94,23.8,1,Mostly Clear,10.2,2021-08-14 03:00:00,3
23,15,38,94,23.8,1,Mostly Clear,8.1,2021-08-14 04:00:00,4
17,20,37,94,23.6,0,Clear,6.6,2021-08-14 05:00:00,5
38,48,86,95,23.4,1,Mostly Clear,4.1,2021-08-14 06:00:00,6
63,108,171,96,23.4,1,Mostly Clear,1.5,2021-08-14 07:00:00,7
144,229,373,93,24.5,1,Mostly Clear,1.3,2021-08-14 08:00:00,8
246,319,565,87,26.1,1,Mostly Clear,1.9,2021-08-14 09:00:00,9
327,349,676,76,28.3,2,Partly Cloudy,3.3,2021-08-14 10:00:00,10
387,358,745,63,30.2,1,Mostly Clear,6.8,2021-08-14 11:00:00,11
412,376,788,56,31.6,1,Mostly Clear,6.4,2021-08-14 12:00:00,12
428,354,782,53,32.5,1,Mostly Clear,7.5,2021-08-14 13:00:00,13
395,316,711,50,33.6,53,Heavy Drizzle,9.7,2021-08-14 14:00:00,14
410,310,720,53,32.4,1,Mostly Clear,7.9,2021-08-14 15:00:00,15
401,246,647,66,29.9,63,Rain,6.6,2021-08-14 16:00:00,16
382,325,707,75,28.5,53,Heavy Drizzle,5.5,2021-08-14 17:00:00,17
332,292,624,75,28.5,1,Mostly Clear,3.6,2021-08-14 18:00:00,18
285,282,567,78,28.2,2,Partly Cloudy,1.8,2021-08-14 19:00:00,19
240,216,456,81,27.8,1,Mostly Clear,4.0,2021-08-14 20:00:00,20
207,203,410,85,26.6,61,Light Rain,2.3,2021-08-14 21:00:00,21
160,135,295,94,24.8,63,Rain,3.9,2021-08-14 22:00:00,22
119,104,223,96,24.2,63,Rain,3.1,2021-08-14 23:00:00,23
33,49,82,95,24.0,2,Partly Cloudy,3.7,2021-08-15 00:00:00,0
25,34,59,94,24.0,3,Cloudy,4.8,2021-08-15 01:00:00,1
55,28,83,94,23.7,53,Heavy Drizzle,5.7,2021-08-15 02:00:00,2
12,14,26,96,24.0,1,Mostly Clear,7.5,2021-08-15 03:00:00,3
11,11,22,94,23.6,53,Heavy Drizzle,8.0,2021-08-15 04:00:00,4
10,16,26,92,23.2,61,Light Rain,8.7,2021-08-15 05:00:00,5
23,35,58,91,22.5,63,Rain,9.9,2021-08-15 06:00:00,6
51,67,118,91,21.7,61,Light Rain,9.2,2021-08-15 07:00:00,7
106,146,252,92,21.1,53,Heavy Drizzle,11.2,2021-08-15 08:00:00,8
186,237,423,92,21.0,53,Heavy Drizzle,11.0,2021-08-15 09:00:00,9
333,289,622,87,21.7,51,Light Drizzle,11.8,2021-08-15 10:00:00,10
394,327,721,78,23.2,51,Light Drizzle,12.2,2021-08-15 11:00:00,11
460,341,801,72,24.3,51,Light Drizzle,11.3,2021-08-15 12:00:00,12
427,348,775,68,25.0,2,Partly Cloudy,10.0,2021-08-15 13:00:00,13
447,395,842,65,25.8,2,Partly Cloudy,8.5,2021-08-15 14:00:00,14
466,371,837,59,27.2,1,Mostly Clear,7.5,2021-08-15 15:00:00,15
429,358,787,58,27.3,1,Mostly Clear,6.6,2021-08-15 16:00:00,16
331,316,647,57,27.3,1,Mostly Clear,7.0,2021-08-15 17:00:00,17
317,312,629,59,26.7,3,Cloudy,4.9,2021-08-15 18:00:00,18
346,253,599,61,26.2,2,Partly Cloudy,4.7,2021-08-15 19:00:00,19
211,237,448,66,25.5,2,Partly Cloudy,3.9,2021-08-15 20:00:00,20
119,138,257,70,24.7,2,Partly Cloudy,3.1,2021-08-15 21:00:00,21
145,113,258,74,24.2,2,Partly Cloudy,3.9,2021-08-15 22:00:00,22
85,52,137,77,23.7,2,Partly Cloudy,3.6,2021-08-15 23:00:00,23
30,31,61,82,23.3,3,Cloudy,3.6,2021-08-16 00:00:00,0
31,7,38,82,23.4,3,Cloudy,4.7,2021-08-16 01:00:00,1
18,7,25,83,23.5,51,Light Drizzle,5.8,2021-08-16 02:00:00,2
4,13,17,91,22.8,61,Light Rain,6.3,2021-08-16 03:00:00,3
7,12,19,93,22.9,53,Heavy Drizzle,6.1,2021-08-16 04:00:00,4
17,38,55,95,22.8,51,Light Drizzle,6.2,2021-08-16 05:00:00,5
34,116,150,94,22.8,51,Light Drizzle,5.2,2021-08-16 06:00:00,6
80,266,346,94,22.8,51,Light Drizzle,4.7,2021-08-16 07:00:00,7
107,381,488,92,23.0,51,Light Drizzle,5.8,2021-08-16 08:00:00,8
138,195,333,92,23.2,3,Cloudy,6.2,2021-08-16 09:00:00,9
119,154,273,89,23.8,3,Cloudy,6.9,2021-08-16 10:00:00,10
54,57,111,84,24.6,3,Cloudy,7.1,2021-08-16 11:00:00,11
129,136,265,76,25.9,3,Cloudy,6.8,2021-08-16 12:00:00,12
171,184,355,76,26.4,51,Light Drizzle,6.8,2021-08-16 13:00:00,13
198,184,382,76,26.9,3,Cloudy,6.6,2021-08-16 14:00:00,14
182,216,398,94,24.7,51,Light Drizzle,6.8,2021-08-16 15:00:00,15
131,210,341,89,26.2,51,Light Drizzle,7.2,2021-08-16 16:00:00,16
171,376,547,88,25.7,51,Light Drizzle,8.1,2021-08-16 17:00:00,17
89,201,290,89,25.0,51,Light Drizzle,5.9,2021-08-16 18:00:00,18
73,153,226,91,24.6,51,Light Drizzle,7.1,2021-08-16 19:00:00,19
52,115,167,93,24.2,3,Cloudy,7.1,2021-08-16 20:00:00,20
62,114,176,95,23.8,3,Cloudy,7.4,2021-08-16 21:00:00,21
69,75,144,96,23.6,3,Cloudy,8.4,2021-08-16 22:00:00,22
40,50,90,97,23.5,3,Cloudy,8.5,2021-08-16 23:00:00,23
22,15,37,96,23.5,3,Cloudy,8.1,2021-08-17 00:00:00,0
6,5,11,96,23.5,3,Cloudy,9.5,2021-08-17 01:00:00,1
4,2,6,97,23.3,51,Light Drizzle,9.5,2021-08-17 02:00:00,2
5,3,8,97,23.4,51,Light Drizzle,10.0,2021-08-17 03:00:00,3
7,14,21,97,23.3,51,Light Drizzle,8.7,2021-08-17 04:00:00,4
11,43,54,98,23.1,53,Heavy Drizzle,7.4,2021-08-17 05:00:00,5
37,131,168,98,23.1,51,Light Drizzle,3.8,2021-08-17 06:00:00,6
69,268,337,98,23.3,3,Cloudy,4.8,2021-08-17 07:00:00,7
98,395,493,95,23.9,3,Cloudy,6.4,2021-08-17 08:00:00,8
111,260,371,93,24.6,51,Light Drizzle,7.0,2021-08-17 09:00:00,9
106,173,279,92,25.6,51,Light Drizzle,8.6,2021-08-17 10:00:00,10
131,198,329,93,26.1,51,Light Drizzle,10.5,2021-08-17 11:00:00,11
202,219,421,87,27.1,51,Light Drizzle,10.5,2021-08-17 12:00:00,12
167,197,364,86,27.9,53,Heavy Drizzle,9.5,2021-08-17 13:00:00,13
187,219,406,84,28.3,53,Heavy Drizzle,8.3,2021-08-17 14:00:00,14
206,237,443,80,28.1,3,Cloudy,7.6,2021-08-17 15:00:00,15
242,322,564,78,28.6,3,Cloudy,7.6,2021-08-17 16:00:00,16
346,622,968,74,28.9,3,Cloudy,7.4,2021-08-17 17:00:00,17
337,570,907,73,28.5,2,Partly Cloudy,4.1,2021-08-17 18:00:00,18
231,392,623,78,27.8,3,Cloudy,4.5,2021-08-17 19:00:00,19
217,275,492,84,26.7,2,Partly Cloudy,5.9,2021-08-17 20:00:00,20
122,200,322,84,26.2,51,Light Drizzle,6.1,2021-08-17 21:00:00,21
140,138,278,86,25.9,3,Cloudy,7.4,2021-08-17 22:00:00,22
76,84,160,88,25.5,3,Cloudy,9.4,2021-08-17 23:00:00,23
37,35,72,91,25.2,2,Partly Cloudy,12.0,2021-08-18 00:00:00,0
4,21,25,93,24.9,2,Partly Cloudy,11.0,2021-08-18 01:00:00,1
11,3,14,94,24.7,3,Cloudy,10.5,2021-08-18 02:00:00,2
3,6,9,96,24.7,51,Light Drizzle,9.7,2021-08-18 03:00:00,3
9,14,23,96,24.7,53,Heavy Drizzle,9.9,2021-08-18 04:00:00,4
22,38,60,97,24.9,3,Cloudy,11.0,2021-08-18 05:00:00,5
42,126,168,97,24.8,3,Cloudy,7.9,2021-08-18 06:00:00,6
74,280,354,97,24.8,3,Cloudy,11.0,2021-08-18 07:00:00,7
111,470,581,95,25.1,3,Cloudy,12.2,2021-08-18 08:00:00,8
123,278,401,93,25.7,3,Cloudy,12.5,2021-08-18 09:00:00,9
126,206,332,88,26.6,51,Light Drizzle,14.7,2021-08-18 10:00:00,10
154,210,364,86,27.3,51,Light Drizzle,16.9,2021-08-18 11:00:00,11
108,187,295,84,27.8,51,Light Drizzle,17.3,2021-08-18 12:00:00,12
123,130,253,83,27.8,61,Light Rain,16.8,2021-08-18 13:00:00,13
146,198,344,85,27.3,55,Heavy Drizzle,15.5,2021-08-18 14:00:00,14
197,245,442,84,28.5,53,Heavy Drizzle,14.7,2021-08-18 15:00:00,15
223,340,563,82,27.8,61,Light Rain,17.0,2021-08-18 16:00:00,16
306,603,909,86,26.8,61,Light Rain,17.8,2021-08-18 17:00:00,17
294,570,864,87,27.0,51,Light Drizzle,15.4,2021-08-18 18:00:00,18
277,452,729,89,27.0,1,Mostly Clear,10.8,2021-08-18 19:00:00,19
231,338,569,90,26.6,1,Mostly Clear,12.0,2021-08-18 20:00:00,20
169,213,382,90,26.3,1,Mostly Clear,12.0,2021-08-18 21:00:00,21
133,164,297,90,26.2,1,Mostly Clear,10.8,2021-08-18 22:00:00,22
72,84,156,90,26.0,1,Mostly Clear,10.7,2021-08-18 23:00:00,23
53,28,81,88,25.6,1,Mostly Clear,10.2,2021-08-19 00:00:00,0
22,23,45,86,25.2,1,Mostly Clear,9.3,2021-08-19 01:00:00,1
19,13,32,84,24.9,1,Mostly Clear,9.7,2021-08-19 02:00:00,2
2,7,9,90,24.7,1,Mostly Clear,9.8,2021-08-19 03:00:00,3
9,15,24,89,24.3,0,Clear,9.8,2021-08-19 04:00:00,4
20,40,60,88,24.0,0,Clear,9.7,2021-08-19 05:00:00,5
49,132,181,89,23.7,0,Clear,9.6,2021-08-19 06:00:00,6
89,302,391,89,23.5,0,Clear,10.4,2021-08-19 07:00:00,7
142,424,566,87,24.7,0,Clear,9.1,2021-08-19 08:00:00,8
132,279,411,79,26.2,0,Clear,8.7,2021-08-19 09:00:00,9
184,197,381,73,27.2,1,Mostly Clear,11.7,2021-08-19 10:00:00,10
166,255,421,67,28.5,1,Mostly Clear,11.9,2021-08-19 11:00:00,11
223,249,472,62,29.7,1,Mostly Clear,11.6,2021-08-19 12:00:00,12
222,276,498,59,30.3,1,Mostly Clear,10.8,2021-08-19 13:00:00,13
192,258,450,57,30.5,1,Mostly Clear,9.6,2021-08-19 14:00:00,14
232,275,507,55,31.4,1,Mostly Clear,9.6,2021-08-19 15:00:00,15
270,347,617,55,31.3,1,Mostly Clear,7.6,2021-08-19 16:00:00,16
381,601,982,56,31.0,2,Partly Cloudy,5.2,2021-08-19 17:00:00,17
350,544,894,59,30.3,51,Light Drizzle,4.9,2021-08-19 18:00:00,18
209,313,522,65,29.7,3,Cloudy,4.1,2021-08-19 19:00:00,19
93,178,271,72,28.5,3,Cloudy,4.1,2021-08-19 20:00:00,20
127,171,298,76,27.3,3,Cloudy,5.2,2021-08-19 21:00:00,21
142,141,283,79,26.6,2,Partly Cloudy,5.5,2021-08-19 22:00:00,22
95,74,169,82,26.1,3,Cloudy,6.1,2021-08-19 23:00:00,23
52,45,97,81,25.8,3,Cloudy,6.1,2021-08-20 00:00:00,0
28,20,48,81,25.6,53,Heavy Drizzle,5.9,2021-08-20 01:00:00,1
14,9,23,86,24.6,55,Heavy Drizzle,5.6,2021-08-20 02:00:00,2
10,17,27,96,23.8,63,Rain,5.8,2021-08-20 03:00:00,3
5,11,16,96,23.7,63,Rain,6.4,2021-08-20 04:00:00,4
8,27,35,96,23.6,61,Light Rain,4.8,2021-08-20 05:00:00,5
16,50,66,96,23.5,61,Light Rain,3.4,2021-08-20 06:00:00,6
17,49,66,96,23.4,61,Light Rain,4.6,2021-08-20 07:00:00,7
14,41,55,96,23.4,55,Heavy Drizzle,7.9,2021-08-20 08:00:00,8
7,28,35,95,23.6,53,Heavy Drizzle,8.2,2021-08-20 09:00:00,9
23,49,72,92,24.1,51,Light Drizzle,9.4,2021-08-20 10:00:00,10
97,156,253,86,25.0,3,Cloudy,9.9,2021-08-20 11:00:00,11
147,190,337,83,25.4,3,Cloudy,9.0,2021-08-20 12:00:00,12
183,238,421,78,26.0,3,Cloudy,6.5,2021-08-20 13:00:00,13
256,266,522,72,26.5,3,Cloudy,6.2,2021-08-20 14:00:00,14
258,341,599,80,25.6,53,Heavy Drizzle,6.5,2021-08-20 15:00:00,15
323,371,694,79,25.5,51,Light Drizzle,9.3,2021-08-20 16:00:00,16
377,481,858,77,25.6,1,Mostly Clear,8.7,2021-08-20 17:00:00,17
364,513,877,79,25.3,1,Mostly Clear,2.3,2021-08-20 18:00:00,18
339,436,775,81,24.9,1,Mostly Clear,1.9,2021-08-20 19:00:00,19
212,298,510,85,24.3,1,Mostly Clear,1.6,2021-08-20 20:00:00,20
182,198,380,88,23.7,1,Mostly Clear,1.5,2021-08-20 21:00:00,21
169,160,329,91,23.1,1,Mostly Clear,0.8,2021-08-20 22:00:00,22
147,120,267,93,22.7,1,Mostly Clear,1.6,2021-08-20 23:00:00,23
82,75,157,95,22.3,1,Mostly Clear,1.5,2021-08-21 00:00:00,0
121,96,217,96,22.1,1,Mostly Clear,2.9,2021-08-21 01:00:00,1
107,57,164,96,22.0,3,Cloudy,3.1,2021-08-21 02:00:00,2
59,40,99,98,22.6,2,Partly Cloudy,2.5,2021-08-21 03:00:00,3
26,22,48,99,22.3,3,Cloudy,2.3,2021-08-21 04:00:00,4
20,20,40,99,22.1,3,Cloudy,2.9,2021-08-21 05:00:00,5
39,51,90,99,21.8,2,Partly Cloudy,3.2,2021-08-21 06:00:00,6
53,104,157,99,21.8,3,Cloudy,4.7,2021-08-21 07:00:00,7
157,208,365,94,23.1,3,Cloudy,2.1,2021-08-21 08:00:00,8
213,314,527,89,24.1,2,Partly Cloudy,4.3,2021-08-21 09:00:00,9
306,401,707,82,25.4,51,Light Drizzle,5.4,2021-08-21 10:00:00,10
410,402,812,80,26.4,2,Partly Cloudy,6.7,2021-08-21 11:00:00,11
369,359,728,78,27.2,2,Partly Cloudy,7.7,2021-08-21 12:00:00,12
327,349,676,75,28.1,51,Light Drizzle,7.2,2021-08-21 13:00:00,13
355,282,637,69,28.8,51,Light Drizzle,5.8,2021-08-21 14:00:00,14
255,184,439,72,29.1,51,Light Drizzle,6.5,2021-08-21 15:00:00,15
363,316,679,71,28.9,51,Light Drizzle,5.5,2021-08-21 16:00:00,16
402,327,729,72,28.6,51,Light Drizzle,5.1,2021-08-21 17:00:00,17
376,369,745,82,25.5,63,Rain,5.7,2021-08-21 18:00:00,18
321,321,642,88,24.7,51,Light Drizzle,1.4,2021-08-21 19:00:00,19
284,235,519,90,24.3,2,Partly Cloudy,4.1,2021-08-21 20:00:00,20
189,214,403,92,24.0,3,Cloudy,1.9,2021-08-21 21:00:00,21
210,213,423,96,23.3,2,Partly Cloudy,1.9,2021-08-21 22:00:00,22
196,143,339,97,23.2,1,Mostly Clear,3.6,2021-08-21 23:00:00,23
145,137,282,99,22.4,1,Mostly Clear,4.7,2021-08-22 00:00:00,0
154,91,245,99,21.7,2,Partly Cloudy,3.2,2021-08-22 01:00:00,1
106,70,176,99,21.7,3,Cloudy,5.0,2021-08-22 02:00:00,2
57,38,95,98,21.3,2,Partly Cloudy,6.1,2021-08-22 03:00:00,3
27,15,42,98,21.2,2,Partly Cloudy,6.3,2021-08-22 04:00:00,4
17,25,42,98,21.1,1,Mostly Clear,6.4,2021-08-22 05:00:00,5
27,33,60,99,20.7,1,Mostly Clear,2.4,2021-08-22 06:00:00,6
49,54,103,98,20.6,2,Partly Cloudy,4.0,2021-08-22 07:00:00,7
121,134,255,96,22.0,2,Partly Cloudy,5.0,2021-08-22 08:00:00,8
173,244,417,89,23.8,2,Partly Cloudy,1.8,2021-08-22 09:00:00,9
291,293,584,80,25.8,3,Cloudy,1.8,2021-08-22 10:00:00,10
366,360,726,73,27.5,2,Partly Cloudy,1.3,2021-08-22 11:00:00,11
365,376,741,67,28.9,51,Light Drizzle,4.4,2021-08-22 12:00:00,12
399,369,768,63,29.5,51,Light Drizzle,9.4,2021-08-22 13:00:00,13
424,354,778,62,30.1,1,Mostly Clear,8.3,2021-08-22 14:00:00,14
450,353,803,71,27.8,51,Light Drizzle,6.6,2021-08-22 15:00:00,15
394,328,722,71,27.3,2,Partly Cloudy,5.4,2021-08-22 16:00:00,16
357,310,667,77,26.4,2,Partly Cloudy,4.1,2021-08-22 17:00:00,17
297,319,616,76,26.2,2,Partly Cloudy,4.0,2021-08-22 18:00:00,18
239,276,515,79,25.7,3,Cloudy,3.9,2021-08-22 19:00:00,19
172,192,364,89,25.0,3,Cloudy,1.3,2021-08-22 20:00:00,20
130,144,274,90,24.2,2,Partly Cloudy,5.8,2021-08-22 21:00:00,21
112,112,224,91,23.9,3,Cloudy,7.4,2021-08-22 22:00:00,22
49,67,116,90,23.9,3,Cloudy,7.6,2021-08-22 23:00:00,23
50,30,80,91,23.8,2,Partly Cloudy,7.9,2021-08-23 00:00:00,0
13,18,31,91,23.7,3,Cloudy,7.6,2021-08-23 01:00:00,1
7,6,13,91,23.6,2,Partly Cloudy,7.1,2021-08-23 02:00:00,2
7,4,11,94,23.3,53,Heavy Drizzle,6.8,2021-08-23 03:00:00,3
21,12,33,95,23.0,51,Light Drizzle,7.4,2021-08-23 04:00:00,4
14,42,56,96,22.8,53,Heavy Drizzle,7.9,2021-08-23 05:00:00,5
47,136,183,96,22.5,1,Mostly Clear,7.3,2021-08-23 06:00:00,6
71,307,378,96,22.6,1,Mostly Clear,8.0,2021-08-23 07:00:00,7
137,435,572,95,23.3,1,Mostly Clear,8.6,2021-08-23 08:00:00,8
152,263,415,89,24.8,1,Mostly Clear,8.0,2021-08-23 09:00:00,9
187,191,378,80,26.3,1,Mostly Clear,9.7,2021-08-23 10:00:00,10
177,211,388,73,28.0,0,Clear,10.8,2021-08-23 11:00:00,11
221,237,458,68,29.2,51,Light Drizzle,10.8,2021-08-23 12:00:00,12
176,260,436,67,29.8,1,Mostly Clear,10.6,2021-08-23 13:00:00,13
192,224,416,64,30.6,1,Mostly Clear,11.0,2021-08-23 14:00:00,14
199,280,479,56,31.8,1,Mostly Clear,11.6,2021-08-23 15:00:00,15
226,347,573,56,31.8,1,Mostly Clear,10.9,2021-08-23 16:00:00,16
329,589,918,55,31.8,1,Mostly Clear,9.4,2021-08-23 17:00:00,17
287,579,866,58,31.3,1,Mostly Clear,7.2,2021-08-23 18:00:00,18
273,437,710,66,30.3,0,Clear,5.4,2021-08-23 19:00:00,19
218,312,530,70,29.0,1,Mostly Clear,6.9,2021-08-23 20:00:00,20
127,180,307,73,27.6,2,Partly Cloudy,7.6,2021-08-23 21:00:00,21
105,119,224,73,26.9,1,Mostly Clear,8.6,2021-08-23 22:00:00,22
32,39,71,72,26.6,1,Mostly Clear,10.0,2021-08-23 23:00:00,23
18,14,32,73,26.2,1,Mostly Clear,10.0,2021-08-24 00:00:00,0
27,7,34,76,25.9,0,Clear,10.1,2021-08-24 01:00:00,1
17,5,22,78,25.6,0,Clear,11.0,2021-08-24 02:00:00,2
3,7,10,79,25.4,0,Clear,11.5,2021-08-24 03:00:00,3
10,17,27,82,25.1,0,Clear,11.7,2021-08-24 04:00:00,4
26,45,71,84,24.8,0,Clear,11.5,2021-08-24 05:00:00,5
43,145,188,87,24.3,0,Clear,9.4,2021-08-24 06:00:00,6
96,368,464,89,23.9,0,Clear,8.7,2021-08-24 07:00:00,7
138,488,626,88,24.9,1,Mostly Clear,8.2,2021-08-24 08:00:00,8
120,306,426,79,26.7,0,Clear,7.9,2021-08-24 09:00:00,9
125,206,331,71,28.1,0,Clear,7.1,2021-08-24 10:00:00,10
155,257,412,64,29.3,0,Clear,5.5,2021-08-24 11:00:00,11
191,286,477,57,30.5,0,Clear,4.3,2021-08-24 12:00:00,12
182,248,430,52,31.6,0,Clear,4.6,2021-08-24 13:00:00,13
167,247,414,48,32.4,0,Clear,5.7,2021-08-24 14:00:00,14
178,282,460,48,32.8,0,Clear,5.5,2021-08-24 15:00:00,15
199,392,591,45,33.1,0,Clear,5.3,2021-08-24 16:00:00,16
286,630,916,45,33.0,0,Clear,4.7,2021-08-24 17:00:00,17
324,617,941,49,32.2,0,Clear,5.1,2021-08-24 18:00:00,18
272,512,784,63,30.7,0,Clear,3.1,2021-08-24 19:00:00,19
207,338,545,69,29.4,0,Clear,1.1,2021-08-24 20:00:00,20
160,190,350,74,27.9,0,Clear,2.2,2021-08-24 21:00:00,21
102,156,258,80,26.9,0,Clear,3.3,2021-08-24 22:00:00,22
76,71,147,86,26.0,0,Clear,2.6,2021-08-24 23:00:00,23
21,24,45,89,25.3,0,Clear,1.8,2021-08-25 00:00:00,0
12,14,26,91,24.7,0,Clear,1.8,2021-08-25 01:00:00,1
10,6,16,93,24.2,0,Clear,1.4,2021-08-25 02:00:00,2
7,4,11,90,25.7,0,Clear,2.2,2021-08-25 03:00:00,3
12,11,23,91,25.4,0,Clear,1.3,2021-08-25 04:00:00,4
18,56,74,93,25.0,0,Clear,1.8,2021-08-25 05:00:00,5
48,175,223,95,24.7,2,Partly Cloudy,2.6,2021-08-25 06:00:00,6
111,352,463,96,24.5,1,Mostly Clear,2.0,2021-08-25 07:00:00,7
144,491,635,94,25.5,0,Clear,2.7,2021-08-25 08:00:00,8
130,279,409,78,28.2,0,Clear,2.7,2021-08-25 09:00:00,9
122,225,347,68,29.8,0,Clear,4.8,2021-08-25 10:00:00,10
128,224,352,62,30.8,0,Clear,6.1,2021-08-25 11:00:00,11
167,254,421,58,31.7,0,Clear,6.0,2021-08-25 12:00:00,12
138,268,406,55,32.4,0,Clear,5.4,2021-08-25 13:00:00,13
166,244,410,54,32.9,0,Clear,5.2,2021-08-25 14:00:00,14
190,304,494,52,33.5,0,Clear,6.9,2021-08-25 15:00:00,15
178,373,551,52,33.4,0,Clear,8.3,2021-08-25 16:00:00,16
303,631,934,56,31.9,51,Light Drizzle,8.0,2021-08-25 17:00:00,17
330,603,933,60,31.0,1,Mostly Clear,4.7,2021-08-25 18:00:00,18
248,498,746,71,30.0,1,Mostly Clear,3.8,2021-08-25 19:00:00,19
173,327,500,74,29.1,1,Mostly Clear,4.0,2021-08-25 20:00:00,20
72,155,227,78,28.1,1,Mostly Clear,5.0,2021-08-25 21:00:00,21
60,108,168,82,27.4,1,Mostly Clear,5.8,2021-08-25 22:00:00,22
85,86,171,86,26.8,1,Mostly Clear,6.5,2021-08-25 23:00:00,23
27,38,65,89,26.4,1,Mostly Clear,9.2,2021-08-26 00:00:00,0
20,21,41,92,26.0,1,Mostly Clear,7.6,2021-08-26 01:00:00,1
10,4,14,94,25.7,1,Mostly Clear,7.3,2021-08-26 02:00:00,2
9,6,15,91,24.6,1,Mostly Clear,6.6,2021-08-26 03:00:00,3
15,18,33,92,24.5,1,Mostly Clear,5.2,2021-08-26 04:00:00,4
27,44,71,94,24.3,2,Partly Cloudy,4.4,2021-08-26 05:00:00,5
54,153,207,95,24.3,1,Mostly Clear,3.1,2021-08-26 06:00:00,6
91,356,447,96,24.4,1,Mostly Clear,2.5,2021-08-26 07:00:00,7
140,474,614,94,25.2,1,Mostly Clear,0.8,2021-08-26 08:00:00,8
155,313,468,89,26.8,0,Clear,2.0,2021-08-26 09:00:00,9
147,194,341,83,28.3,1,Mostly Clear,2.7,2021-08-26 10:00:00,10
142,235,377,76,29.6,1,Mostly Clear,3.1,2021-08-26 11:00:00,11
168,272,440,68,31.0,0,Clear,3.2,2021-08-26 12:00:00,12
151,256,407,65,31.7,51,Light Drizzle,3.6,2021-08-26 13:00:00,13
179,273,452,62,32.2,1,Mostly Clear,5.0,2021-08-26 14:00:00,14
110,155,265,70,31.3,53,Heavy Drizzle,5.0,2021-08-26 15:00:00,15
63,122,185,75,29.8,63,Rain,5.6,2021-08-26 16:00:00,16
232,457,689,80,28.7,61,Light Rain,6.1,2021-08-26 17:00:00,17
262,514,776,80,28.9,1,Mostly Clear,4.8,2021-08-26 18:00:00,18
245,468,713,84,28.5,1,Mostly Clear,2.7,2021-08-26 19:00:00,19
169,307,476,86,28.2,1,Mostly Clear,1.8,2021-08-26 20:00:00,20
157,252,409,88,27.8,1,Mostly Clear,2.7,2021-08-26 21:00:00,21
131,187,318,90,27.3,0,Clear,3.6,2021-08-26 22:00:00,22
106,86,192,92,26.9,0,Clear,3.9,2021-08-26 23:00:00,23
57,49,106,92,26.7,0,Clear,2.2,2021-08-27 00:00:00,0
51,37,88,95,26.2,0,Clear,2.6,2021-08-27 01:00:00,1
22,25,47,98,25.7,0,Clear,5.5,2021-08-27 02:00:00,2
9,9,18,96,24.4,0,Clear,4.2,2021-08-27 03:00:00,3
10,10,20,96,24.2,0,Clear,4.6,2021-08-27 04:00:00,4
15,35,50,98,24.0,0,Clear,4.7,2021-08-27 05:00:00,5
56,145,201,98,23.8,0,Clear,5.3,2021-08-27 06:00:00,6
113,336,449,99,23.7,0,Clear,3.4,2021-08-27 07:00:00,7
143,440,583,95,25.7,0,Clear,3.9,2021-08-27 08:00:00,8
146,292,438,87,27.4,0,Clear,2.9,2021-08-27 09:00:00,9
165,238,403,79,29.1,0,Clear,3.1,2021-08-27 10:00:00,10
207,276,483,71,30.5,0,Clear,3.6,2021-08-27 11:00:00,11
204,307,511,64,31.5,51,Light Drizzle,4.3,2021-08-27 12:00:00,12
215,281,496,60,32.3,0,Clear,5.2,2021-08-27 13:00:00,13
269,314,583,58,33.0,1,Mostly Clear,6.0,2021-08-27 14:00:00,14
278,407,685,61,32.7,51,Light Drizzle,8.6,2021-08-27 15:00:00,15
96,137,233,67,31.3,61,Light Rain,7.6,2021-08-27 16:00:00,16
144,318,462,81,28.8,63,Rain,7.3,2021-08-27 17:00:00,17
217,421,638,88,27.5,63,Rain,2.2,2021-08-27 18:00:00,18
236,398,634,90,26.8,1,Mostly Clear,4.3,2021-08-27 19:00:00,19
174,237,411,92,26.4,2,Partly Cloudy,6.6,2021-08-27 20:00:00,20
138,194,332,93,26.0,2,Partly Cloudy,4.4,2021-08-27 21:00:00,21
149,171,320,95,25.7,2,Partly Cloudy,4.0,2021-08-27 22:00:00,22
131,145,276,96,25.5,2,Partly Cloudy,5.8,2021-08-27 23:00:00,23
131,113,244,97,25.2,2,Partly Cloudy,3.8,2021-08-28 00:00:00,0
127,70,197,98,25.0,1,Mostly Clear,2.9,2021-08-28 01:00:00,1
81,48,129,98,24.7,1,Mostly Clear,2.5,2021-08-28 02:00:00,2
41,25,66,96,24.7,0,Clear,2.7,2021-08-28 03:00:00,3
13,16,29,98,24.3,2,Partly Cloudy,4.3,2021-08-28 04:00:00,4
30,23,53,99,24.1,3,Cloudy,5.7,2021-08-28 05:00:00,5
34,62,96,99,24.0,3,Cloudy,4.7,2021-08-28 06:00:00,6
71,129,200,99,23.9,3,Cloudy,5.2,2021-08-28 07:00:00,7
146,232,378,96,24.4,3,Cloudy,5.7,2021-08-28 08:00:00,8
236,341,577,90,25.8,3,Cloudy,5.6,2021-08-28 09:00:00,9
317,408,725,84,27.3,2,Partly Cloudy,5.7,2021-08-28 10:00:00,10
398,459,857,82,28.3,1,Mostly Clear,5.8,2021-08-28 11:00:00,11
519,465,984,79,29.1,51,Light Drizzle,6.7,2021-08-28 12:00:00,12
450,353,803,75,29.8,1,Mostly Clear,7.1,2021-08-28 13:00:00,13
491,347,838,72,30.4,1,Mostly Clear,7.4,2021-08-28 14:00:00,14
437,388,825,68,30.8,51,Light Drizzle,7.9,2021-08-28 15:00:00,15
352,386,738,70,29.4,51,Light Drizzle,10.5,2021-08-28 16:00:00,16
386,376,762,76,28.2,1,Mostly Clear,12.3,2021-08-28 17:00:00,17
347,368,715,78,27.8,2,Partly Cloudy,9.7,2021-08-28 18:00:00,18
375,359,734,79,27.4,3,Cloudy,10.0,2021-08-28 19:00:00,19
277,241,518,83,26.6,3,Cloudy,10.1,2021-08-28 20:00:00,20
218,216,434,86,25.9,3,Cloudy,12.1,2021-08-28 21:00:00,21
224,208,432,89,25.4,3,Cloudy,12.4,2021-08-28 22:00:00,22
227,185,412,90,25.0,3,Cloudy,11.3,2021-08-28 23:00:00,23
230,138,368,91,24.7,3,Cloudy,11.0,2021-08-29 00:00:00,0
131,88,219,92,24.4,3,Cloudy,10.0,2021-08-29 01:00:00,1
108,59,167,92,24.3,3,Cloudy,9.5,2021-08-29 02:00:00,2
72,26,98,89,23.7,3,Cloudy,9.4,2021-08-29 03:00:00,3
26,21,47,89,23.5,3,Cloudy,8.4,2021-08-29 04:00:00,4
13,27,40,89,23.5,3,Cloudy,7.1,2021-08-29 05:00:00,5
34,45,79,88,23.5,3,Cloudy,6.5,2021-08-29 06:00:00,6
45,96,141,88,23.4,3,Cloudy,6.6,2021-08-29 07:00:00,7
87,175,262,88,23.6,3,Cloudy,8.5,2021-08-29 08:00:00,8
215,258,473,85,24.0,3,Cloudy,8.0,2021-08-29 09:00:00,9
274,291,565,81,24.8,3,Cloudy,5.4,2021-08-29 10:00:00,10
266,331,597,76,26.1,3,Cloudy,4.5,2021-08-29 11:00:00,11
344,388,732,72,27.2,3,Cloudy,2.8,2021-08-29 12:00:00,12
361,414,775,69,27.9,3,Cloudy,1.6,2021-08-29 13:00:00,13
383,408,791,67,28.3,3,Cloudy,2.8,2021-08-29 14:00:00,14
373,386,759,73,27.1,3,Cloudy,3.1,2021-08-29 15:00:00,15
354,363,717,72,27.4,3,Cloudy,3.7,2021-08-29 16:00:00,16
317,386,703,73,27.3,3,Cloudy,4.6,2021-08-29 17:00:00,17
284,358,642,74,27.0,2,Partly Cloudy,3.3,2021-08-29 18:00:00,18
231,308,539,77,26.5,1,Mostly Clear,4.6,2021-08-29 19:00:00,19
134,186,320,82,25.8,1,Mostly Clear,5.5,2021-08-29 20:00:00,20
108,149,257,87,25.1,1,Mostly Clear,4.6,2021-08-29 21:00:00,21
87,103,190,91,24.3,1,Mostly Clear,4.7,2021-08-29 22:00:00,22
49,59,108,93,23.9,1,Mostly Clear,5.9,2021-08-29 23:00:00,23
22,27,49,95,23.5,1,Mostly Clear,6.0,2021-08-30 00:00:00,0
16,19,35,96,23.2,0,Clear,4.5,2021-08-30 01:00:00,1
13,13,26,96,22.9,0,Clear,4.6,2021-08-30 02:00:00,2
6,5,11,97,23.2,0,Clear,4.0,2021-08-30 03:00:00,3
11,14,25,98,22.9,0,Clear,4.4,2021-08-30 04:00:00,4
23,46,69,99,22.7,0,Clear,5.6,2021-08-30 05:00:00,5
55,168,223,99,22.7,3,Cloudy,5.8,2021-08-30 06:00:00,6
93,360,453,99,22.6,3,Cloudy,7.2,2021-08-30 07:00:00,7
150,514,664,94,24.6,3,Cloudy,9.6,2021-08-30 08:00:00,8
119,301,420,86,26.1,3,Cloudy,8.9,2021-08-30 09:00:00,9
139,224,363,79,27.6,2,Partly Cloudy,8.0,2021-08-30 10:00:00,10
143,231,374,71,29.0,1,Mostly Clear,6.2,2021-08-30 11:00:00,11
155,288,443,66,30.0,0,Clear,7.4,2021-08-30 12:00:00,12
156,228,384,64,30.8,0,Clear,7.2,2021-08-30 13:00:00,13
163,263,426,63,31.4,1,Mostly Clear,8.1,2021-08-30 14:00:00,14
184,310,494,62,31.4,51,Light Drizzle,5.8,2021-08-30 15:00:00,15
212,437,649,65,30.7,51,Light Drizzle,4.1,2021-08-30 16:00:00,16
245,620,865,77,28.5,61,Light Rain,4.3,2021-08-30 17:00:00,17
270,546,816,84,27.4,61,Light Rain,6.2,2021-08-30 18:00:00,18
259,431,690,88,27.0,1,Mostly Clear,4.0,2021-08-30 19:00:00,19
137,274,411,91,26.5,1,Mostly Clear,0.5,2021-08-30 20:00:00,20
95,212,307,93,25.9,2,Partly Cloudy,4.0,2021-08-30 21:00:00,21
91,132,223,95,25.4,2,Partly Cloudy,2.2,2021-08-30 22:00:00,22
64,64,128,96,25.0,2,Partly Cloudy,4.6,2021-08-30 23:00:00,23
22,16,38,96,24.8,2,Partly Cloudy,8.1,2021-08-31 00:00:00,0
9,7,16,94,24.6,2,Partly Cloudy,7.3,2021-08-31 01:00:00,1
4,3,7,91,24.4,1,Mostly Clear,5.6,2021-08-31 02:00:00,2
5,5,10,94,23.9,1,Mostly Clear,7.1,2021-08-31 03:00:00,3
14,14,28,93,23.5,1,Mostly Clear,8.6,2021-08-31 04:00:00,4
18,52,70,93,23.2,1,Mostly Clear,8.9,2021-08-31 05:00:00,5
57,171,228,93,23.0,2,Partly Cloudy,7.7,2021-08-31 06:00:00,6
99,430,529,94,22.9,2,Partly Cloudy,7.2,2021-08-31 07:00:00,7
130,534,664,93,23.6,2,Partly Cloudy,6.4,2021-08-31 08:00:00,8
129,395,524,89,24.8,2,Partly Cloudy,3.4,2021-08-31 09:00:00,9
144,248,392,82,26.3,1,Mostly Clear,3.7,2021-08-31 10:00:00,10
168,277,445,75,27.2,2,Partly Cloudy,3.4,2021-08-31 11:00:00,11
139,340,479,74,27.2,51,Light Drizzle,1.0,2021-08-31 12:00:00,12
134,276,410,73,27.3,51,Light Drizzle,1.4,2021-08-31 13:00:00,13
147,281,428,73,27.4,51,Light Drizzle,0.4,2021-08-31 14:00:00,14
174,347,521,74,27.6,51,Light Drizzle,2.3,2021-08-31 15:00:00,15
198,445,643,78,27.0,53,Heavy Drizzle,3.8,2021-08-31 16:00:00,16
301,678,979,83,26.5,51,Light Drizzle,1.0,2021-08-31 17:00:00,17
279,648,927,87,25.9,51,Light Drizzle,1.4,2021-08-31 18:00:00,18
207,452,659,90,25.7,51,Light Drizzle,3.1,2021-08-31 19:00:00,19
131,273,404,93,25.2,51,Light Drizzle,8.0,2021-08-31 20:00:00,20
94,165,259,95,24.7,53,Heavy Drizzle,5.4,2021-08-31 21:00:00,21
69,123,192,96,24.3,53,Heavy Drizzle,4.4,2021-08-31 22:00:00,22
55,84,139,97,23.9,53,Heavy Drizzle,4.0,2021-08-31 23:00:00,23
11,12,23,97,23.7,53,Heavy Drizzle,4.7,2021-09-01 00:00:00,0
4,8,12,97,23.5,53,Heavy Drizzle,5.4,2021-09-01 01:00:00,1
6,10,16,97,23.3,61,Light Rain,7.6,2021-09-01 02:00:00,2
6,2,8,95,23.2,55,Heavy Drizzle,7.6,2021-09-01 03:00:00,3
8,10,18,97,22.7,61,Light Rain,4.6,2021-09-01 04:00:00,4
16,35,51,97,22.3,53,Heavy Drizzle,3.8,2021-09-01 05:00:00,5
39,129,168,97,22.0,53,Heavy Drizzle,4.0,2021-09-01 06:00:00,6
93,305,398,96,22.3,51,Light Drizzle,6.5,2021-09-01 07:00:00,7
123,432,555,96,22.7,51,Light Drizzle,7.7,2021-09-01 08:00:00,8
95,325,420,96,23.3,51,Light Drizzle,9.0,2021-09-01 09:00:00,9
89,217,306,97,24.0,53,Heavy Drizzle,8.6,2021-09-01 10:00:00,10
119,258,377,96,24.9,53,Heavy Drizzle,11.2,2021-09-01 11:00:00,11
121,308,429,92,26.0,53,Heavy Drizzle,17.1,2021-09-01 12:00:00,12
64,173,237,85,26.6,61,Light Rain,20.8,2021-09-01 13:00:00,13
58,172,230,88,26.6,55,Heavy Drizzle,23.1,2021-09-01 14:00:00,14
48,109,157,95,25.9,63,Rain,18.3,2021-09-01 15:00:00,15
84,256,340,95,25.8,61,Light Rain,17.8,2021-09-01 16:00:00,16
136,392,528,96,25.0,63,Rain,21.8,2021-09-01 17:00:00,17
35,129,164,96,24.0,63,Rain,10.3,2021-09-01 18:00:00,18
54,179,233,97,22.7,53,Heavy Drizzle,10.2,2021-09-01 19:00:00,19
60,154,214,90,20.7,3,Cloudy,21.9,2021-09-01 20:00:00,20
68,109,177,85,19.6,3,Cloudy,27.5,2021-09-01 21:00:00,21
37,94,131,82,19.5,3,Cloudy,24.2,2021-09-01 22:00:00,22
42,43,85,79,19.5,2,Partly Cloudy,22.1,2021-09-01 23:00:00,23
27,23,50,78,19.3,1,Mostly Clear,21.1,2021-09-02 00:00:00,0
11,6,17,77,19.3,1,Mostly Clear,19.8,2021-09-02 01:00:00,1
13,8,21,76,19.2,1,Mostly Clear,20.0,2021-09-02 02:00:00,2
12,8,20,77,19.3,0,Clear,20.0,2021-09-02 03:00:00,3
13,14,27,75,19.0,0,Clear,19.2,2021-09-02 04:00:00,4
21,36,57,73,18.6,0,Clear,18.0,2021-09-02 05:00:00,5
61,156,217,71,18.2,0,Clear,16.9,2021-09-02 06:00:00,6
106,365,471,68,17.7,0,Clear,16.0,2021-09-02 07:00:00,7
185,507,692,68,17.9,0,Clear,14.1,2021-09-02 08:00:00,8
153,386,539,61,18.9,0,Clear,15.0,2021-09-02 09:00:00,9
159,232,391,57,20.3,0,Clear,16.7,2021-09-02 10:00:00,10
162,315,477,51,21.8,0,Clear,16.8,2021-09-02 11:00:00,11
192,344,536,46,23.1,0,Clear,15.7,2021-09-02 12:00:00,12
220,310,530,43,24.1,0,Clear,15.0,2021-09-02 13:00:00,13
217,353,570,41,24.9,0,Clear,14.5,2021-09-02 14:00:00,14
255,360,615,40,25.3,0,Clear,13.5,2021-09-02 15:00:00,15
283,492,775,40,25.5,0,Clear,13.2,2021-09-02 16:00:00,16
408,789,1197,40,25.3,0,Clear,12.4,2021-09-02 17:00:00,17
438,777,1215,44,24.7,0,Clear,9.0,2021-09-02 18:00:00,18
354,563,917,50,23.4,0,Clear,6.7,2021-09-02 19:00:00,19
231,380,611,56,21.8,0,Clear,6.2,2021-09-02 20:00:00,20
191,271,462,60,20.5,0,Clear,6.2,2021-09-02 21:00:00,21
132,184,316,64,19.4,0,Clear,6.7,2021-09-02 22:00:00,22
131,115,246,66,18.6,0,Clear,7.9,2021-09-02 23:00:00,23
72,63,135,67,18.0,0,Clear,7.8,2021-09-03 00:00:00,0
44,50,94,66,17.7,0,Clear,11.2,2021-09-03 01:00:00,1
22,28,50,66,17.3,0,Clear,13.0,2021-09-03 02:00:00,2
10,12,22,66,16.7,0,Clear,13.1,2021-09-03 03:00:00,3
13,14,27,68,16.3,0,Clear,11.7,2021-09-03 04:00:00,4
25,46,71,72,15.8,0,Clear,10.7,2021-09-03 05:00:00,5
46,146,192,76,15.3,0,Clear,8.6,2021-09-03 06:00:00,6
113,348,461,81,14.8,0,Clear,8.7,2021-09-03 07:00:00,7
133,425,558,78,16.0,0,Clear,7.4,2021-09-03 08:00:00,8
142,344,486,67,18.3,0,Clear,6.6,2021-09-03 09:00:00,9
168,286,454,60,20.0,0,Clear,6.9,2021-09-03 10:00:00,10
225,307,532,55,21.2,0,Clear,6.6,2021-09-03 11:00:00,11
323,350,673,51,22.3,1,Mostly Clear,7.6,2021-09-03 12:00:00,12
322,368,690,49,23.3,3,Cloudy,8.5,2021-09-03 13:00:00,13
357,437,794,47,24.1,2,Partly Cloudy,7.7,2021-09-03 14:00:00,14
424,510,934,46,24.7,3,Cloudy,8.1,2021-09-03 15:00:00,15
405,577,982,46,24.8,2,Partly Cloudy,8.0,2021-09-03 16:00:00,16
452,631,1083,45,24.8,2,Partly Cloudy,8.3,2021-09-03 17:00:00,17
457,537,994,51,24.1,1,Mostly Clear,5.8,2021-09-03 18:00:00,18
363,423,786,58,23.2,1,Mostly Clear,4.9,2021-09-03 19:00:00,19
259,310,569,65,21.7,1,Mostly Clear,5.1,2021-09-03 20:00:00,20
177,205,382,69,20.6,1,Mostly Clear,5.9,2021-09-03 21:00:00,21
209,179,388,75,19.6,1,Mostly Clear,6.6,2021-09-03 22:00:00,22
171,169,340,81,18.6,1,Mostly Clear,5.9,2021-09-03 23:00:00,23
144,125,269,84,18.0,1,Mostly Clear,5.0,2021-09-04 00:00:00,0
108,87,195,81,18.4,0,Clear,4.6,2021-09-04 01:00:00,1
78,56,134,86,17.5,0,Clear,5.0,2021-09-04 02:00:00,2
53,31,84,79,18.7,0,Clear,2.3,2021-09-04 03:00:00,3
20,17,37,86,17.3,0,Clear,3.1,2021-09-04 04:00:00,4
15,21,36,93,15.8,0,Clear,4.3,2021-09-04 05:00:00,5
36,60,96,95,15.4,2,Partly Cloudy,4.5,2021-09-04 06:00:00,6
57,100,157,96,15.2,1,Mostly Clear,5.1,2021-09-04 07:00:00,7
145,185,330,92,17.0,0,Clear,3.1,2021-09-04 08:00:00,8
267,275,542,75,20.0,0,Clear,1.1,2021-09-04 09:00:00,9
392,376,768,62,21.9,0,Clear,1.4,2021-09-04 10:00:00,10
455,398,853,56,22.9,0,Clear,2.3,2021-09-04 11:00:00,11
584,373,957,54,23.9,0,Clear,3.3,2021-09-04 12:00:00,12
533,433,966,53,24.6,2,Partly Cloudy,3.3,2021-09-04 13:00:00,13
591,370,961,49,25.6,0,Clear,3.6,2021-09-04 14:00:00,14
654,400,1054,49,25.8,0,Clear,5.8,2021-09-04 15:00:00,15
612,383,995,49,26.1,0,Clear,7.3,2021-09-04 16:00:00,16
534,382,916,51,25.9,0,Clear,8.5,2021-09-04 17:00:00,17
527,355,882,54,25.3,0,Clear,7.4,2021-09-04 18:00:00,18
434,339,773,63,23.9,0,Clear,7.7,2021-09-04 19:00:00,19
294,214,508,69,22.4,1,Mostly Clear,8.9,2021-09-04 20:00:00,20
248,186,434,74,21.4,0,Clear,10.5,2021-09-04 21:00:00,21
223,155,378,77,21.0,0,Clear,10.8,2021-09-04 22:00:00,22
221,101,322,79,20.7,0,Clear,11.0,2021-09-04 23:00:00,23
131,88,219,79,20.7,1,Mostly Clear,11.2,2021-09-05 00:00:00,0
100,84,184,81,20.5,0,Clear,10.7,2021-09-05 01:00:00,1
111,55,166,82,20.1,0,Clear,10.4,2021-09-05 02:00:00,2
43,20,63,81,19.8,0,Clear,11.2,2021-09-05 03:00:00,3
17,11,28,80,19.6,0,Clear,11.2,2021-09-05 04:00:00,4
15,24,39,80,19.5,1,Mostly Clear,11.2,2021-09-05 05:00:00,5
34,39,73,79,19.6,1,Mostly Clear,8.8,2021-09-05 06:00:00,6
45,84,129,78,19.8,2,Partly Cloudy,7.9,2021-09-05 07:00:00,7
104,148,252,78,20.4,2,Partly Cloudy,7.3,2021-09-05 08:00:00,8
275,224,499,74,21.6,2,Partly Cloudy,7.2,2021-09-05 09:00:00,9
383,263,646,72,22.5,2,Partly Cloudy,7.2,2021-09-05 10:00:00,10
450,327,777,69,23.3,2,Partly Cloudy,7.4,2021-09-05 11:00:00,11
473,361,834,69,24.0,2,Partly Cloudy,8.8,2021-09-05 12:00:00,12
480,330,810,70,24.6,61,Light Rain,10.2,2021-09-05 13:00:00,13
442,273,715,74,24.7,53,Heavy Drizzle,10.0,2021-09-05 14:00:00,14
354,242,596,81,23.7,55,Heavy Drizzle,8.1,2021-09-05 15:00:00,15
526,288,814,82,24.0,53,Heavy Drizzle,8.7,2021-09-05 16:00:00,16
523,315,838,84,23.9,51,Light Drizzle,7.6,2021-09-05 17:00:00,17
379,294,673,84,23.9,3,Cloudy,5.4,2021-09-05 18:00:00,18
344,234,578,84,23.8,3,Cloudy,3.9,2021-09-05 19:00:00,19
196,189,385,84,23.6,3,Cloudy,3.4,2021-09-05 20:00:00,20
174,130,304,85,23.4,3,Cloudy,4.4,2021-09-05 21:00:00,21
122,137,259,87,23.1,53,Heavy Drizzle,4.6,2021-09-05 22:00:00,22
143,87,230,92,22.6,55,Heavy Drizzle,4.7,2021-09-05 23:00:00,23
92,68,160,93,22.3,55,Heavy Drizzle,5.8,2021-09-06 00:00:00,0
63,40,103,94,22.1,53,Heavy Drizzle,7.4,2021-09-06 01:00:00,1
58,24,82,96,21.9,51,Light Drizzle,8.7,2021-09-06 02:00:00,2
17,14,31,95,21.7,3,Cloudy,9.0,2021-09-06 03:00:00,3
22,23,45,95,21.4,3,Cloudy,9.4,2021-09-06 04:00:00,4
19,22,41,95,21.0,2,Partly Cloudy,9.5,2021-09-06 05:00:00,5
39,48,87,95,20.6,0,Clear,9.0,2021-09-06 06:00:00,6
52,95,147,95,20.3,1,Mostly Clear,9.1,2021-09-06 07:00:00,7
121,191,312,93,20.9,1,Mostly Clear,9.3,2021-09-06 08:00:00,8
227,263,490,88,21.8,0,Clear,9.1,2021-09-06 09:00:00,9
387,318,705,77,23.5,0,Clear,9.7,2021-09-06 10:00:00,10
488,447,935,63,25.4,0,Clear,10.7,2021-09-06 11:00:00,11
567,406,973,49,26.7,0,Clear,12.0,2021-09-06 12:00:00,12
567,431,998,43,27.6,0,Clear,12.1,2021-09-06 13:00:00,13
551,407,958,41,28.1,0,Clear,13.8,2021-09-06 14:00:00,14
506,407,913,39,28.8,1,Mostly Clear,15.9,2021-09-06 15:00:00,15
485,435,920,39,28.5,1,Mostly Clear,16.7,2021-09-06 16:00:00,16
454,414,868,42,28.1,1,Mostly Clear,11.1,2021-09-06 17:00:00,17
396,405,801,49,27.3,0,Clear,9.7,2021-09-06 18:00:00,18
327,336,663,53,26.0,0,Clear,7.9,2021-09-06 19:00:00,19
218,223,441,58,24.3,0,Clear,8.1,2021-09-06 20:00:00,20
120,153,273,60,23.0,0,Clear,7.9,2021-09-06 21:00:00,21
102,105,207,64,22.0,0,Clear,8.0,2021-09-06 22:00:00,22
57,63,120,69,21.0,0,Clear,7.6,2021-09-06 23:00:00,23
36,33,69,76,19.9,0,Clear,6.8,2021-09-07 00:00:00,0
10,15,25,79,19.2,0,Clear,8.7,2021-09-07 01:00:00,1
15,17,32,79,19.1,0,Clear,8.4,2021-09-07 02:00:00,2
9,7,16,81,18.8,0,Clear,7.3,2021-09-07 03:00:00,3
15,13,28,84,18.3,0,Clear,7.2,2021-09-07 04:00:00,4
23,61,84,85,18.1,1,Mostly Clear,6.7,2021-09-07 05:00:00,5
40,150,190,83,18.5,1,Mostly Clear,6.2,2021-09-07 06:00:00,6
94,354,448,80,19.5,1,Mostly Clear,5.4,2021-09-07 07:00:00,7
120,550,670,85,19.8,1,Mostly Clear,2.9,2021-09-07 08:00:00,8
159,327,486,72,22.8,0,Clear,0.7,2021-09-07 09:00:00,9
173,213,386,64,24.7,0,Clear,1.5,2021-09-07 10:00:00,10
187,207,394,56,26.3,0,Clear,3.9,2021-09-07 11:00:00,11
194,309,503,50,27.5,0,Clear,6.0,2021-09-07 12:00:00,12
202,257,459,45,28.5,0,Clear,7.6,2021-09-07 13:00:00,13
228,256,484,43,28.8,1,Mostly Clear,9.8,2021-09-07 14:00:00,14
243,353,596,43,29.4,0,Clear,10.0,2021-09-07 15:00:00,15
277,451,728,43,29.5,0,Clear,8.7,2021-09-07 16:00:00,16
340,747,1087,43,29.2,0,Clear,8.3,2021-09-07 17:00:00,17
312,698,1010,48,28.1,0,Clear,10.9,2021-09-07 18:00:00,18
255,493,748,55,26.2,0,Clear,10.9,2021-09-07 19:00:00,19
172,320,492,61,24.7,0,Clear,11.5,2021-09-07 20:00:00,20
112,236,348,64,24.0,0,Clear,11.2,2021-09-07 21:00:00,21
65,125,190,66,23.5,0,Clear,11.2,2021-09-07 22:00:00,22
53,77,130,67,23.1,0,Clear,12.6,2021-09-07 23:00:00,23
27,36,63,66,22.7,0,Clear,13.7,2021-09-08 00:00:00,0
9,9,18,66,22.3,0,Clear,14.1,2021-09-08 01:00:00,1
8,4,12,69,21.9,0,Clear,13.9,2021-09-08 02:00:00,2
7,5,12,77,21.3,0,Clear,13.5,2021-09-08 03:00:00,3
10,11,21,81,21.0,0,Clear,12.4,2021-09-08 04:00:00,4
34,53,87,85,20.7,0,Clear,12.2,2021-09-08 05:00:00,5
53,172,225,89,20.5,0,Clear,12.5,2021-09-08 06:00:00,6
119,428,547,92,20.4,0,Clear,11.5,2021-09-08 07:00:00,7
166,585,751,91,21.4,0,Clear,10.6,2021-09-08 08:00:00,8
123,379,502,85,23.4,1,Mostly Clear,11.5,2021-09-08 09:00:00,9
131,241,372,75,25.5,0,Clear,11.8,2021-09-08 10:00:00,10
146,268,414,72,26.8,0,Clear,11.3,2021-09-08 11:00:00,11
138,293,431,67,28.2,1,Mostly Clear,11.9,2021-09-08 12:00:00,12
168,299,467,63,29.1,51,Light Drizzle,12.9,2021-09-08 13:00:00,13
147,287,434,60,29.8,2,Partly Cloudy,13.8,2021-09-08 14:00:00,14
168,349,517,55,29.7,1,Mostly Clear,14.7,2021-09-08 15:00:00,15
201,435,636,56,29.5,1,Mostly Clear,14.7,2021-09-08 16:00:00,16
358,702,1060,61,28.8,1,Mostly Clear,13.7,2021-09-08 17:00:00,17
368,703,1071,70,27.7,1,Mostly Clear,12.2,2021-09-08 18:00:00,18
300,554,854,76,26.3,1,Mostly Clear,11.4,2021-09-08 19:00:00,19
196,364,560,80,25.3,1,Mostly Clear,13.8,2021-09-08 20:00:00,20
127,251,378,84,24.6,1,Mostly Clear,12.7,2021-09-08 21:00:00,21
104,158,262,86,24.3,1,Mostly Clear,12.4,2021-09-08 22:00:00,22
113,127,240,89,23.8,2,Partly Cloudy,8.2,2021-09-08 23:00:00,23
32,49,81,91,23.4,51,Light Drizzle,5.9,2021-09-09 00:00:00,0
9,15,24,94,22.9,3,Cloudy,5.1,2021-09-09 01:00:00,1
9,6,15,91,22.3,53,Heavy Drizzle,4.3,2021-09-09 02:00:00,2
1,6,7,96,21.5,61,Light Rain,4.0,2021-09-09 03:00:00,3
11,13,24,96,21.3,53,Heavy Drizzle,4.0,2021-09-09 04:00:00,4
18,35,53,95,21.2,51,Light Drizzle,4.7,2021-09-09 05:00:00,5
43,143,186,95,21.1,3,Cloudy,5.7,2021-09-09 06:00:00,6
90,385,475,94,20.9,3,Cloudy,5.5,2021-09-09 07:00:00,7
143,488,631,93,20.8,3,Cloudy,4.4,2021-09-09 08:00:00,8
112,315,427,86,21.3,2,Partly Cloudy,5.0,2021-09-09 09:00:00,9
114,230,344,83,21.4,51,Light Drizzle,5.8,2021-09-09 10:00:00,10
136,245,381,82,21.3,53,Heavy Drizzle,6.7,2021-09-09 11:00:00,11
145,303,448,80,21.2,53,Heavy Drizzle,6.8,2021-09-09 12:00:00,12
156,273,429,80,20.9,51,Light Drizzle,7.0,2021-09-09 13:00:00,13
183,290,473,80,20.9,51,Light Drizzle,7.8,2021-09-09 14:00:00,14
203,337,540,61,24.7,2,Partly Cloudy,7.6,2021-09-09 15:00:00,15
210,475,685,58,24.8,2,Partly Cloudy,7.9,2021-09-09 16:00:00,16
353,740,1093,60,24.2,1,Mostly Clear,7.2,2021-09-09 17:00:00,17
348,727,1075,64,23.8,1,Mostly Clear,4.0,2021-09-09 18:00:00,18
315,549,864,65,23.1,0,Clear,5.4,2021-09-09 19:00:00,19
171,393,564,65,21.9,1,Mostly Clear,9.2,2021-09-09 20:00:00,20
150,256,406,61,21.2,1,Mostly Clear,8.9,2021-09-09 21:00:00,21
126,166,292,63,20.4,0,Clear,12.0,2021-09-09 22:00:00,22
96,135,231,67,19.8,0,Clear,13.0,2021-09-09 23:00:00,23
87,85,172,70,19.3,0,Clear,13.4,2021-09-10 00:00:00,0
41,46,87,71,18.8,0,Clear,13.8,2021-09-10 01:00:00,1
18,19,37,72,18.3,0,Clear,14.0,2021-09-10 02:00:00,2
14,13,27,73,18.0,0,Clear,14.1,2021-09-10 03:00:00,3
15,22,37,73,17.6,0,Clear,14.4,2021-09-10 04:00:00,4
23,52,75,74,17.2,0,Clear,14.8,2021-09-10 05:00:00,5
50,137,187,75,16.8,0,Clear,13.6,2021-09-10 06:00:00,6
93,353,446,77,16.5,0,Clear,13.9,2021-09-10 07:00:00,7
145,545,690,78,16.9,0,Clear,13.3,2021-09-10 08:00:00,8
145,360,505,73,18.2,0,Clear,16.1,2021-09-10 09:00:00,9
182,260,442,67,19.7,0,Clear,17.2,2021-09-10 10:00:00,10
209,310,519,60,21.2,1,Mostly Clear,17.7,2021-09-10 11:00:00,11
227,358,585,53,22.5,1,Mostly Clear,17.7,2021-09-10 12:00:00,12
282,362,644,48,23.5,2,Partly Cloudy,18.4,2021-09-10 13:00:00,13
268,359,627,45,24.2,2,Partly Cloudy,17.8,2021-09-10 14:00:00,14
347,414,761,43,24.3,1,Mostly Clear,16.1,2021-09-10 15:00:00,15
314,557,871,43,24.2,1,Mostly Clear,15.0,2021-09-10 16:00:00,16
504,797,1301,42,24.2,1,Mostly Clear,13.0,2021-09-10 17:00:00,17
425,624,1049,47,23.6,0,Clear,8.7,2021-09-10 18:00:00,18
339,460,799,61,22.4,0,Clear,4.6,2021-09-10 19:00:00,19
251,383,634,64,21.0,0,Clear,4.7,2021-09-10 20:00:00,20
175,250,425,69,19.5,0,Clear,4.9,2021-09-10 21:00:00,21
205,209,414,73,18.1,0,Clear,5.4,2021-09-10 22:00:00,22
158,175,333,76,17.1,0,Clear,6.2,2021-09-10 23:00:00,23
148,123,271,79,16.3,0,Clear,6.8,2021-09-11 00:00:00,0
99,115,214,80,15.8,0,Clear,6.8,2021-09-11 01:00:00,1
96,67,163,80,15.7,0,Clear,6.5,2021-09-11 02:00:00,2
39,21,60,84,14.9,0,Clear,6.1,2021-09-11 03:00:00,3
13,10,23,85,14.7,0,Clear,6.4,2021-09-11 04:00:00,4
18,26,44,86,14.5,0,Clear,6.4,2021-09-11 05:00:00,5
33,60,93,88,14.1,0,Clear,4.7,2021-09-11 06:00:00,6
61,119,180,89,13.9,0,Clear,5.1,2021-09-11 07:00:00,7
123,221,344,88,15.7,0,Clear,5.2,2021-09-11 08:00:00,8
249,360,609,72,19.6,0,Clear,3.2,2021-09-11 09:00:00,9
321,452,773,61,22.2,0,Clear,4.1,2021-09-11 10:00:00,10
470,470,940,51,23.8,0,Clear,6.9,2021-09-11 11:00:00,11
508,532,1040,46,24.9,1,Mostly Clear,9.2,2021-09-11 12:00:00,12
543,485,1028,43,25.5,3,Cloudy,10.9,2021-09-11 13:00:00,13
579,479,1058,43,25.3,3,Cloudy,11.0,2021-09-11 14:00:00,14
536,483,1019,47,25.4,3,Cloudy,11.0,2021-09-11 15:00:00,15
520,469,989,50,25.1,3,Cloudy,11.4,2021-09-11 16:00:00,16
528,428,956,53,24.8,2,Partly Cloudy,10.1,2021-09-11 17:00:00,17
430,433,863,57,24.4,1,Mostly Clear,10.2,2021-09-11 18:00:00,18
307,362,669,63,23.1,0,Clear,9.4,2021-09-11 19:00:00,19
235,292,527,69,21.8,0,Clear,10.2,2021-09-11 20:00:00,20
215,207,422,72,21.0,0,Clear,11.7,2021-09-11 21:00:00,21
201,185,386,74,20.6,0,Clear,12.6,2021-09-11 22:00:00,22
183,190,373,75,20.2,0,Clear,13.3,2021-09-11 23:00:00,23
175,150,325,75,20.0,0,Clear,13.9,2021-09-12 00:00:00,0
93,118,211,75,19.8,0,Clear,13.1,2021-09-12 01:00:00,1
113,78,191,74,19.6,1,Mostly Clear,12.6,2021-09-12 02:00:00,2
35,32,67,79,19.0,0,Clear,11.9,2021-09-12 03:00:00,3
19,15,34,80,18.7,0,Clear,10.9,2021-09-12 04:00:00,4
13,37,50,81,18.3,0,Clear,10.1,2021-09-12 05:00:00,5
76,94,170,83,18.0,1,Mostly Clear,6.0,2021-09-12 06:00:00,6
73,100,173,85,17.7,0,Clear,9.0,2021-09-12 07:00:00,7
106,178,284,83,18.6,0,Clear,10.2,2021-09-12 08:00:00,8
281,311,592,74,20.8,0,Clear,9.3,2021-09-12 09:00:00,9
346,398,744,67,23.0,0,Clear,9.8,2021-09-12 10:00:00,10
452,446,898,61,25.2,0,Clear,10.4,2021-09-12 11:00:00,11
511,462,973,55,27.2,0,Clear,11.9,2021-09-12 12:00:00,12
401,467,868,50,28.8,0,Clear,13.3,2021-09-12 13:00:00,13
468,400,868,47,29.9,0,Clear,14.3,2021-09-12 14:00:00,14
426,421,847,45,30.7,0,Clear,15.0,2021-09-12 15:00:00,15
405,412,817,44,30.9,0,Clear,15.1,2021-09-12 16:00:00,16
413,421,834,46,30.7,0,Clear,14.6,2021-09-12 17:00:00,17
311,387,698,51,29.6,0,Clear,12.1,2021-09-12 18:00:00,18
247,374,621,56,27.6,0,Clear,11.9,2021-09-12 19:00:00,19
138,224,362,60,26.3,0,Clear,13.6,2021-09-12 20:00:00,20
130,164,294,63,25.4,0,Clear,13.5,2021-09-12 21:00:00,21
99,102,201,65,24.8,0,Clear,13.2,2021-09-12 22:00:00,22
77,68,145,67,24.2,0,Clear,12.7,2021-09-12 23:00:00,23
22,24,46,69,23.5,0,Clear,12.2,2021-09-13 00:00:00,0
13,17,30,73,22.8,0,Clear,11.0,2021-09-13 01:00:00,1
8,10,18,75,22.2,0,Clear,9.0,2021-09-13 02:00:00,2
5,7,12,82,21.7,1,Mostly Clear,7.6,2021-09-13 03:00:00,3
13,14,27,85,21.1,1,Mostly Clear,8.1,2021-09-13 04:00:00,4
30,54,84,85,20.9,1,Mostly Clear,9.4,2021-09-13 05:00:00,5
51,145,196,85,20.7,0,Clear,6.9,2021-09-13 06:00:00,6
103,361,464,86,20.4,0,Clear,7.5,2021-09-13 07:00:00,7
127,522,649,84,21.6,0,Clear,9.9,2021-09-13 08:00:00,8
140,319,459,72,24.7,0,Clear,8.4,2021-09-13 09:00:00,9
143,187,330,64,26.9,0,Clear,11.2,2021-09-13 10:00:00,10
160,220,380,60,28.3,0,Clear,13.7,2021-09-13 11:00:00,11
186,295,481,57,29.6,0,Clear,9.2,2021-09-13 12:00:00,12
145,276,421,55,30.7,1,Mostly Clear,10.1,2021-09-13 13:00:00,13
176,300,476,52,31.6,2,Partly Cloudy,12.8,2021-09-13 14:00:00,14
172,306,478,53,31.5,2,Partly Cloudy,10.5,2021-09-13 15:00:00,15
226,404,630,52,31.6,1,Mostly Clear,9.0,2021-09-13 16:00:00,16
292,723,1015,54,31.3,0,Clear,7.9,2021-09-13 17:00:00,17
326,657,983,57,30.7,0,Clear,6.5,2021-09-13 18:00:00,18
267,542,809,62,29.3,0,Clear,5.6,2021-09-13 19:00:00,19
142,286,428,79,27.1,0,Clear,5.1,2021-09-13 20:00:00,20
107,272,379,84,25.7,0,Clear,3.4,2021-09-13 21:00:00,21
98,155,253,86,24.9,0,Clear,2.5,2021-09-13 22:00:00,22
42,58,100,88,24.3,0,Clear,4.0,2021-09-13 23:00:00,23
20,20,40,89,23.7,0,Clear,5.8,2021-09-14 00:00:00,0
11,10,21,83,24.7,0,Clear,5.1,2021-09-14 01:00:00,1
6,8,14,84,24.5,1,Mostly Clear,5.0,2021-09-14 02:00:00,2
3,10,13,93,21.8,2,Partly Cloudy,4.1,2021-09-14 03:00:00,3
12,14,26,94,21.7,1,Mostly Clear,4.0,2021-09-14 04:00:00,4
33,58,91,94,21.4,1,Mostly Clear,4.6,2021-09-14 05:00:00,5
55,133,188,93,21.4,1,Mostly Clear,2.6,2021-09-14 06:00:00,6
104,393,497,96,20.8,1,Mostly Clear,3.6,2021-09-14 07:00:00,7
155,588,743,93,22.3,1,Mostly Clear,4.3,2021-09-14 08:00:00,8
129,354,483,80,25.3,1,Mostly Clear,1.5,2021-09-14 09:00:00,9
108,236,344,71,27.4,1,Mostly Clear,1.8,2021-09-14 10:00:00,10
127,276,403,64,29.0,1,Mostly Clear,2.2,2021-09-14 11:00:00,11
152,320,472,60,30.1,1,Mostly Clear,5.5,2021-09-14 12:00:00,12
176,303,479,57,30.8,1,Mostly Clear,7.6,2021-09-14 13:00:00,13
182,257,439,58,30.7,51,Light Drizzle,8.8,2021-09-14 14:00:00,14
180,317,497,55,30.9,3,Cloudy,9.7,2021-09-14 15:00:00,15
219,443,662,54,31.0,3,Cloudy,10.0,2021-09-14 16:00:00,16
337,755,1092,57,30.5,3,Cloudy,10.8,2021-09-14 17:00:00,17
358,754,1112,63,29.6,2,Partly Cloudy,10.0,2021-09-14 18:00:00,18
251,580,831,70,28.1,1,Mostly Clear,9.3,2021-09-14 19:00:00,19
172,364,536,77,26.8,1,Mostly Clear,10.0,2021-09-14 20:00:00,20
145,263,408,81,26.0,0,Clear,10.8,2021-09-14 21:00:00,21
127,176,303,83,25.4,1,Mostly Clear,11.6,2021-09-14 22:00:00,22
83,100,183,84,25.1,1,Mostly Clear,11.7,2021-09-14 23:00:00,23
33,23,56,81,24.9,1,Mostly Clear,12.2,2021-09-15 00:00:00,0
9,15,24,78,24.8,1,Mostly Clear,11.6,2021-09-15 01:00:00,1
4,17,21,77,24.5,0,Clear,11.8,2021-09-15 02:00:00,2
3,6,9,79,24.0,1,Mostly Clear,11.3,2021-09-15 03:00:00,3
5,15,20,80,23.5,1,Mostly Clear,10.8,2021-09-15 04:00:00,4
24,45,69,82,23.1,0,Clear,11.4,2021-09-15 05:00:00,5
66,180,246,83,22.7,0,Clear,9.4,2021-09-15 06:00:00,6
108,419,527,84,22.4,0,Clear,8.3,2021-09-15 07:00:00,7
179,624,803,83,22.9,0,Clear,10.0,2021-09-15 08:00:00,8
117,374,491,76,24.7,0,Clear,10.6,2021-09-15 09:00:00,9
123,273,396,68,26.5,0,Clear,10.5,2021-09-15 10:00:00,10
151,276,427,61,28.4,1,Mostly Clear,11.3,2021-09-15 11:00:00,11
147,290,437,55,29.8,2,Partly Cloudy,15.1,2021-09-15 12:00:00,12
133,269,402,48,31.0,1,Mostly Clear,16.8,2021-09-15 13:00:00,13
162,307,469,44,31.7,1,Mostly Clear,16.6,2021-09-15 14:00:00,14
178,368,546,44,31.7,1,Mostly Clear,16.9,2021-09-15 15:00:00,15
210,444,654,43,31.7,1,Mostly Clear,16.5,2021-09-15 16:00:00,16
373,771,1144,44,31.3,1,Mostly Clear,14.3,2021-09-15 17:00:00,17
378,732,1110,50,30.0,2,Partly Cloudy,10.9,2021-09-15 18:00:00,18
305,577,882,58,28.4,1,Mostly Clear,8.7,2021-09-15 19:00:00,19
193,335,528,65,27.2,1,Mostly Clear,8.8,2021-09-15 20:00:00,20
179,267,446,72,26.1,1,Mostly Clear,3.6,2021-09-15 21:00:00,21
110,187,297,74,25.6,51,Light Drizzle,5.6,2021-09-15 22:00:00,22
64,100,164,76,25.1,2,Partly Cloudy,6.8,2021-09-15 23:00:00,23
39,40,79,78,24.6,1,Mostly Clear,5.6,2021-09-16 00:00:00,0
23,25,48,80,24.3,1,Mostly Clear,1.5,2021-09-16 01:00:00,1
8,11,19,86,23.6,2,Partly Cloudy,2.4,2021-09-16 02:00:00,2
6,10,16,94,21.9,51,Light Drizzle,2.9,2021-09-16 03:00:00,3
8,21,29,94,21.7,2,Partly Cloudy,5.8,2021-09-16 04:00:00,4
20,55,75,95,21.4,1,Mostly Clear,5.6,2021-09-16 05:00:00,5
48,140,188,95,21.2,1,Mostly Clear,7.8,2021-09-16 06:00:00,6
114,380,494,96,21.0,1,Mostly Clear,7.9,2021-09-16 07:00:00,7
146,566,712,96,21.6,2,Partly Cloudy,9.7,2021-09-16 08:00:00,8
123,374,497,90,23.0,3,Cloudy,8.7,2021-09-16 09:00:00,9
160,269,429,83,24.4,3,Cloudy,7.8,2021-09-16 10:00:00,10
156,257,413,76,25.8,3,Cloudy,6.6,2021-09-16 11:00:00,11
221,354,575,73,26.9,2,Partly Cloudy,8.5,2021-09-16 12:00:00,12
203,296,499,72,27.5,2,Partly Cloudy,9.4,2021-09-16 13:00:00,13
162,183,345,71,28.2,3,Cloudy,8.9,2021-09-16 14:00:00,14
86,126,212,67,28.5,51,Light Drizzle,8.7,2021-09-16 15:00:00,15
94,204,298,67,28.3,53,Heavy Drizzle,9.0,2021-09-16 16:00:00,16
64,185,249,78,25.8,63,Rain,9.7,2021-09-16 17:00:00,17
68,172,240,88,24.0,63,Rain,7.7,2021-09-16 18:00:00,18
45,146,191,92,23.3,53,Heavy Drizzle,5.1,2021-09-16 19:00:00,19
45,156,201,94,23.0,3,Cloudy,8.4,2021-09-16 20:00:00,20
70,163,233,96,22.8,3,Cloudy,7.4,2021-09-16 21:00:00,21
90,153,243,96,22.7,3,Cloudy,6.6,2021-09-16 22:00:00,22
62,85,147,96,22.8,3,Cloudy,8.2,2021-09-16 23:00:00,23
59,44,103,95,22.9,3,Cloudy,8.9,2021-09-17 00:00:00,0
27,34,61,96,22.8,3,Cloudy,9.5,2021-09-17 01:00:00,1
21,24,45,97,22.8,3,Cloudy,10.2,2021-09-17 02:00:00,2
19,17,36,97,22.6,3,Cloudy,9.9,2021-09-17 03:00:00,3
10,12,22,98,22.5,3,Cloudy,10.7,2021-09-17 04:00:00,4
27,47,74,98,22.4,3,Cloudy,9.2,2021-09-17 05:00:00,5
51,124,175,98,22.3,3,Cloudy,8.9,2021-09-17 06:00:00,6
87,298,385,97,22.2,3,Cloudy,10.3,2021-09-17 07:00:00,7
128,432,560,97,22.3,3,Cloudy,9.8,2021-09-17 08:00:00,8
113,248,361,96,22.8,3,Cloudy,10.0,2021-09-17 09:00:00,9
94,156,250,92,23.7,3,Cloudy,8.4,2021-09-17 10:00:00,10
126,268,394,89,24.5,3,Cloudy,10.1,2021-09-17 11:00:00,11
221,302,523,83,25.9,3,Cloudy,9.4,2021-09-17 12:00:00,12
233,318,551,78,26.9,3,Cloudy,8.2,2021-09-17 13:00:00,13
260,400,660,69,27.2,53,Heavy Drizzle,7.2,2021-09-17 14:00:00,14
291,383,674,90,24.4,51,Light Drizzle,6.9,2021-09-17 15:00:00,15
312,511,823,86,25.6,51,Light Drizzle,7.0,2021-09-17 16:00:00,16
390,622,1012,79,25.8,51,Light Drizzle,6.9,2021-09-17 17:00:00,17
356,601,957,83,24.2,55,Heavy Drizzle,5.2,2021-09-17 18:00:00,18
301,456,757,90,23.1,51,Light Drizzle,7.3,2021-09-17 19:00:00,19
201,298,499,93,22.7,2,Partly Cloudy,6.2,2021-09-17 20:00:00,20
170,207,377,94,22.4,1,Mostly Clear,6.1,2021-09-17 21:00:00,21
175,232,407,95,22.1,1,Mostly Clear,5.2,2021-09-17 22:00:00,22
177,167,344,96,21.7,0,Clear,4.0,2021-09-17 23:00:00,23
114,118,232,97,21.3,0,Clear,3.6,2021-09-18 00:00:00,0
96,106,202,97,21.1,1,Mostly Clear,3.4,2021-09-18 01:00:00,1
100,76,176,98,20.8,1,Mostly Clear,4.5,2021-09-18 02:00:00,2
47,48,95,99,21.0,1,Mostly Clear,4.7,2021-09-18 03:00:00,3
19,16,35,99,20.9,2,Partly Cloudy,4.6,2021-09-18 04:00:00,4
13,19,32,99,20.9,3,Cloudy,4.1,2021-09-18 05:00:00,5
38,62,100,99,20.8,3,Cloudy,1.8,2021-09-18 06:00:00,6
50,122,172,99,20.6,3,Cloudy,1.8,2021-09-18 07:00:00,7
96,231,327,98,21.3,3,Cloudy,1.8,2021-09-18 08:00:00,8
217,322,539,96,22.1,3,Cloudy,2.9,2021-09-18 09:00:00,9
354,334,688,88,23.8,3,Cloudy,1.8,2021-09-18 10:00:00,10
426,489,915,84,25.1,3,Cloudy,2.6,2021-09-18 11:00:00,11
497,495,992,75,26.2,51,Light Drizzle,2.0,2021-09-18 12:00:00,12
475,515,990,67,27.7,51,Light Drizzle,3.6,2021-09-18 13:00:00,13
506,487,993,62,28.5,3,Cloudy,4.8,2021-09-18 14:00:00,14
530,508,1038,70,28.5,1,Mostly Clear,4.1,2021-09-18 15:00:00,15
414,444,858,67,28.7,1,Mostly Clear,4.4,2021-09-18 16:00:00,16
418,391,809,65,28.8,0,Clear,5.6,2021-09-18 17:00:00,17
377,421,798,66,28.3,51,Light Drizzle,5.1,2021-09-18 18:00:00,18
416,429,845,75,27.3,1,Mostly Clear,0.5,2021-09-18 19:00:00,19
277,273,550,78,26.2,0,Clear,2.1,2021-09-18 20:00:00,20
187,221,408,85,24.8,0,Clear,2.9,2021-09-18 21:00:00,21
171,188,359,88,24.1,0,Clear,3.5,2021-09-18 22:00:00,22
239,194,433,91,23.3,0,Clear,4.6,2021-09-18 23:00:00,23
127,121,248,93,22.9,0,Clear,5.2,2021-09-19 00:00:00,0
125,114,239,91,22.8,0,Clear,5.4,2021-09-19 01:00:00,1
97,66,163,90,22.5,0,Clear,7.4,2021-09-19 02:00:00,2
48,51,99,91,22.0,0,Clear,9.0,2021-09-19 03:00:00,3
15,26,41,87,21.7,0,Clear,10.4,2021-09-19 04:00:00,4
12,23,35,84,21.3,0,Clear,10.7,2021-09-19 05:00:00,5
55,48,103,83,20.8,0,Clear,9.4,2021-09-19 06:00:00,6
84,102,186,84,20.3,0,Clear,10.0,2021-09-19 07:00:00,7
111,190,301,83,20.5,0,Clear,9.8,2021-09-19 08:00:00,8
258,258,516,74,21.8,0,Clear,10.2,2021-09-19 09:00:00,9
353,430,783,64,23.2,0,Clear,9.9,2021-09-19 10:00:00,10
431,416,847,54,24.6,2,Partly Cloudy,9.7,2021-09-19 11:00:00,11
543,492,1035,48,25.8,3,Cloudy,8.2,2021-09-19 12:00:00,12
455,410,865,45,26.7,2,Partly Cloudy,6.7,2021-09-19 13:00:00,13
452,375,827,44,27.3,2,Partly Cloudy,5.9,2021-09-19 14:00:00,14
446,448,894,53,27.1,0,Clear,5.8,2021-09-19 15:00:00,15
483,492,975,50,27.4,0,Clear,6.1,2021-09-19 16:00:00,16
397,468,865,48,27.1,0,Clear,7.9,2021-09-19 17:00:00,17
334,441,775,51,26.1,0,Clear,6.4,2021-09-19 18:00:00,18
245,375,620,57,24.4,0,Clear,6.8,2021-09-19 19:00:00,19
173,226,399,63,22.8,0,Clear,6.9,2021-09-19 20:00:00,20
108,151,259,67,21.8,0,Clear,6.6,2021-09-19 21:00:00,21
103,93,196,70,20.8,0,Clear,6.9,2021-09-19 22:00:00,22
58,67,125,73,19.9,0,Clear,6.8,2021-09-19 23:00:00,23
38,31,69,77,19.2,0,Clear,6.7,2021-09-20 00:00:00,0
19,15,34,82,18.5,0,Clear,7.8,2021-09-20 01:00:00,1
10,13,23,87,17.9,1,Mostly Clear,7.7,2021-09-20 02:00:00,2
4,7,11,91,17.5,1,Mostly Clear,7.4,2021-09-20 03:00:00,3
14,15,29,94,17.1,1,Mostly Clear,6.9,2021-09-20 04:00:00,4
23,50,73,95,17.0,1,Mostly Clear,5.8,2021-09-20 05:00:00,5
55,170,225,95,16.9,0,Clear,5.5,2021-09-20 06:00:00,6
89,407,496,96,16.7,1,Mostly Clear,5.4,2021-09-20 07:00:00,7
160,531,691,94,17.9,1,Mostly Clear,6.1,2021-09-20 08:00:00,8
138,370,508,79,21.1,1,Mostly Clear,6.9,2021-09-20 09:00:00,9
152,243,395,69,22.3,0,Clear,8.9,2021-09-20 10:00:00,10
166,249,415,64,23.2,1,Mostly Clear,10.0,2021-09-20 11:00:00,11
201,306,507,59,24.3,1,Mostly Clear,10.7,2021-09-20 12:00:00,12
199,294,493,56,25.0,2,Partly Cloudy,12.1,2021-09-20 13:00:00,13
209,260,469,54,25.3,1,Mostly Clear,13.0,2021-09-20 14:00:00,14
217,358,575,53,25.5,2,Partly Cloudy,12.8,2021-09-20 15:00:00,15
256,432,688,53,25.3,1,Mostly Clear,13.1,2021-09-20 16:00:00,16
359,717,1076,54,24.7,1,Mostly Clear,12.8,2021-09-20 17:00:00,17
364,773,1137,55,24.0,2,Partly Cloudy,10.0,2021-09-20 18:00:00,18
215,521,736,59,22.8,2,Partly Cloudy,10.4,2021-09-20 19:00:00,19
179,326,505,64,21.7,2,Partly Cloudy,11.4,2021-09-20 20:00:00,20
109,242,351,69,21.0,1,Mostly Clear,11.7,2021-09-20 21:00:00,21
98,124,222,73,20.3,1,Mostly Clear,12.3,2021-09-20 22:00:00,22
50,65,115,76,19.8,1,Mostly Clear,11.4,2021-09-20 23:00:00,23
24,26,50,80,19.3,1,Mostly Clear,10.5,2021-09-21 00:00:00,0
13,16,29,83,18.9,1,Mostly Clear,10.1,2021-09-21 01:00:00,1
11,18,29,87,18.4,1,Mostly Clear,9.2,2021-09-21 02:00:00,2
3,12,15,90,18.3,1,Mostly Clear,8.3,2021-09-21 03:00:00,3
6,11,17,91,18.2,1,Mostly Clear,7.6,2021-09-21 04:00:00,4
18,67,85,92,18.5,2,Partly Cloudy,7.9,2021-09-21 05:00:00,5
55,165,220,91,19.0,2,Partly Cloudy,9.0,2021-09-21 06:00:00,6
99,430,529,90,19.6,2,Partly Cloudy,8.5,2021-09-21 07:00:00,7
157,620,777,89,20.4,1,Mostly Clear,9.4,2021-09-21 08:00:00,8
121,401,522,85,21.6,2,Partly Cloudy,11.6,2021-09-21 09:00:00,9
114,246,360,78,23.0,3,Cloudy,14.0,2021-09-21 10:00:00,10
140,320,460,72,24.1,3,Cloudy,12.7,2021-09-21 11:00:00,11
146,351,497,66,25.3,3,Cloudy,12.3,2021-09-21 12:00:00,12
170,302,472,63,25.9,3,Cloudy,12.8,2021-09-21 13:00:00,13
181,273,454,60,26.5,3,Cloudy,12.9,2021-09-21 14:00:00,14
194,336,530,61,26.4,51,Light Drizzle,13.2,2021-09-21 15:00:00,15
219,512,731,61,26.2,3,Cloudy,12.5,2021-09-21 16:00:00,16
372,790,1162,62,25.8,3,Cloudy,9.4,2021-09-21 17:00:00,17
338,763,1101,65,25.3,2,Partly Cloudy,8.7,2021-09-21 18:00:00,18
263,555,818,67,24.3,2,Partly Cloudy,7.2,2021-09-21 19:00:00,19
193,370,563,71,23.6,2,Partly Cloudy,9.4,2021-09-21 20:00:00,20
147,243,390,75,23.1,3,Cloudy,11.4,2021-09-21 21:00:00,21
102,203,305,79,22.7,3,Cloudy,11.4,2021-09-21 22:00:00,22
50,84,134,83,22.4,3,Cloudy,10.0,2021-09-21 23:00:00,23
16,32,48,87,22.2,3,Cloudy,8.7,2021-09-22 00:00:00,0
15,16,31,90,22.1,51,Light Drizzle,9.7,2021-09-22 01:00:00,1
10,14,24,92,22.2,2,Partly Cloudy,10.3,2021-09-22 02:00:00,2
6,8,14,94,21.8,3,Cloudy,10.7,2021-09-22 03:00:00,3
11,10,21,94,22.1,51,Light Drizzle,12.2,2021-09-22 04:00:00,4
21,55,76,95,22.2,3,Cloudy,15.0,2021-09-22 05:00:00,5
53,157,210,94,22.4,3,Cloudy,11.3,2021-09-22 06:00:00,6
66,347,413,93,22.5,3,Cloudy,12.0,2021-09-22 07:00:00,7
159,533,692,92,22.7,2,Partly Cloudy,14.5,2021-09-22 08:00:00,8
93,325,418,91,23.1,51,Light Drizzle,14.8,2021-09-22 09:00:00,9
61,190,251,91,23.4,53,Heavy Drizzle,17.3,2021-09-22 10:00:00,10
86,237,323,93,23.4,51,Light Drizzle,19.2,2021-09-22 11:00:00,11
86,208,294,94,23.5,53,Heavy Drizzle,17.7,2021-09-22 12:00:00,12
131,270,401,91,24.2,53,Heavy Drizzle,16.6,2021-09-22 13:00:00,13
91,224,315,89,23.6,53,Heavy Drizzle,17.3,2021-09-22 14:00:00,14
71,205,276,91,24.6,63,Rain,17.8,2021-09-22 15:00:00,15
70,302,372,93,24.2,61,Light Rain,19.1,2021-09-22 16:00:00,16
59,224,283,93,23.8,61,Light Rain,23.1,2021-09-22 17:00:00,17
75,321,396,94,23.5,51,Light Drizzle,20.3,2021-09-22 18:00:00,18
76,293,369,95,23.2,53,Heavy Drizzle,20.1,2021-09-22 19:00:00,19
73,232,305,95,23.0,55,Heavy Drizzle,19.5,2021-09-22 20:00:00,20
59,210,269,96,22.9,55,Heavy Drizzle,17.4,2021-09-22 21:00:00,21
58,143,201,95,22.8,53,Heavy Drizzle,17.5,2021-09-22 22:00:00,22
52,78,130,95,22.8,53,Heavy Drizzle,18.5,2021-09-22 23:00:00,23
26,27,53,95,22.7,55,Heavy Drizzle,18.8,2021-09-23 00:00:00,0
5,9,14,94,22.8,51,Light Drizzle,20.0,2021-09-23 01:00:00,1
3,14,17,94,22.8,51,Light Drizzle,21.1,2021-09-23 02:00:00,2
0,2,2,95,22.7,63,Rain,20.9,2021-09-23 03:00:00,3
6,10,16,95,22.8,61,Light Rain,19.7,2021-09-23 04:00:00,4
16,27,43,96,22.6,53,Heavy Drizzle,20.4,2021-09-23 05:00:00,5
8,48,56,96,22.4,53,Heavy Drizzle,16.6,2021-09-23 06:00:00,6
15,74,89,94,22.5,55,Heavy Drizzle,14.2,2021-09-23 07:00:00,7
38,143,181,97,22.0,63,Rain,12.6,2021-09-23 08:00:00,8
49,243,292,99,20.7,63,Rain,16.3,2021-09-23 09:00:00,9
64,218,282,92,18.7,63,Rain,11.6,2021-09-23 10:00:00,10
116,265,381,90,17.6,63,Rain,9.3,2021-09-23 11:00:00,11
113,307,420,87,17.7,61,Light Rain,9.1,2021-09-23 12:00:00,12
157,295,452,81,18.8,51,Light Drizzle,7.2,2021-09-23 13:00:00,13
164,345,509,76,19.7,1,Mostly Clear,7.6,2021-09-23 14:00:00,14
202,358,560,57,23.2,2,Partly Cloudy,8.1,2021-09-23 15:00:00,15
274,473,747,54,23.6,2,Partly Cloudy,8.8,2021-09-23 16:00:00,16
331,747,1078,52,23.8,1,Mostly Clear,6.5,2021-09-23 17:00:00,17
374,715,1089,57,23.3,2,Partly Cloudy,10.7,2021-09-23 18:00:00,18
258,551,809,67,22.0,1,Mostly Clear,14.5,2021-09-23 19:00:00,19
171,336,507,60,21.0,3,Cloudy,14.8,2021-09-23 20:00:00,20
109,301,410,53,19.9,3,Cloudy,12.4,2021-09-23 21:00:00,21
107,176,283,49,18.9,3,Cloudy,8.6,2021-09-23 22:00:00,22
109,142,251,49,18.3,3,Cloudy,6.4,2021-09-23 23:00:00,23
87,90,177,52,17.6,3,Cloudy,6.3,2021-09-24 00:00:00,0
39,65,104,55,16.9,3,Cloudy,5.5,2021-09-24 01:00:00,1
31,35,66,56,16.7,1,Mostly Clear,4.2,2021-09-24 02:00:00,2
10,12,22,67,15.7,1,Mostly Clear,5.2,2021-09-24 03:00:00,3
15,13,28,75,14.6,0,Clear,5.1,2021-09-24 04:00:00,4
33,55,88,79,13.8,0,Clear,5.4,2021-09-24 05:00:00,5
34,145,179,81,13.2,0,Clear,6.0,2021-09-24 06:00:00,6
85,343,428,83,12.6,0,Clear,6.6,2021-09-24 07:00:00,7
142,535,677,84,13.4,0,Clear,7.9,2021-09-24 08:00:00,8
137,400,537,66,17.1,0,Clear,5.7,2021-09-24 09:00:00,9
192,277,469,55,19.2,0,Clear,7.9,2021-09-24 10:00:00,10
212,312,524,48,20.4,0,Clear,10.8,2021-09-24 11:00:00,11
247,415,662,44,21.3,0,Clear,11.0,2021-09-24 12:00:00,12
250,328,578,41,22.0,0,Clear,9.4,2021-09-24 13:00:00,13
325,383,708,40,22.6,0,Clear,8.6,2021-09-24 14:00:00,14
349,457,806,39,22.7,0,Clear,8.1,2021-09-24 15:00:00,15
355,554,909,39,22.8,0,Clear,7.3,2021-09-24 16:00:00,16
478,755,1233,40,22.5,0,Clear,6.5,2021-09-24 17:00:00,17
451,764,1215,47,21.8,0,Clear,5.1,2021-09-24 18:00:00,18
373,521,894,59,20.4,0,Clear,4.4,2021-09-24 19:00:00,19
221,323,544,57,20.1,0,Clear,3.4,2021-09-24 20:00:00,20
176,224,400,61,19.6,0,Clear,1.5,2021-09-24 21:00:00,21
144,202,346,64,19.1,0,Clear,1.8,2021-09-24 22:00:00,22
143,161,304,68,18.6,0,Clear,4.0,2021-09-24 23:00:00,23
120,120,240,73,18.1,0,Clear,5.1,2021-09-25 00:00:00,0
96,106,202,78,17.7,0,Clear,3.9,2021-09-25 01:00:00,1
95,64,159,81,17.2,0,Clear,2.6,2021-09-25 02:00:00,2
40,33,73,82,16.0,0,Clear,3.3,2021-09-25 03:00:00,3
15,17,32,91,13.9,0,Clear,4.6,2021-09-25 04:00:00,4
20,27,47,93,13.4,0,Clear,5.1,2021-09-25 05:00:00,5
34,58,92,94,13.7,0,Clear,4.0,2021-09-25 06:00:00,6
64,119,183,95,13.4,0,Clear,3.4,2021-09-25 07:00:00,7
107,203,310,96,13.7,0,Clear,3.1,2021-09-25 08:00:00,8
253,371,624,76,17.3,0,Clear,1.8,2021-09-25 09:00:00,9
393,416,809,60,19.9,0,Clear,3.1,2021-09-25 10:00:00,10
533,486,1019,50,21.6,0,Clear,4.7,2021-09-25 11:00:00,11
593,524,1117,46,22.6,1,Mostly Clear,5.2,2021-09-25 12:00:00,12
651,491,1142,45,23.2,1,Mostly Clear,5.4,2021-09-25 13:00:00,13
697,480,1177,44,23.6,1,Mostly Clear,5.6,2021-09-25 14:00:00,14
628,501,1129,44,23.6,1,Mostly Clear,5.6,2021-09-25 15:00:00,15
598,490,1088,44,23.5,1,Mostly Clear,5.4,2021-09-25 16:00:00,16
564,491,1055,46,23.2,1,Mostly Clear,4.8,2021-09-25 17:00:00,17
410,461,871,54,22.3,1,Mostly Clear,5.2,2021-09-25 18:00:00,18
348,402,750,60,21.1,1,Mostly Clear,4.4,2021-09-25 19:00:00,19
217,243,460,66,19.6,0,Clear,5.8,2021-09-25 20:00:00,20
195,284,479,73,18.4,0,Clear,6.7,2021-09-25 21:00:00,21
189,200,389,80,17.5,1,Mostly Clear,7.5,2021-09-25 22:00:00,22
186,181,367,83,16.9,1,Mostly Clear,7.9,2021-09-25 23:00:00,23
166,144,310,84,16.5,0,Clear,10.0,2021-09-26 00:00:00,0
146,96,242,79,16.6,0,Clear,13.4,2021-09-26 01:00:00,1
89,65,154,76,16.7,0,Clear,13.7,2021-09-26 02:00:00,2
41,43,84,73,16.4,0,Clear,13.8,2021-09-26 03:00:00,3
19,13,32,76,16.0,0,Clear,13.3,2021-09-26 04:00:00,4
18,18,36,78,15.5,0,Clear,11.5,2021-09-26 05:00:00,5
24,35,59,80,14.8,0,Clear,10.2,2021-09-26 06:00:00,6
41,70,111,83,14.2,0,Clear,8.9,2021-09-26 07:00:00,7
70,194,264,85,14.4,0,Clear,10.1,2021-09-26 08:00:00,8
209,302,511,75,16.5,0,Clear,9.1,2021-09-26 09:00:00,9
350,406,756,65,18.4,0,Clear,10.7,2021-09-26 10:00:00,10
445,422,867,55,20.0,0,Clear,12.6,2021-09-26 11:00:00,11
505,497,1002,46,21.2,0,Clear,14.5,2021-09-26 12:00:00,12
486,465,951,42,22.1,0,Clear,15.5,2021-09-26 13:00:00,13
519,478,997,40,22.7,0,Clear,16.0,2021-09-26 14:00:00,14
433,449,882,38,23.2,0,Clear,16.5,2021-09-26 15:00:00,15
523,448,971,38,23.2,0,Clear,16.2,2021-09-26 16:00:00,16
458,496,954,39,23.0,0,Clear,13.8,2021-09-26 17:00:00,17
347,445,792,46,21.9,0,Clear,8.4,2021-09-26 18:00:00,18
235,336,571,50,20.4,0,Clear,7.1,2021-09-26 19:00:00,19
179,216,395,56,18.9,0,Clear,7.6,2021-09-26 20:00:00,20
121,166,287,61,17.7,0,Clear,8.2,2021-09-26 21:00:00,21
81,120,201,65,16.9,0,Clear,8.6,2021-09-26 22:00:00,22
66,84,150,67,16.3,0,Clear,8.6,2021-09-26 23:00:00,23
34,24,58,68,15.9,0,Clear,8.0,2021-09-27 00:00:00,0
14,22,36,70,15.5,0,Clear,7.6,2021-09-27 01:00:00,1
10,11,21,72,15.0,0,Clear,7.6,2021-09-27 02:00:00,2
1,8,9,79,14.1,0,Clear,7.2,2021-09-27 03:00:00,3
17,13,30,81,13.6,0,Clear,7.2,2021-09-27 04:00:00,4
14,42,56,83,13.2,0,Clear,6.7,2021-09-27 05:00:00,5
44,156,200,84,13.0,0,Clear,7.6,2021-09-27 06:00:00,6
85,384,469,85,12.8,0,Clear,6.9,2021-09-27 07:00:00,7
117,513,630,81,14.4,0,Clear,7.2,2021-09-27 08:00:00,8
131,320,451,70,17.4,1,Mostly Clear,2.7,2021-09-27 09:00:00,9
123,206,329,62,20.1,0,Clear,4.2,2021-09-27 10:00:00,10
176,239,415,55,22.0,0,Clear,7.4,2021-09-27 11:00:00,11
166,291,457,51,22.9,0,Clear,10.5,2021-09-27 12:00:00,12
204,320,524,49,23.5,0,Clear,12.4,2021-09-27 13:00:00,13
169,310,479,46,24.5,0,Clear,13.2,2021-09-27 14:00:00,14
182,359,541,41,26.2,0,Clear,14.0,2021-09-27 15:00:00,15
230,521,751,40,26.3,0,Clear,14.3,2021-09-27 16:00:00,16
310,759,1069,42,25.9,0,Clear,13.1,2021-09-27 17:00:00,17
330,795,1125,48,24.4,0,Clear,10.9,2021-09-27 18:00:00,18
223,565,788,51,22.7,0,Clear,11.7,2021-09-27 19:00:00,19
142,324,466,52,21.8,0,Clear,13.9,2021-09-27 20:00:00,20
92,240,332,53,21.4,0,Clear,15.2,2021-09-27 21:00:00,21
81,147,228,54,21.1,0,Clear,15.3,2021-09-27 22:00:00,22
45,63,108,55,20.8,0,Clear,14.5,2021-09-27 23:00:00,23
23,21,44,57,20.4,0,Clear,12.9,2021-09-28 00:00:00,0
14,16,30,60,19.9,0,Clear,11.7,2021-09-28 01:00:00,1
4,6,10,63,19.4,0,Clear,11.0,2021-09-28 02:00:00,2
5,10,15,68,18.4,0,Clear,10.0,2021-09-28 03:00:00,3
9,23,32,70,17.9,0,Clear,8.7,2021-09-28 04:00:00,4
23,54,77,73,17.4,0,Clear,8.3,2021-09-28 05:00:00,5
44,163,207,77,17.0,0,Clear,10.5,2021-09-28 06:00:00,6
95,439,534,80,16.5,2,Partly Cloudy,11.6,2021-09-28 07:00:00,7
159,607,766,85,16.8,2,Partly Cloudy,8.3,2021-09-28 08:00:00,8
141,380,521,71,19.8,1,Mostly Clear,6.0,2021-09-28 09:00:00,9
129,248,377,64,22.6,2,Partly Cloudy,7.4,2021-09-28 10:00:00,10
106,222,328,61,24.3,1,Mostly Clear,9.0,2021-09-28 11:00:00,11
106,291,397,62,24.7,51,Light Drizzle,9.5,2021-09-28 12:00:00,12
101,305,406,64,24.6,0,Clear,13.0,2021-09-28 13:00:00,13
149,303,452,60,25.8,1,Mostly Clear,15.5,2021-09-28 14:00:00,14
168,339,507,52,28.1,53,Heavy Drizzle,13.0,2021-09-28 15:00:00,15
234,467,701,59,26.5,51,Light Drizzle,6.1,2021-09-28 16:00:00,16
323,751,1074,82,22.6,61,Light Rain,2.6,2021-09-28 17:00:00,17
310,721,1031,88,21.3,51,Light Drizzle,5.4,2021-09-28 18:00:00,18
209,568,777,89,20.7,1,Mostly Clear,6.2,2021-09-28 19:00:00,19
137,343,480,91,20.2,0,Clear,8.4,2021-09-28 20:00:00,20
156,272,428,92,19.8,0,Clear,8.2,2021-09-28 21:00:00,21
105,155,260,94,19.3,0,Clear,10.5,2021-09-28 22:00:00,22
62,86,148,94,19.0,0,Clear,12.2,2021-09-28 23:00:00,23
27,34,61,95,18.8,0,Clear,12.0,2021-09-29 00:00:00,0
23,10,33,94,18.3,0,Clear,9.5,2021-09-29 01:00:00,1
7,6,13,93,17.8,1,Mostly Clear,8.5,2021-09-29 02:00:00,2
4,2,6,88,17.8,1,Mostly Clear,9.8,2021-09-29 03:00:00,3
13,12,25,87,17.5,0,Clear,10.7,2021-09-29 04:00:00,4
23,59,82,82,16.8,0,Clear,11.2,2021-09-29 05:00:00,5
55,157,212,75,15.9,1,Mostly Clear,8.6,2021-09-29 06:00:00,6
93,446,539,72,15.0,0,Clear,8.4,2021-09-29 07:00:00,7
134,598,732,72,14.6,0,Clear,9.4,2021-09-29 08:00:00,8
140,384,524,66,15.2,0,Clear,11.2,2021-09-29 09:00:00,9
121,243,364,61,16.2,1,Mostly Clear,10.9,2021-09-29 10:00:00,10
139,263,402,57,17.3,1,Mostly Clear,8.8,2021-09-29 11:00:00,11
142,320,462,51,18.8,0,Clear,8.0,2021-09-29 12:00:00,12
168,324,492,47,19.9,0,Clear,7.3,2021-09-29 13:00:00,13
166,314,480,46,20.7,0,Clear,6.1,2021-09-29 14:00:00,14
186,377,563,45,21.2,0,Clear,6.4,2021-09-29 15:00:00,15
247,503,750,44,21.5,0,Clear,7.5,2021-09-29 16:00:00,16
381,843,1224,44,21.4,0,Clear,8.4,2021-09-29 17:00:00,17
411,760,1171,48,20.8,0,Clear,6.3,2021-09-29 18:00:00,18
259,591,850,67,19.1,0,Clear,4.3,2021-09-29 19:00:00,19
166,306,472,53,19.5,0,Clear,4.5,2021-09-29 20:00:00,20
175,290,465,57,19.0,0,Clear,5.0,2021-09-29 21:00:00,21
147,213,360,70,16.9,0,Clear,5.2,2021-09-29 22:00:00,22
67,85,152,82,14.7,0,Clear,6.3,2021-09-29 23:00:00,23
30,33,63,85,14.1,0,Clear,7.1,2021-09-30 00:00:00,0
13,19,32,85,13.8,0,Clear,5.2,2021-09-30 01:00:00,1
3,12,15,86,13.4,0,Clear,7.9,2021-09-30 02:00:00,2
1,6,7,88,13.4,0,Clear,8.3,2021-09-30 03:00:00,3
7,17,24,89,12.9,0,Clear,7.6,2021-09-30 04:00:00,4
31,46,77,89,12.6,0,Clear,7.0,2021-09-30 05:00:00,5
39,163,202,89,12.1,0,Clear,6.3,2021-09-30 06:00:00,6
84,372,456,89,11.8,0,Clear,7.4,2021-09-30 07:00:00,7
135,553,688,88,12.5,0,Clear,8.6,2021-09-30 08:00:00,8
112,379,491,72,16.1,0,Clear,7.1,2021-09-30 09:00:00,9
150,241,391,64,18.2,0,Clear,7.2,2021-09-30 10:00:00,10
153,247,400,56,19.9,0,Clear,7.2,2021-09-30 11:00:00,11
172,369,541,50,21.1,0,Clear,8.4,2021-09-30 12:00:00,12
165,346,511,46,21.9,2,Partly Cloudy,10.0,2021-09-30 13:00:00,13
198,327,525,43,22.5,3,Cloudy,10.9,2021-09-30 14:00:00,14
224,379,603,42,22.6,1,Mostly Clear,10.7,2021-09-30 15:00:00,15
286,551,837,42,22.8,1,Mostly Clear,10.1,2021-09-30 16:00:00,16
378,819,1197,42,22.6,1,Mostly Clear,8.7,2021-09-30 17:00:00,17
396,789,1185,50,21.6,1,Mostly Clear,7.8,2021-09-30 18:00:00,18
264,564,828,54,20.1,0,Clear,6.9,2021-09-30 19:00:00,19
197,341,538,59,18.9,0,Clear,8.9,2021-09-30 20:00:00,20
175,296,471,63,17.8,1,Mostly Clear,9.4,2021-09-30 21:00:00,21
135,183,318,65,17.0,1,Mostly Clear,8.2,2021-09-30 22:00:00,22
107,131,238,69,16.0,2,Partly Cloudy,6.6,2021-09-30 23:00:00,23
39,45,84,74,15.0,3,Cloudy,4.6,2021-10-01 00:00:00,0
45,45,90,79,14.1,2,Partly Cloudy,5.7,2021-10-01 01:00:00,1
25,16,41,82,13.3,1,Mostly Clear,5.5,2021-10-01 02:00:00,2
4,13,17,87,13.3,1,Mostly Clear,6.0,2021-10-01 03:00:00,3
8,19,27,88,12.9,1,Mostly Clear,7.0,2021-10-01 04:00:00,4
23,42,65,86,12.8,1,Mostly Clear,7.6,2021-10-01 05:00:00,5
52,139,191,86,12.5,0,Clear,7.1,2021-10-01 06:00:00,6
93,357,450,86,12.0,0,Clear,6.8,2021-10-01 07:00:00,7
138,467,605,88,12.2,0,Clear,7.5,2021-10-01 08:00:00,8
142,340,482,72,15.1,0,Clear,5.4,2021-10-01 09:00:00,9
196,277,473,64,16.7,0,Clear,4.4,2021-10-01 10:00:00,10
197,301,498,57,18.2,0,Clear,2.5,2021-10-01 11:00:00,11
304,404,708,54,19.4,0,Clear,2.1,2021-10-01 12:00:00,12
278,371,649,52,20.4,0,Clear,3.5,2021-10-01 13:00:00,13
313,390,703,50,21.2,0,Clear,4.2,2021-10-01 14:00:00,14
315,476,791,49,21.4,0,Clear,4.3,2021-10-01 15:00:00,15
412,564,976,48,21.7,0,Clear,4.1,2021-10-01 16:00:00,16
461,773,1234,47,21.6,0,Clear,4.0,2021-10-01 17:00:00,17
497,738,1235,53,20.8,0,Clear,3.8,2021-10-01 18:00:00,18
356,450,806,63,19.3,0,Clear,0.7,2021-10-01 19:00:00,19
185,269,454,70,17.6,0,Clear,2.5,2021-10-01 20:00:00,20
212,224,436,76,16.3,0,Clear,4.1,2021-10-01 21:00:00,21
188,220,408,83,15.4,0,Clear,5.2,2021-10-01 22:00:00,22
205,204,409,88,14.6,0,Clear,6.4,2021-10-01 23:00:00,23
135,168,303,91,14.0,0,Clear,8.2,2021-10-02 00:00:00,0
80,78,158,92,13.5,0,Clear,8.4,2021-10-02 01:00:00,1
63,64,127,94,13.3,0,Clear,6.7,2021-10-02 02:00:00,2
34,26,60,95,13.2,0,Clear,6.3,2021-10-02 03:00:00,3
8,12,20,96,13.0,0,Clear,7.3,2021-10-02 04:00:00,4
11,20,31,96,12.7,0,Clear,7.2,2021-10-02 05:00:00,5
33,47,80,97,12.4,0,Clear,6.0,2021-10-02 06:00:00,6
54,106,160,97,12.2,0,Clear,6.3,2021-10-02 07:00:00,7
141,259,400,97,13.0,0,Clear,8.7,2021-10-02 08:00:00,8
309,348,657,85,16.5,0,Clear,7.2,2021-10-02 09:00:00,9
419,444,863,76,18.7,0,Clear,7.3,2021-10-02 10:00:00,10
643,514,1157,69,20.8,0,Clear,7.4,2021-10-02 11:00:00,11
595,527,1122,63,22.7,0,Clear,7.4,2021-10-02 12:00:00,12
673,561,1234,60,24.2,0,Clear,7.1,2021-10-02 13:00:00,13
680,573,1253,57,25.2,0,Clear,7.1,2021-10-02 14:00:00,14
740,583,1323,54,25.6,0,Clear,7.4,2021-10-02 15:00:00,15
641,532,1173,53,25.8,1,Mostly Clear,7.1,2021-10-02 16:00:00,16
500,458,958,53,25.6,0,Clear,6.6,2021-10-02 17:00:00,17
475,485,960,60,24.6,1,Mostly Clear,2.9,2021-10-02 18:00:00,18
344,371,715,65,23.0,1,Mostly Clear,4.3,2021-10-02 19:00:00,19
304,316,620,74,21.2,1,Mostly Clear,5.1,2021-10-02 20:00:00,20
218,226,444,80,20.0,1,Mostly Clear,5.4,2021-10-02 21:00:00,21
164,159,323,85,19.3,0,Clear,6.6,2021-10-02 22:00:00,22
211,169,380,89,18.7,0,Clear,5.8,2021-10-02 23:00:00,23
138,143,281,91,18.1,0,Clear,5.4,2021-10-03 00:00:00,0
128,89,217,93,17.6,0,Clear,5.8,2021-10-03 01:00:00,1
95,77,172,93,17.3,0,Clear,5.8,2021-10-03 02:00:00,2
65,56,121,94,16.9,0,Clear,6.0,2021-10-03 03:00:00,3
18,17,35,95,16.6,0,Clear,5.4,2021-10-03 04:00:00,4
20,25,45,96,16.3,0,Clear,5.4,2021-10-03 05:00:00,5
31,43,74,96,16.0,3,Cloudy,5.5,2021-10-03 06:00:00,6
37,72,109,97,15.7,3,Cloudy,5.0,2021-10-03 07:00:00,7
126,152,278,97,16.3,3,Cloudy,3.9,2021-10-03 08:00:00,8
228,301,529,87,19.5,1,Mostly Clear,2.9,2021-10-03 09:00:00,9
405,452,857,78,21.9,0,Clear,3.1,2021-10-03 10:00:00,10
536,479,1015,69,24.3,0,Clear,3.2,2021-10-03 11:00:00,11
502,496,998,62,26.5,0,Clear,4.5,2021-10-03 12:00:00,12
562,490,1052,55,28.0,0,Clear,6.5,2021-10-03 13:00:00,13
593,489,1082,48,28.9,1,Mostly Clear,8.3,2021-10-03 14:00:00,14
494,427,921,49,28.8,1,Mostly Clear,10.0,2021-10-03 15:00:00,15
463,430,893,50,28.5,1,Mostly Clear,9.1,2021-10-03 16:00:00,16
425,489,914,53,27.9,1,Mostly Clear,10.1,2021-10-03 17:00:00,17
343,420,763,60,26.3,2,Partly Cloudy,6.8,2021-10-03 18:00:00,18
323,391,714,65,24.8,1,Mostly Clear,8.6,2021-10-03 19:00:00,19
150,196,346,69,23.8,2,Partly Cloudy,9.4,2021-10-03 20:00:00,20
118,157,275,72,23.2,2,Partly Cloudy,11.2,2021-10-03 21:00:00,21
88,118,206,74,22.6,2,Partly Cloudy,12.4,2021-10-03 22:00:00,22
82,56,138,74,22.3,1,Mostly Clear,12.5,2021-10-03 23:00:00,23
42,31,73,75,21.9,2,Partly Cloudy,11.8,2021-10-04 00:00:00,0
26,18,44,76,21.6,3,Cloudy,11.0,2021-10-04 01:00:00,1
15,6,21,78,21.1,3,Cloudy,10.4,2021-10-04 02:00:00,2
2,4,6,77,21.8,2,Partly Cloudy,9.9,2021-10-04 03:00:00,3
13,14,27,78,21.6,1,Mostly Clear,9.7,2021-10-04 04:00:00,4
17,44,61,80,21.1,1,Mostly Clear,9.6,2021-10-04 05:00:00,5
54,150,204,82,20.8,2,Partly Cloudy,6.9,2021-10-04 06:00:00,6
78,374,452,85,20.4,2,Partly Cloudy,7.2,2021-10-04 07:00:00,7
112,490,602,85,20.7,2,Partly Cloudy,7.4,2021-10-04 08:00:00,8
103,325,428,82,21.7,1,Mostly Clear,6.9,2021-10-04 09:00:00,9
150,241,391,77,23.0,2,Partly Cloudy,6.4,2021-10-04 10:00:00,10
178,225,403,73,24.3,51,Light Drizzle,6.5,2021-10-04 11:00:00,11
203,312,515,72,24.9,51,Light Drizzle,6.0,2021-10-04 12:00:00,12
202,286,488,67,25.7,1,Mostly Clear,6.3,2021-10-04 13:00:00,13
219,282,501,64,26.3,1,Mostly Clear,6.7,2021-10-04 14:00:00,14
229,350,579,62,27.2,1,Mostly Clear,5.8,2021-10-04 15:00:00,15
223,414,637,62,27.1,1,Mostly Clear,6.3,2021-10-04 16:00:00,16
313,678,991,62,27.0,1,Mostly Clear,5.4,2021-10-04 17:00:00,17
336,680,1016,70,25.5,51,Light Drizzle,4.5,2021-10-04 18:00:00,18
168,457,625,80,23.2,63,Rain,5.0,2021-10-04 19:00:00,19
117,279,396,88,21.6,63,Rain,5.5,2021-10-04 20:00:00,20
98,203,301,92,20.9,53,Heavy Drizzle,5.9,2021-10-04 21:00:00,21
75,129,204,95,20.3,1,Mostly Clear,6.5,2021-10-04 22:00:00,22
66,95,161,97,19.8,1,Mostly Clear,4.7,2021-10-04 23:00:00,23
37,36,73,98,19.6,2,Partly Cloudy,5.1,2021-10-05 00:00:00,0
12,12,24,98,19.3,3,Cloudy,4.1,2021-10-05 01:00:00,1
4,5,9,99,19.0,3,Cloudy,5.2,2021-10-05 02:00:00,2
4,4,8,99,19.4,3,Cloudy,5.9,2021-10-05 03:00:00,3
11,16,27,99,19.3,2,Partly Cloudy,5.5,2021-10-05 04:00:00,4
17,53,70,100,18.8,3,Cloudy,3.5,2021-10-05 05:00:00,5
45,169,214,100,18.9,3,Cloudy,5.6,2021-10-05 06:00:00,6
95,420,515,100,18.8,3,Cloudy,6.0,2021-10-05 07:00:00,7
126,571,697,99,19.3,3,Cloudy,7.4,2021-10-05 08:00:00,8
130,369,499,95,20.2,3,Cloudy,9.6,2021-10-05 09:00:00,9
141,236,377,88,21.6,3,Cloudy,4.8,2021-10-05 10:00:00,10
162,255,417,83,22.7,3,Cloudy,5.8,2021-10-05 11:00:00,11
145,303,448,79,23.4,3,Cloudy,6.8,2021-10-05 12:00:00,12
189,271,460,74,24.2,3,Cloudy,5.2,2021-10-05 13:00:00,13
202,286,488,72,24.8,51,Light Drizzle,4.2,2021-10-05 14:00:00,14
184,296,480,86,23.0,61,Light Rain,6.3,2021-10-05 15:00:00,15
217,474,691,91,22.2,61,Light Rain,9.0,2021-10-05 16:00:00,16
286,729,1015,93,22.1,51,Light Drizzle,9.7,2021-10-05 17:00:00,17
313,678,991,94,21.7,3,Cloudy,13.6,2021-10-05 18:00:00,18
191,496,687,95,21.1,51,Light Drizzle,11.3,2021-10-05 19:00:00,19
119,308,427,96,20.9,3,Cloudy,11.5,2021-10-05 20:00:00,20
115,229,344,96,20.7,3,Cloudy,10.5,2021-10-05 21:00:00,21
79,150,229,96,20.7,3,Cloudy,10.1,2021-10-05 22:00:00,22
51,85,136,96,20.6,3,Cloudy,10.6,2021-10-05 23:00:00,23
20,23,43,97,20.4,3,Cloudy,9.8,2021-10-06 00:00:00,0
5,12,17,98,20.2,3,Cloudy,11.3,2021-10-06 01:00:00,1
10,11,21,98,20.0,3,Cloudy,12.1,2021-10-06 02:00:00,2
1,5,6,99,19.7,51,Light Drizzle,11.9,2021-10-06 03:00:00,3
7,16,23,99,19.6,3,Cloudy,11.2,2021-10-06 04:00:00,4
17,50,67,99,19.5,3,Cloudy,10.8,2021-10-06 05:00:00,5
38,142,180,98,19.5,3,Cloudy,8.7,2021-10-06 06:00:00,6
61,342,403,98,19.5,3,Cloudy,10.2,2021-10-06 07:00:00,7
119,490,609,97,19.5,3,Cloudy,11.3,2021-10-06 08:00:00,8
90,325,415,98,19.6,51,Light Drizzle,10.5,2021-10-06 09:00:00,9
99,208,307,98,19.8,51,Light Drizzle,10.3,2021-10-06 10:00:00,10
138,224,362,97,20.1,3,Cloudy,10.8,2021-10-06 11:00:00,11
143,281,424,96,20.4,3,Cloudy,12.0,2021-10-06 12:00:00,12
136,298,434,95,20.6,3,Cloudy,11.2,2021-10-06 13:00:00,13
186,285,471,93,20.6,3,Cloudy,9.7,2021-10-06 14:00:00,14
209,335,544,88,20.8,3,Cloudy,10.4,2021-10-06 15:00:00,15
228,466,694,85,21.3,3,Cloudy,9.7,2021-10-06 16:00:00,16
303,738,1041,85,21.4,3,Cloudy,8.0,2021-10-06 17:00:00,17
289,766,1055,86,21.3,3,Cloudy,4.8,2021-10-06 18:00:00,18
213,549,762,87,20.9,3,Cloudy,6.5,2021-10-06 19:00:00,19
159,334,493,87,20.8,3,Cloudy,7.2,2021-10-06 20:00:00,20
104,257,361,88,20.6,2,Partly Cloudy,7.2,2021-10-06 21:00:00,21
108,168,276,89,20.4,3,Cloudy,6.8,2021-10-06 22:00:00,22
67,87,154,89,20.3,3,Cloudy,6.8,2021-10-06 23:00:00,23
36,58,94,89,20.0,3,Cloudy,7.6,2021-10-07 00:00:00,0
25,20,45,89,19.8,1,Mostly Clear,8.3,2021-10-07 01:00:00,1
12,11,23,89,19.6,1,Mostly Clear,6.4,2021-10-07 02:00:00,2
9,6,15,95,18.8,3,Cloudy,5.6,2021-10-07 03:00:00,3
13,19,32,95,18.6,3,Cloudy,5.4,2021-10-07 04:00:00,4
16,51,67,94,18.6,3,Cloudy,6.2,2021-10-07 05:00:00,5
51,166,217,94,18.4,3,Cloudy,3.3,2021-10-07 06:00:00,6
89,345,434,94,18.2,3,Cloudy,4.2,2021-10-07 07:00:00,7
141,570,711,94,18.3,3,Cloudy,5.2,2021-10-07 08:00:00,8
127,379,506,88,19.2,3,Cloudy,5.5,2021-10-07 09:00:00,9
153,274,427,81,20.1,3,Cloudy,5.8,2021-10-07 10:00:00,10
158,277,435,75,21.2,2,Partly Cloudy,7.2,2021-10-07 11:00:00,11
176,378,554,68,22.6,3,Cloudy,7.8,2021-10-07 12:00:00,12
175,309,484,65,23.2,2,Partly Cloudy,7.9,2021-10-07 13:00:00,13
237,346,583,62,23.6,3,Cloudy,7.6,2021-10-07 14:00:00,14
255,354,609,62,23.5,3,Cloudy,7.0,2021-10-07 15:00:00,15
266,472,738,63,23.4,3,Cloudy,6.6,2021-10-07 16:00:00,16
391,793,1184,63,23.4,3,Cloudy,6.1,2021-10-07 17:00:00,17
395,772,1167,68,22.7,3,Cloudy,2.6,2021-10-07 18:00:00,18
240,551,791,74,21.6,3,Cloudy,3.7,2021-10-07 19:00:00,19
198,378,576,83,20.6,2,Partly Cloudy,3.3,2021-10-07 20:00:00,20
159,283,442,83,20.2,3,Cloudy,4.5,2021-10-07 21:00:00,21
127,212,339,86,19.6,2,Partly Cloudy,4.3,2021-10-07 22:00:00,22
111,122,233,88,19.1,1,Mostly Clear,3.4,2021-10-07 23:00:00,23
44,53,97,88,19.0,0,Clear,0.7,2021-10-08 00:00:00,0
30,33,63,89,18.8,0,Clear,1.5,2021-10-08 01:00:00,1
30,27,57,93,18.0,0,Clear,2.4,2021-10-08 02:00:00,2
5,11,16,93,18.6,0,Clear,4.0,2021-10-08 03:00:00,3
9,21,30,97,17.2,1,Mostly Clear,4.0,2021-10-08 04:00:00,4
25,39,64,98,17.1,2,Partly Cloudy,4.3,2021-10-08 05:00:00,5
48,139,187,98,17.0,3,Cloudy,2.3,2021-10-08 06:00:00,6
85,274,359,99,17.2,3,Cloudy,3.1,2021-10-08 07:00:00,7
133,471,604,98,17.9,3,Cloudy,3.3,2021-10-08 08:00:00,8
176,352,528,93,19.6,3,Cloudy,1.8,2021-10-08 09:00:00,9
220,267,487,83,21.1,1,Mostly Clear,2.3,2021-10-08 10:00:00,10
270,338,608,76,22.0,1,Mostly Clear,4.1,2021-10-08 11:00:00,11
285,380,665,69,23.3,2,Partly Cloudy,5.3,2021-10-08 12:00:00,12
287,378,665,65,23.8,3,Cloudy,5.8,2021-10-08 13:00:00,13
378,393,771,63,24.2,3,Cloudy,5.5,2021-10-08 14:00:00,14
404,434,838,64,24.2,3,Cloudy,5.8,2021-10-08 15:00:00,15
406,468,874,63,24.2,3,Cloudy,6.4,2021-10-08 16:00:00,16
409,636,1045,65,23.8,3,Cloudy,7.0,2021-10-08 17:00:00,17
392,577,969,69,23.1,3,Cloudy,5.4,2021-10-08 18:00:00,18
296,413,709,74,22.0,3,Cloudy,5.6,2021-10-08 19:00:00,19
201,253,454,78,21.3,3,Cloudy,5.6,2021-10-08 20:00:00,20
159,218,377,82,20.7,3,Cloudy,4.9,2021-10-08 21:00:00,21
180,190,370,84,20.3,3,Cloudy,5.2,2021-10-08 22:00:00,22
166,186,352,85,20.0,2,Partly Cloudy,7.0,2021-10-08 23:00:00,23
98,125,223,86,19.7,3,Cloudy,6.8,2021-10-09 00:00:00,0
116,88,204,89,19.2,3,Cloudy,7.4,2021-10-09 01:00:00,1
63,61,124,89,18.9,3,Cloudy,9.3,2021-10-09 02:00:00,2
40,31,71,87,19.2,2,Partly Cloudy,9.2,2021-10-09 03:00:00,3
12,20,32,86,19.0,2,Partly Cloudy,8.7,2021-10-09 04:00:00,4
14,37,51,85,18.9,2,Partly Cloudy,9.0,2021-10-09 05:00:00,5
24,47,71,86,18.7,2,Partly Cloudy,6.6,2021-10-09 06:00:00,6
56,96,152,87,18.6,2,Partly Cloudy,7.2,2021-10-09 07:00:00,7
140,224,364,88,18.7,3,Cloudy,8.4,2021-10-09 08:00:00,8
231,332,563,84,19.4,3,Cloudy,12.6,2021-10-09 09:00:00,9
425,401,826,77,20.5,3,Cloudy,13.1,2021-10-09 10:00:00,10
575,463,1038,72,21.2,3,Cloudy,15.0,2021-10-09 11:00:00,11
584,465,1049,67,21.7,3,Cloudy,15.5,2021-10-09 12:00:00,12
627,496,1123,65,21.9,3,Cloudy,16.2,2021-10-09 13:00:00,13
677,478,1155,65,21.7,3,Cloudy,15.5,2021-10-09 14:00:00,14
686,408,1094,69,21.9,3,Cloudy,15.5,2021-10-09 15:00:00,15
607,416,1023,68,21.9,3,Cloudy,14.8,2021-10-09 16:00:00,16
564,411,975,67,21.8,3,Cloudy,12.0,2021-10-09 17:00:00,17
392,405,797,68,21.3,3,Cloudy,10.8,2021-10-09 18:00:00,18
296,324,620,69,20.9,3,Cloudy,11.8,2021-10-09 19:00:00,19
259,223,482,71,20.6,3,Cloudy,12.7,2021-10-09 20:00:00,20
217,200,417,73,20.2,2,Partly Cloudy,12.5,2021-10-09 21:00:00,21
155,179,334,75,19.9,2,Partly Cloudy,11.8,2021-10-09 22:00:00,22
152,117,269,78,19.6,3,Cloudy,13.0,2021-10-09 23:00:00,23
137,132,269,80,19.3,3,Cloudy,13.5,2021-10-10 00:00:00,0
106,78,184,83,19.1,3,Cloudy,13.8,2021-10-10 01:00:00,1
71,54,125,85,19.1,3,Cloudy,13.6,2021-10-10 02:00:00,2
28,30,58,85,19.0,3,Cloudy,13.3,2021-10-10 03:00:00,3
19,13,32,87,19.0,3,Cloudy,12.6,2021-10-10 04:00:00,4
8,26,34,89,18.9,51,Light Drizzle,11.7,2021-10-10 05:00:00,5
22,34,56,92,18.7,3,Cloudy,9.8,2021-10-10 06:00:00,6
33,60,93,93,18.9,3,Cloudy,10.9,2021-10-10 07:00:00,7
92,133,225,93,19.2,3,Cloudy,11.8,2021-10-10 08:00:00,8
206,240,446,91,19.7,3,Cloudy,14.8,2021-10-10 09:00:00,9
331,309,640,88,20.1,3,Cloudy,14.3,2021-10-10 10:00:00,10
433,363,796,83,20.8,3,Cloudy,13.0,2021-10-10 11:00:00,11
469,433,902,80,21.4,3,Cloudy,16.3,2021-10-10 12:00:00,12
487,436,923,75,22.2,3,Cloudy,16.4,2021-10-10 13:00:00,13
500,355,855,73,22.7,3,Cloudy,15.8,2021-10-10 14:00:00,14
520,385,905,79,22.0,3,Cloudy,16.4,2021-10-10 15:00:00,15
461,390,851,79,22.0,3,Cloudy,15.3,2021-10-10 16:00:00,16
519,401,920,81,21.6,3,Cloudy,13.5,2021-10-10 17:00:00,17
333,372,705,82,21.0,3,Cloudy,11.5,2021-10-10 18:00:00,18
218,276,494,83,20.4,3,Cloudy,12.2,2021-10-10 19:00:00,19
158,159,317,83,20.0,3,Cloudy,11.4,2021-10-10 20:00:00,20
114,128,242,84,19.8,3,Cloudy,11.2,2021-10-10 21:00:00,21
118,109,227,85,19.7,3,Cloudy,10.7,2021-10-10 22:00:00,22
88,88,176,85,19.7,3,Cloudy,10.5,2021-10-10 23:00:00,23
64,54,118,85,19.6,3,Cloudy,9.8,2021-10-11 00:00:00,0
31,20,51,83,19.5,3,Cloudy,9.8,2021-10-11 01:00:00,1
17,21,38,82,19.4,1,Mostly Clear,10.3,2021-10-11 02:00:00,2
16,16,32,87,18.3,1,Mostly Clear,11.3,2021-10-11 03:00:00,3
17,22,39,88,17.8,1,Mostly Clear,11.4,2021-10-11 04:00:00,4
11,43,54,88,17.6,2,Partly Cloudy,11.0,2021-10-11 05:00:00,5
42,111,153,88,17.5,3,Cloudy,10.4,2021-10-11 06:00:00,6
63,175,238,87,17.6,3,Cloudy,9.2,2021-10-11 07:00:00,7
88,274,362,88,17.5,3,Cloudy,9.9,2021-10-11 08:00:00,8
147,284,431,82,18.3,3,Cloudy,12.4,2021-10-11 09:00:00,9
234,326,560,78,19.0,3,Cloudy,12.1,2021-10-11 10:00:00,10
293,294,587,76,19.6,3,Cloudy,11.1,2021-10-11 11:00:00,11
324,363,687,73,20.4,3,Cloudy,10.5,2021-10-11 12:00:00,12
302,351,653,69,21.4,3,Cloudy,10.0,2021-10-11 13:00:00,13
327,359,686,64,22.2,3,Cloudy,10.0,2021-10-11 14:00:00,14
376,419,795,72,21.1,3,Cloudy,10.4,2021-10-11 15:00:00,15
361,429,790,71,21.3,3,Cloudy,11.3,2021-10-11 16:00:00,16
376,559,935,71,21.4,3,Cloudy,8.7,2021-10-11 17:00:00,17
253,507,760,74,21.0,3,Cloudy,7.1,2021-10-11 18:00:00,18
135,386,521,74,20.7,3,Cloudy,5.4,2021-10-11 19:00:00,19
149,228,377,75,20.5,3,Cloudy,5.8,2021-10-11 20:00:00,20
93,184,277,76,20.3,3,Cloudy,6.0,2021-10-11 21:00:00,21
66,114,180,78,19.9,3,Cloudy,6.4,2021-10-11 22:00:00,22
30,72,102,78,19.8,3,Cloudy,7.1,2021-10-11 23:00:00,23
29,18,47,78,19.6,3,Cloudy,7.6,2021-10-12 00:00:00,0
19,8,27,80,19.4,2,Partly Cloudy,6.8,2021-10-12 01:00:00,1
4,15,19,81,19.2,3,Cloudy,6.8,2021-10-12 02:00:00,2
4,5,9,86,18.4,3,Cloudy,7.2,2021-10-12 03:00:00,3
10,17,27,86,18.1,3,Cloudy,7.3,2021-10-12 04:00:00,4
19,48,67,86,18.0,3,Cloudy,7.8,2021-10-12 05:00:00,5
47,157,204,85,17.9,3,Cloudy,7.5,2021-10-12 06:00:00,6
87,367,454,86,17.8,3,Cloudy,7.7,2021-10-12 07:00:00,7
144,557,701,87,17.7,2,Partly Cloudy,6.9,2021-10-12 08:00:00,8
115,308,423,85,18.6,2,Partly Cloudy,6.6,2021-10-12 09:00:00,9
106,182,288,83,19.8,2,Partly Cloudy,6.1,2021-10-12 10:00:00,10
166,194,360,81,20.5,3,Cloudy,6.4,2021-10-12 11:00:00,11
180,301,481,77,21.4,3,Cloudy,4.9,2021-10-12 12:00:00,12
187,267,454,76,21.8,51,Light Drizzle,4.1,2021-10-12 13:00:00,13
212,261,473,76,21.9,51,Light Drizzle,4.2,2021-10-12 14:00:00,14
216,346,562,81,20.7,3,Cloudy,5.4,2021-10-12 15:00:00,15
236,478,714,80,21.0,3,Cloudy,6.5,2021-10-12 16:00:00,16
332,751,1083,80,21.0,3,Cloudy,5.9,2021-10-12 17:00:00,17
266,645,911,81,20.8,3,Cloudy,0.7,2021-10-12 18:00:00,18
137,392,529,84,20.5,51,Light Drizzle,1.5,2021-10-12 19:00:00,19
93,266,359,89,20.0,3,Cloudy,2.6,2021-10-12 20:00:00,20
92,214,306,88,19.9,3,Cloudy,4.3,2021-10-12 21:00:00,21
77,139,216,90,19.5,2,Partly Cloudy,4.9,2021-10-12 22:00:00,22
41,90,131,94,18.9,1,Mostly Clear,3.4,2021-10-12 23:00:00,23
31,25,56,90,19.4,2,Partly Cloudy,2.9,2021-10-13 00:00:00,0
12,12,24,92,19.0,1,Mostly Clear,3.6,2021-10-13 01:00:00,1
9,12,21,94,18.7,1,Mostly Clear,4.8,2021-10-13 02:00:00,2
4,9,13,99,17.5,2,Partly Cloudy,5.9,2021-10-13 03:00:00,3
6,8,14,99,17.5,3,Cloudy,6.1,2021-10-13 04:00:00,4
23,64,87,99,17.7,3,Cloudy,5.6,2021-10-13 05:00:00,5
43,177,220,99,18.2,3,Cloudy,2.1,2021-10-13 06:00:00,6
73,437,510,99,18.3,3,Cloudy,0.4,2021-10-13 07:00:00,7
153,596,749,97,18.9,3,Cloudy,0.7,2021-10-13 08:00:00,8
139,388,527,95,19.4,51,Light Drizzle,2.0,2021-10-13 09:00:00,9
142,267,409,85,20.8,3,Cloudy,4.3,2021-10-13 10:00:00,10
161,235,396,78,21.9,3,Cloudy,4.8,2021-10-13 11:00:00,11
180,340,520,75,22.5,3,Cloudy,4.4,2021-10-13 12:00:00,12
183,302,485,72,23.1,3,Cloudy,5.0,2021-10-13 13:00:00,13
232,330,562,68,23.9,3,Cloudy,5.1,2021-10-13 14:00:00,14
248,373,621,76,22.9,51,Light Drizzle,5.2,2021-10-13 15:00:00,15
256,489,745,76,22.9,51,Light Drizzle,3.0,2021-10-13 16:00:00,16
438,838,1276,76,22.8,1,Mostly Clear,5.8,2021-10-13 17:00:00,17
369,852,1221,80,22.3,1,Mostly Clear,4.5,2021-10-13 18:00:00,18
251,596,847,84,21.4,1,Mostly Clear,5.5,2021-10-13 19:00:00,19
168,321,489,88,20.7,1,Mostly Clear,5.1,2021-10-13 20:00:00,20
137,262,399,91,20.0,1,Mostly Clear,5.5,2021-10-13 21:00:00,21
126,210,336,95,19.3,0,Clear,5.5,2021-10-13 22:00:00,22
109,106,215,95,19.0,0,Clear,5.0,2021-10-13 23:00:00,23
26,40,66,96,18.7,1,Mostly Clear,4.7,2021-10-14 00:00:00,0
13,27,40,96,18.5,2,Partly Cloudy,5.0,2021-10-14 01:00:00,1
15,11,26,96,18.3,2,Partly Cloudy,5.5,2021-10-14 02:00:00,2
2,4,6,98,18.2,3,Cloudy,6.3,2021-10-14 03:00:00,3
9,18,27,97,18.4,3,Cloudy,5.4,2021-10-14 04:00:00,4
23,52,75,98,18.2,1,Mostly Clear,5.8,2021-10-14 05:00:00,5
42,148,190,98,17.9,3,Cloudy,8.4,2021-10-14 06:00:00,6
105,388,493,97,17.7,3,Cloudy,9.4,2021-10-14 07:00:00,7
175,594,769,96,17.7,3,Cloudy,9.9,2021-10-14 08:00:00,8
140,380,520,89,19.4,1,Mostly Clear,8.0,2021-10-14 09:00:00,9
144,274,418,77,21.7,1,Mostly Clear,8.7,2021-10-14 10:00:00,10
201,229,430,62,23.3,0,Clear,10.0,2021-10-14 11:00:00,11
212,359,571,53,24.3,0,Clear,10.4,2021-10-14 12:00:00,12
233,352,585,48,25.1,0,Clear,8.6,2021-10-14 13:00:00,13
253,338,591,45,25.7,1,Mostly Clear,7.7,2021-10-14 14:00:00,14
261,363,624,52,25.7,0,Clear,7.4,2021-10-14 15:00:00,15
342,552,894,51,25.8,1,Mostly Clear,7.0,2021-10-14 16:00:00,16
454,769,1223,52,25.5,1,Mostly Clear,5.6,2021-10-14 17:00:00,17
484,832,1316,62,24.1,0,Clear,3.7,2021-10-14 18:00:00,18
301,610,911,75,22.5,0,Clear,5.8,2021-10-14 19:00:00,19
205,356,561,65,22.7,0,Clear,5.4,2021-10-14 20:00:00,20
197,292,489,70,21.7,0,Clear,4.7,2021-10-14 21:00:00,21
139,222,361,72,21.3,0,Clear,4.3,2021-10-14 22:00:00,22
123,156,279,75,20.6,0,Clear,5.5,2021-10-14 23:00:00,23
62,65,127,86,18.4,0,Clear,4.8,2021-10-15 00:00:00,0
39,33,72,90,17.6,0,Clear,5.2,2021-10-15 01:00:00,1
26,25,51,90,17.3,0,Clear,5.4,2021-10-15 02:00:00,2
2,11,13,89,16.9,0,Clear,5.8,2021-10-15 03:00:00,3
4,16,20,87,17.0,0,Clear,6.5,2021-10-15 04:00:00,4
20,41,61,86,17.3,0,Clear,5.5,2021-10-15 05:00:00,5
43,144,187,84,17.9,0,Clear,4.9,2021-10-15 06:00:00,6
99,354,453,84,18.0,1,Mostly Clear,4.2,2021-10-15 07:00:00,7
173,480,653,86,17.8,2,Partly Cloudy,2.4,2021-10-15 08:00:00,8
191,384,575,81,19.8,3,Cloudy,1.1,2021-10-15 09:00:00,9
264,286,550,69,22.9,2,Partly Cloudy,2.6,2021-10-15 10:00:00,10
316,303,619,60,25.0,2,Partly Cloudy,4.0,2021-10-15 11:00:00,11
360,388,748,55,26.5,1,Mostly Clear,5.5,2021-10-15 12:00:00,12
331,381,712,53,27.4,1,Mostly Clear,5.4,2021-10-15 13:00:00,13
411,353,764,53,27.9,0,Clear,6.8,2021-10-15 14:00:00,14
432,455,887,62,27.7,1,Mostly Clear,8.6,2021-10-15 15:00:00,15
471,549,1020,62,27.5,1,Mostly Clear,10.1,2021-10-15 16:00:00,16
489,704,1193,64,26.8,1,Mostly Clear,10.6,2021-10-15 17:00:00,17
444,659,1103,68,25.6,1,Mostly Clear,8.0,2021-10-15 18:00:00,18
336,442,778,74,24.0,0,Clear,10.2,2021-10-15 19:00:00,19
259,315,574,77,23.1,0,Clear,11.2,2021-10-15 20:00:00,20
213,226,439,78,22.4,0,Clear,11.3,2021-10-15 21:00:00,21
185,195,380,79,22.0,0,Clear,11.2,2021-10-15 22:00:00,22
232,218,450,80,21.6,0,Clear,11.2,2021-10-15 23:00:00,23
162,172,334,80,21.3,0,Clear,11.9,2021-10-16 00:00:00,0
112,134,246,82,20.9,0,Clear,12.6,2021-10-16 01:00:00,1
116,81,197,83,20.7,0,Clear,12.6,2021-10-16 02:00:00,2
35,38,73,85,20.3,0,Clear,12.6,2021-10-16 03:00:00,3
15,15,30,86,20.0,0,Clear,13.0,2021-10-16 04:00:00,4
14,28,42,87,19.8,0,Clear,13.4,2021-10-16 05:00:00,5
27,45,72,87,19.7,0,Clear,13.2,2021-10-16 06:00:00,6
51,110,161,88,19.5,0,Clear,14.0,2021-10-16 07:00:00,7
153,230,383,87,19.5,0,Clear,14.8,2021-10-16 08:00:00,8
294,330,624,83,20.7,0,Clear,14.4,2021-10-16 09:00:00,9
434,443,877,77,22.2,1,Mostly Clear,17.1,2021-10-16 10:00:00,10
552,506,1058,72,23.8,0,Clear,17.3,2021-10-16 11:00:00,11
538,442,980,68,25.3,0,Clear,17.3,2021-10-16 12:00:00,12
621,477,1098,63,26.7,1,Mostly Clear,19.4,2021-10-16 13:00:00,13
297,292,589,71,24.9,63,Rain,21.4,2021-10-16 14:00:00,14
114,127,241,82,21.3,55,Heavy Drizzle,20.9,2021-10-16 15:00:00,15
54,74,128,75,20.2,51,Light Drizzle,19.6,2021-10-16 16:00:00,16
174,181,355,79,18.7,53,Heavy Drizzle,17.6,2021-10-16 17:00:00,17
201,228,429,84,17.2,51,Light Drizzle,15.8,2021-10-16 18:00:00,18
227,258,485,80,16.4,1,Mostly Clear,16.3,2021-10-16 19:00:00,19
149,156,305,73,15.7,0,Clear,14.8,2021-10-16 20:00:00,20
161,186,347,69,15.4,0,Clear,14.5,2021-10-16 21:00:00,21
191,191,382,66,14.9,0,Clear,13.3,2021-10-16 22:00:00,22
163,159,322,67,14.6,0,Clear,12.6,2021-10-16 23:00:00,23
136,155,291,67,14.3,0,Clear,12.0,2021-10-17 00:00:00,0
108,114,222,67,14.1,0,Clear,12.9,2021-10-17 01:00:00,1
79,53,132,66,13.8,0,Clear,13.0,2021-10-17 02:00:00,2
43,28,71,68,13.1,0,Clear,13.5,2021-10-17 03:00:00,3
10,14,24,67,12.8,0,Clear,13.4,2021-10-17 04:00:00,4
11,23,34,65,12.5,0,Clear,13.1,2021-10-17 05:00:00,5
12,37,49,64,12.3,0,Clear,14.5,2021-10-17 06:00:00,6
33,58,91,63,12.0,0,Clear,14.2,2021-10-17 07:00:00,7
99,160,259,63,12.0,0,Clear,15.0,2021-10-17 08:00:00,8
197,264,461,61,12.9,0,Clear,15.0,2021-10-17 09:00:00,9
367,378,745,54,14.2,0,Clear,19.3,2021-10-17 10:00:00,10
409,427,836,50,15.4,0,Clear,20.6,2021-10-17 11:00:00,11
476,428,904,43,16.8,3,Cloudy,24.6,2021-10-17 12:00:00,12
554,411,965,41,17.2,2,Partly Cloudy,24.2,2021-10-17 13:00:00,13
499,446,945,42,17.0,1,Mostly Clear,21.5,2021-10-17 14:00:00,14
461,446,907,39,17.7,1,Mostly Clear,20.8,2021-10-17 15:00:00,15
404,477,881,36,17.8,0,Clear,21.5,2021-10-17 16:00:00,16
360,391,751,35,17.4,0,Clear,19.0,2021-10-17 17:00:00,17
306,368,674,36,16.5,0,Clear,15.0,2021-10-17 18:00:00,18
162,253,415,38,15.5,0,Clear,13.6,2021-10-17 19:00:00,19
95,179,274,40,14.7,0,Clear,11.4,2021-10-17 20:00:00,20
74,120,194,43,14.1,0,Clear,10.2,2021-10-17 21:00:00,21
53,111,164,47,13.6,0,Clear,11.3,2021-10-17 22:00:00,22
47,74,121,50,13.2,0,Clear,11.3,2021-10-17 23:00:00,23
27,34,61,53,12.7,0,Clear,11.7,2021-10-18 00:00:00,0
18,11,29,55,12.2,0,Clear,11.7,2021-10-18 01:00:00,1
3,13,16,58,11.7,0,Clear,10.4,2021-10-18 02:00:00,2
3,5,8,66,10.6,0,Clear,9.6,2021-10-18 03:00:00,3
8,14,22,69,10.2,0,Clear,10.4,2021-10-18 04:00:00,4
19,39,58,70,10.1,0,Clear,10.8,2021-10-18 05:00:00,5
37,134,171,69,10.0,0,Clear,11.2,2021-10-18 06:00:00,6
76,356,432,68,10.1,0,Clear,12.7,2021-10-18 07:00:00,7
167,537,704,65,10.6,0,Clear,14.2,2021-10-18 08:00:00,8
138,322,460,62,12.3,0,Clear,13.3,2021-10-18 09:00:00,9
131,225,356,55,14.3,0,Clear,15.9,2021-10-18 10:00:00,10
165,237,402,48,15.6,0,Clear,17.7,2021-10-18 11:00:00,11
197,271,468,43,16.8,1,Mostly Clear,22.8,2021-10-18 12:00:00,12
204,248,452,39,17.6,1,Mostly Clear,23.6,2021-10-18 13:00:00,13
222,275,497,35,18.4,1,Mostly Clear,23.3,2021-10-18 14:00:00,14
232,313,545,35,19.0,1,Mostly Clear,21.7,2021-10-18 15:00:00,15
248,444,692,34,19.1,0,Clear,20.2,2021-10-18 16:00:00,16
375,805,1180,36,18.5,0,Clear,16.6,2021-10-18 17:00:00,17
324,716,1040,39,17.4,0,Clear,11.0,2021-10-18 18:00:00,18
174,495,669,41,16.2,0,Clear,9.2,2021-10-18 19:00:00,19
122,306,428,45,15.0,0,Clear,8.4,2021-10-18 20:00:00,20
81,221,302,48,14.2,0,Clear,9.2,2021-10-18 21:00:00,21
62,112,174,51,13.5,1,Mostly Clear,10.4,2021-10-18 22:00:00,22
38,65,103,55,12.6,0,Clear,10.2,2021-10-18 23:00:00,23
22,23,45,58,11.8,0,Clear,9.9,2021-10-19 00:00:00,0
13,5,18,61,11.0,0,Clear,10.5,2021-10-19 01:00:00,1
5,9,14,63,10.4,0,Clear,10.5,2021-10-19 02:00:00,2
5,6,11,67,9.8,0,Clear,10.1,2021-10-19 03:00:00,3
5,21,26,70,9.2,0,Clear,9.5,2021-10-19 04:00:00,4
15,48,63,72,8.7,0,Clear,9.2,2021-10-19 05:00:00,5
49,166,215,75,8.2,0,Clear,8.4,2021-10-19 06:00:00,6
103,397,500,78,7.8,0,Clear,8.0,2021-10-19 07:00:00,7
203,634,837,81,7.7,0,Clear,8.3,2021-10-19 08:00:00,8
136,366,502,69,11.3,0,Clear,8.3,2021-10-19 09:00:00,9
121,239,360,58,14.1,0,Clear,9.0,2021-10-19 10:00:00,10
145,235,380,52,16.4,0,Clear,10.8,2021-10-19 11:00:00,11
177,349,526,47,18.3,0,Clear,11.9,2021-10-19 12:00:00,12
190,319,509,43,19.9,0,Clear,13.0,2021-10-19 13:00:00,13
198,339,537,39,21.0,0,Clear,13.8,2021-10-19 14:00:00,14
227,381,608,38,21.9,0,Clear,14.2,2021-10-19 15:00:00,15
278,492,770,37,22.2,0,Clear,14.5,2021-10-19 16:00:00,16
414,793,1207,40,21.7,0,Clear,10.8,2021-10-19 17:00:00,17
370,809,1179,46,19.8,0,Clear,8.4,2021-10-19 18:00:00,18
224,528,752,52,17.9,0,Clear,9.2,2021-10-19 19:00:00,19
170,341,511,57,16.5,0,Clear,9.1,2021-10-19 20:00:00,20
152,311,463,59,15.5,0,Clear,9.4,2021-10-19 21:00:00,21
129,212,341,61,14.8,0,Clear,9.7,2021-10-19 22:00:00,22
57,88,145,62,14.4,0,Clear,10.5,2021-10-19 23:00:00,23
11,37,48,64,14.1,0,Clear,11.3,2021-10-20 00:00:00,0
10,14,24,66,13.9,0,Clear,11.7,2021-10-20 01:00:00,1
3,7,10,68,13.6,1,Mostly Clear,11.9,2021-10-20 02:00:00,2
0,6,6,68,13.4,1,Mostly Clear,12.0,2021-10-20 03:00:00,3
6,8,14,69,13.4,1,Mostly Clear,12.1,2021-10-20 04:00:00,4
22,43,65,70,13.3,1,Mostly Clear,11.8,2021-10-20 05:00:00,5
46,149,195,69,13.4,1,Mostly Clear,13.0,2021-10-20 06:00:00,6
115,408,523,70,13.3,1,Mostly Clear,12.5,2021-10-20 07:00:00,7
208,626,834,73,13.2,0,Clear,12.0,2021-10-20 08:00:00,8
144,423,567,70,15.1,0,Clear,12.1,2021-10-20 09:00:00,9
132,244,376,58,18.1,0,Clear,12.2,2021-10-20 10:00:00,10
168,312,480,52,20.2,0,Clear,13.2,2021-10-20 11:00:00,11
174,315,489,47,21.9,0,Clear,12.9,2021-10-20 12:00:00,12
189,288,477,43,23.0,0,Clear,12.5,2021-10-20 13:00:00,13
194,328,522,40,23.7,0,Clear,12.1,2021-10-20 14:00:00,14
237,341,578,40,24.1,0,Clear,12.0,2021-10-20 15:00:00,15
270,492,762,39,24.1,0,Clear,11.5,2021-10-20 16:00:00,16
397,842,1239,42,23.4,0,Clear,8.5,2021-10-20 17:00:00,17
402,837,1239,48,21.6,0,Clear,6.0,2021-10-20 18:00:00,18
246,540,786,55,19.6,0,Clear,6.4,2021-10-20 19:00:00,19
158,327,485,62,17.9,0,Clear,7.9,2021-10-20 20:00:00,20
165,318,483,67,16.6,0,Clear,8.6,2021-10-20 21:00:00,21
117,232,349,72,15.6,0,Clear,8.7,2021-10-20 22:00:00,22
77,116,193,75,14.7,0,Clear,8.9,2021-10-20 23:00:00,23
23,31,54,78,13.9,0,Clear,8.7,2021-10-21 00:00:00,0
17,23,40,82,13.2,0,Clear,7.5,2021-10-21 01:00:00,1
9,10,19,85,12.5,0,Clear,6.5,2021-10-21 02:00:00,2
4,8,12,86,11.8,0,Clear,6.5,2021-10-21 03:00:00,3
10,7,17,84,12.3,0,Clear,6.1,2021-10-21 04:00:00,4
24,48,72,81,13.3,0,Clear,4.3,2021-10-21 05:00:00,5
45,153,198,87,11.9,0,Clear,1.8,2021-10-21 06:00:00,6
83,357,440,94,10.3,0,Clear,1.8,2021-10-21 07:00:00,7
175,629,804,94,10.5,0,Clear,2.9,2021-10-21 08:00:00,8
192,374,566,87,13.7,0,Clear,0.8,2021-10-21 09:00:00,9
144,269,413,70,17.5,0,Clear,1.8,2021-10-21 10:00:00,10
185,271,456,59,20.2,0,Clear,3.7,2021-10-21 11:00:00,11
257,333,590,51,21.9,0,Clear,4.0,2021-10-21 12:00:00,12
241,350,591,45,23.3,0,Clear,4.0,2021-10-21 13:00:00,13
277,333,610,42,24.1,0,Clear,6.3,2021-10-21 14:00:00,14
286,388,674,43,24.2,0,Clear,9.7,2021-10-21 15:00:00,15
322,549,871,43,24.0,0,Clear,11.7,2021-10-21 16:00:00,16
511,844,1355,46,23.3,0,Clear,10.9,2021-10-21 17:00:00,17
445,825,1270,52,21.4,0,Clear,9.9,2021-10-21 18:00:00,18
266,553,819,57,20.1,0,Clear,13.1,2021-10-21 19:00:00,19
201,371,572,58,19.9,0,Clear,15.7,2021-10-21 20:00:00,20
153,275,428,57,20.3,0,Clear,18.3,2021-10-21 21:00:00,21
143,221,364,57,20.3,1,Mostly Clear,19.0,2021-10-21 22:00:00,22
123,137,260,58,20.1,1,Mostly Clear,19.9,2021-10-21 23:00:00,23
49,66,115,59,20.0,0,Clear,19.2,2021-10-22 00:00:00,0
32,43,75,61,20.0,0,Clear,17.3,2021-10-22 01:00:00,1
18,19,37,66,19.3,2,Partly Cloudy,14.7,2021-10-22 02:00:00,2
4,14,18,70,19.1,1,Mostly Clear,13.1,2021-10-22 03:00:00,3
7,10,17,74,18.4,0,Clear,13.0,2021-10-22 04:00:00,4
15,47,62,72,17.6,0,Clear,13.3,2021-10-22 05:00:00,5
51,146,197,67,16.7,0,Clear,11.7,2021-10-22 06:00:00,6
111,331,442,66,15.9,0,Clear,11.6,2021-10-22 07:00:00,7
171,512,683,68,15.3,0,Clear,12.3,2021-10-22 08:00:00,8
165,338,503,66,15.6,0,Clear,13.3,2021-10-22 09:00:00,9
246,281,527,61,16.5,0,Clear,12.5,2021-10-22 10:00:00,10
249,299,548,57,17.6,0,Clear,10.2,2021-10-22 11:00:00,11
296,368,664,53,18.9,1,Mostly Clear,7.7,2021-10-22 12:00:00,12
325,367,692,47,20.2,3,Cloudy,6.2,2021-10-22 13:00:00,13
436,409,845,45,20.8,3,Cloudy,6.4,2021-10-22 14:00:00,14
425,465,890,47,20.8,3,Cloudy,7.9,2021-10-22 15:00:00,15
471,522,993,47,20.6,3,Cloudy,9.2,2021-10-22 16:00:00,16
622,724,1346,51,19.8,3,Cloudy,10.4,2021-10-22 17:00:00,17
493,678,1171,55,19.0,3,Cloudy,7.6,2021-10-22 18:00:00,18
277,446,723,57,18.3,3,Cloudy,5.8,2021-10-22 19:00:00,19
224,294,518,59,17.7,3,Cloudy,5.4,2021-10-22 20:00:00,20
218,219,437,62,17.1,2,Partly Cloudy,4.6,2021-10-22 21:00:00,21
181,210,391,67,16.2,2,Partly Cloudy,5.2,2021-10-22 22:00:00,22
126,163,289,72,15.7,2,Partly Cloudy,6.7,2021-10-22 23:00:00,23
100,113,213,71,15.7,0,Clear,7.5,2021-10-23 00:00:00,0
113,119,232,71,15.5,0,Clear,8.3,2021-10-23 01:00:00,1
85,71,156,72,15.2,1,Mostly Clear,8.9,2021-10-23 02:00:00,2
37,42,79,76,13.8,2,Partly Cloudy,8.9,2021-10-23 03:00:00,3
19,16,35,77,13.7,2,Partly Cloudy,8.2,2021-10-23 04:00:00,4
10,16,26,78,13.5,3,Cloudy,7.9,2021-10-23 05:00:00,5
22,32,54,77,13.7,2,Partly Cloudy,5.2,2021-10-23 06:00:00,6
43,96,139,79,13.7,3,Cloudy,4.7,2021-10-23 07:00:00,7
160,191,351,79,13.9,3,Cloudy,3.8,2021-10-23 08:00:00,8
273,294,567,75,14.4,3,Cloudy,2.9,2021-10-23 09:00:00,9
396,349,745,73,14.8,3,Cloudy,2.6,2021-10-23 10:00:00,10
527,450,977,71,15.2,2,Partly Cloudy,2.5,2021-10-23 11:00:00,11
564,449,1013,66,16.0,1,Mostly Clear,6.1,2021-10-23 12:00:00,12
568,475,1043,61,16.9,3,Cloudy,11.4,2021-10-23 13:00:00,13
599,482,1081,56,17.7,2,Partly Cloudy,15.0,2021-10-23 14:00:00,14
640,492,1132,54,18.5,3,Cloudy,14.8,2021-10-23 15:00:00,15
506,479,985,54,18.2,1,Mostly Clear,10.8,2021-10-23 16:00:00,16
482,424,906,52,18.4,1,Mostly Clear,9.4,2021-10-23 17:00:00,17
411,462,873,54,17.4,1,Mostly Clear,8.2,2021-10-23 18:00:00,18
258,322,580,58,16.0,2,Partly Cloudy,7.4,2021-10-23 19:00:00,19
222,249,471,61,15.1,3,Cloudy,7.8,2021-10-23 20:00:00,20
165,183,348,64,14.4,3,Cloudy,7.2,2021-10-23 21:00:00,21
172,161,333,66,13.7,1,Mostly Clear,8.2,2021-10-23 22:00:00,22
129,159,288,67,13.1,0,Clear,6.8,2021-10-23 23:00:00,23
147,143,290,70,12.4,0,Clear,6.4,2021-10-24 00:00:00,0
107,89,196,79,11.4,2,Partly Cloudy,5.2,2021-10-24 01:00:00,1
68,57,125,68,12.5,2,Partly Cloudy,5.2,2021-10-24 02:00:00,2
28,33,61,78,12.3,2,Partly Cloudy,4.8,2021-10-24 03:00:00,3
13,15,28,81,12.2,2,Partly Cloudy,4.3,2021-10-24 04:00:00,4
13,20,33,80,12.4,2,Partly Cloudy,4.4,2021-10-24 05:00:00,5
19,40,59,80,12.6,2,Partly Cloudy,4.2,2021-10-24 06:00:00,6
29,59,88,77,12.8,3,Cloudy,4.3,2021-10-24 07:00:00,7
90,122,212,77,13.0,3,Cloudy,5.4,2021-10-24 08:00:00,8
169,243,412,75,13.6,3,Cloudy,4.9,2021-10-24 09:00:00,9
346,356,702,72,14.3,3,Cloudy,5.9,2021-10-24 10:00:00,10
386,418,804,67,15.4,2,Partly Cloudy,8.7,2021-10-24 11:00:00,11
535,476,1011,62,16.6,1,Mostly Clear,10.6,2021-10-24 12:00:00,12
511,414,925,59,18.0,1,Mostly Clear,10.8,2021-10-24 13:00:00,13
537,465,1002,58,19.1,1,Mostly Clear,12.1,2021-10-24 14:00:00,14
532,459,991,55,20.5,3,Cloudy,13.6,2021-10-24 15:00:00,15
481,486,967,54,21.1,3,Cloudy,12.0,2021-10-24 16:00:00,16
433,478,911,56,20.9,2,Partly Cloudy,10.1,2021-10-24 17:00:00,17
264,396,660,64,19.3,1,Mostly Clear,9.6,2021-10-24 18:00:00,18
189,249,438,72,17.9,0,Clear,11.8,2021-10-24 19:00:00,19
137,166,303,78,17.2,1,Mostly Clear,11.8,2021-10-24 20:00:00,20
105,163,268,79,16.9,0,Clear,12.9,2021-10-24 21:00:00,21
83,126,209,75,17.0,0,Clear,13.2,2021-10-24 22:00:00,22
43,86,129,70,17.0,0,Clear,12.3,2021-10-24 23:00:00,23
33,26,59,69,17.0,1,Mostly Clear,13.3,2021-10-25 00:00:00,0
19,13,32,71,16.8,1,Mostly Clear,14.2,2021-10-25 01:00:00,1
4,6,10,74,16.7,1,Mostly Clear,14.2,2021-10-25 02:00:00,2
5,5,10,78,16.6,1,Mostly Clear,14.6,2021-10-25 03:00:00,3
10,11,21,83,16.6,1,Mostly Clear,15.4,2021-10-25 04:00:00,4
17,39,56,87,16.7,1,Mostly Clear,15.8,2021-10-25 05:00:00,5
49,143,192,90,16.7,1,Mostly Clear,15.8,2021-10-25 06:00:00,6
90,373,463,93,16.5,1,Mostly Clear,14.5,2021-10-25 07:00:00,7
162,592,754,94,16.5,1,Mostly Clear,14.7,2021-10-25 08:00:00,8
128,358,486,90,17.6,0,Clear,13.7,2021-10-25 09:00:00,9
129,243,372,82,19.6,2,Partly Cloudy,15.0,2021-10-25 10:00:00,10
209,277,486,75,21.3,0,Clear,14.8,2021-10-25 11:00:00,11
203,351,554,68,23.0,0,Clear,16.5,2021-10-25 12:00:00,12
206,343,549,60,24.3,0,Clear,16.5,2021-10-25 13:00:00,13
224,323,547,58,24.9,0,Clear,14.9,2021-10-25 14:00:00,14
220,411,631,53,26.0,0,Clear,14.7,2021-10-25 15:00:00,15
263,546,809,55,25.4,2,Partly Cloudy,14.4,2021-10-25 16:00:00,16
178,520,698,65,23.9,2,Partly Cloudy,12.1,2021-10-25 17:00:00,17
78,304,382,77,22.1,51,Light Drizzle,8.1,2021-10-25 18:00:00,18
59,219,278,90,20.0,61,Light Rain,2.5,2021-10-25 19:00:00,19
6,52,58,95,19.2,63,Rain,4.7,2021-10-25 20:00:00,20
9,38,47,97,18.7,63,Rain,6.6,2021-10-25 21:00:00,21
9,23,32,98,18.5,63,Rain,5.4,2021-10-25 22:00:00,22
15,24,39,98,18.2,63,Rain,4.8,2021-10-25 23:00:00,23
4,15,19,98,18.0,63,Rain,6.1,2021-10-26 00:00:00,0
2,5,7,97,17.9,61,Light Rain,4.4,2021-10-26 01:00:00,1
4,9,13,99,17.7,61,Light Rain,5.5,2021-10-26 02:00:00,2
6,4,10,99,16.9,63,Rain,8.7,2021-10-26 03:00:00,3
2,10,12,100,16.5,61,Light Rain,9.9,2021-10-26 04:00:00,4
18,43,61,99,16.0,0,Clear,14.0,2021-10-26 05:00:00,5
28,156,184,95,15.7,2,Partly Cloudy,11.4,2021-10-26 06:00:00,6
83,456,539,91,15.2,1,Mostly Clear,14.0,2021-10-26 07:00:00,7
148,645,793,90,14.6,1,Mostly Clear,15.3,2021-10-26 08:00:00,8
105,432,537,88,15.2,0,Clear,16.0,2021-10-26 09:00:00,9
93,252,345,78,16.7,1,Mostly Clear,21.7,2021-10-26 10:00:00,10
123,299,422,72,18.0,1,Mostly Clear,25.2,2021-10-26 11:00:00,11
150,376,526,70,18.1,1,Mostly Clear,26.7,2021-10-26 12:00:00,12
133,351,484,65,17.4,1,Mostly Clear,28.0,2021-10-26 13:00:00,13
162,318,480,62,16.5,3,Cloudy,29.2,2021-10-26 14:00:00,14
143,406,549,57,16.3,3,Cloudy,30.2,2021-10-26 15:00:00,15
165,520,685,56,14.6,3,Cloudy,30.4,2021-10-26 16:00:00,16
239,784,1023,54,13.5,3,Cloudy,30.4,2021-10-26 17:00:00,17
189,735,924,54,12.7,3,Cloudy,25.5,2021-10-26 18:00:00,18
104,500,604,56,12.1,3,Cloudy,22.9,2021-10-26 19:00:00,19
79,308,387,60,11.5,3,Cloudy,21.7,2021-10-26 20:00:00,20
72,278,350,64,11.0,51,Light Drizzle,23.3,2021-10-26 21:00:00,21
67,182,249,66,10.9,3,Cloudy,23.3,2021-10-26 22:00:00,22
29,84,113,64,11.0,3,Cloudy,25.0,2021-10-26 23:00:00,23
16,43,59,63,11.1,3,Cloudy,31.8,2021-10-27 00:00:00,0
7,12,19,65,11.1,3,Cloudy,29.0,2021-10-27 01:00:00,1
4,6,10,69,11.0,3,Cloudy,23.7,2021-10-27 02:00:00,2
5,2,7,70,11.2,3,Cloudy,21.0,2021-10-27 03:00:00,3
4,13,17,72,11.4,3,Cloudy,19.4,2021-10-27 04:00:00,4
14,53,67,73,11.7,3,Cloudy,18.6,2021-10-27 05:00:00,5
37,149,186,73,12.0,3,Cloudy,16.9,2021-10-27 06:00:00,6
91,470,561,75,12.3,2,Partly Cloudy,19.1,2021-10-27 07:00:00,7
152,727,879,77,12.6,2,Partly Cloudy,20.5,2021-10-27 08:00:00,8
114,441,555,77,13.1,1,Mostly Clear,19.1,2021-10-27 09:00:00,9
92,298,390,74,14.5,0,Clear,21.9,2021-10-27 10:00:00,10
108,328,436,69,16.1,0,Clear,21.6,2021-10-27 11:00:00,11
145,413,558,64,17.8,0,Clear,20.3,2021-10-27 12:00:00,12
151,354,505,61,19.1,0,Clear,19.7,2021-10-27 13:00:00,13
148,374,522,58,20.0,0,Clear,19.4,2021-10-27 14:00:00,14
198,473,671,56,21.0,0,Clear,18.4,2021-10-27 15:00:00,15
231,617,848,55,21.0,0,Clear,17.2,2021-10-27 16:00:00,16
330,1043,1373,57,20.5,0,Clear,13.9,2021-10-27 17:00:00,17
288,982,1270,61,19.0,0,Clear,8.2,2021-10-27 18:00:00,18
154,604,758,66,17.5,0,Clear,8.3,2021-10-27 19:00:00,19
132,344,476,70,16.4,0,Clear,8.4,2021-10-27 20:00:00,20
129,407,536,73,15.4,0,Clear,7.7,2021-10-27 21:00:00,21
124,280,404,74,14.5,0,Clear,8.3,2021-10-27 22:00:00,22
43,128,171,75,13.9,0,Clear,8.5,2021-10-27 23:00:00,23
15,66,81,76,13.3,0,Clear,8.0,2021-10-28 00:00:00,0
25,22,47,80,12.5,0,Clear,7.2,2021-10-28 01:00:00,1
11,9,20,83,11.9,0,Clear,7.9,2021-10-28 02:00:00,2
4,6,10,88,11.7,0,Clear,8.0,2021-10-28 03:00:00,3
7,9,16,89,11.2,0,Clear,8.2,2021-10-28 04:00:00,4
17,60,77,92,10.6,0,Clear,6.3,2021-10-28 05:00:00,5
33,155,188,93,10.3,0,Clear,5.2,2021-10-28 06:00:00,6
71,448,519,94,10.0,0,Clear,5.2,2021-10-28 07:00:00,7
132,681,813,93,10.3,0,Clear,4.0,2021-10-28 08:00:00,8
120,468,588,89,12.6,1,Mostly Clear,3.4,2021-10-28 09:00:00,9
122,298,420,80,15.1,1,Mostly Clear,2.5,2021-10-28 10:00:00,10
129,293,422,70,16.8,1,Mostly Clear,5.5,2021-10-28 11:00:00,11
165,365,530,64,17.7,2,Partly Cloudy,8.5,2021-10-28 12:00:00,12
198,414,612,60,18.6,3,Cloudy,9.2,2021-10-28 13:00:00,13
166,366,532,59,18.7,3,Cloudy,11.3,2021-10-28 14:00:00,14
192,419,611,57,19.0,3,Cloudy,12.7,2021-10-28 15:00:00,15
237,630,867,58,18.8,2,Partly Cloudy,14.0,2021-10-28 16:00:00,16
294,953,1247,62,18.0,2,Partly Cloudy,13.0,2021-10-28 17:00:00,17
290,932,1222,67,16.8,2,Partly Cloudy,9.8,2021-10-28 18:00:00,18
172,581,753,70,16.2,2,Partly Cloudy,10.4,2021-10-28 19:00:00,19
154,391,545,73,15.9,3,Cloudy,7.9,2021-10-28 20:00:00,20
117,328,445,75,15.9,3,Cloudy,10.8,2021-10-28 21:00:00,21
119,268,387,78,15.7,3,Cloudy,13.4,2021-10-28 22:00:00,22
69,150,219,80,15.3,3,Cloudy,14.7,2021-10-28 23:00:00,23
41,64,105,80,15.0,2,Partly Cloudy,15.2,2021-10-29 00:00:00,0
20,35,55,82,14.7,53,Heavy Drizzle,16.4,2021-10-29 01:00:00,1
19,25,44,86,14.3,51,Light Drizzle,15.9,2021-10-29 02:00:00,2
6,11,17,91,13.8,51,Light Drizzle,17.3,2021-10-29 03:00:00,3
3,8,11,93,13.7,61,Light Rain,18.7,2021-10-29 04:00:00,4
10,35,45,94,13.6,53,Heavy Drizzle,20.6,2021-10-29 05:00:00,5
20,62,82,95,13.7,51,Light Drizzle,20.5,2021-10-29 06:00:00,6
31,195,226,96,13.8,51,Light Drizzle,21.7,2021-10-29 07:00:00,7
47,254,301,94,14.0,3,Cloudy,23.2,2021-10-29 08:00:00,8
25,111,136,92,14.2,51,Light Drizzle,27.5,2021-10-29 09:00:00,9
22,85,107,93,14.2,61,Light Rain,29.6,2021-10-29 10:00:00,10
31,86,117,92,14.4,53,Heavy Drizzle,28.2,2021-10-29 11:00:00,11
26,57,83,93,14.6,61,Light Rain,27.6,2021-10-29 12:00:00,12
20,61,81,93,15.3,61,Light Rain,25.4,2021-10-29 13:00:00,13
15,68,83,94,15.7,61,Light Rain,23.2,2021-10-29 14:00:00,14
32,108,140,98,16.5,63,Rain,17.3,2021-10-29 15:00:00,15
35,98,133,100,16.7,63,Rain,14.8,2021-10-29 16:00:00,16
39,172,211,99,16.6,61,Light Rain,9.4,2021-10-29 17:00:00,17
87,252,339,99,16.5,61,Light Rain,15.4,2021-10-29 18:00:00,18
86,275,361,100,16.2,53,Heavy Drizzle,19.0,2021-10-29 19:00:00,19
72,223,295,100,16.1,51,Light Drizzle,16.1,2021-10-29 20:00:00,20
95,192,287,98,15.8,51,Light Drizzle,11.0,2021-10-29 21:00:00,21
88,153,241,96,15.5,53,Heavy Drizzle,5.7,2021-10-29 22:00:00,22
69,117,186,97,15.2,51,Light Drizzle,3.7,2021-10-29 23:00:00,23
64,95,159,98,15.2,3,Cloudy,4.4,2021-10-30 00:00:00,0
86,122,208,98,14.8,51,Light Drizzle,5.4,2021-10-30 01:00:00,1
41,87,128,98,14.6,51,Light Drizzle,3.6,2021-10-30 02:00:00,2
20,30,50,99,13.9,53,Heavy Drizzle,3.1,2021-10-30 03:00:00,3
16,19,35,99,14.0,51,Light Drizzle,5.4,2021-10-30 04:00:00,4
6,16,22,99,13.8,51,Light Drizzle,9.7,2021-10-30 05:00:00,5
19,43,62,96,13.5,51,Light Drizzle,8.3,2021-10-30 06:00:00,6
37,92,129,93,13.2,3,Cloudy,9.4,2021-10-30 07:00:00,7
80,184,264,92,12.8,3,Cloudy,9.5,2021-10-30 08:00:00,8
134,346,480,91,13.2,2,Partly Cloudy,10.5,2021-10-30 09:00:00,9
244,477,721,81,14.4,2,Partly Cloudy,12.6,2021-10-30 10:00:00,10
345,594,939,71,15.8,3,Cloudy,12.0,2021-10-30 11:00:00,11
400,589,989,65,16.7,2,Partly Cloudy,13.3,2021-10-30 12:00:00,12
399,614,1013,60,17.4,3,Cloudy,14.4,2021-10-30 13:00:00,13
427,645,1072,58,17.5,3,Cloudy,13.1,2021-10-30 14:00:00,14
453,612,1065,61,17.1,3,Cloudy,13.1,2021-10-30 15:00:00,15
414,605,1019,61,16.9,3,Cloudy,10.9,2021-10-30 16:00:00,16
344,527,871,61,16.8,3,Cloudy,7.6,2021-10-30 17:00:00,17
268,495,763,65,16.2,3,Cloudy,4.0,2021-10-30 18:00:00,18
217,436,653,69,15.4,3,Cloudy,4.1,2021-10-30 19:00:00,19
146,283,429,73,14.6,3,Cloudy,4.8,2021-10-30 20:00:00,20
143,259,402,74,14.5,3,Cloudy,5.6,2021-10-30 21:00:00,21
135,190,325,75,14.3,1,Mostly Clear,5.6,2021-10-30 22:00:00,22
146,210,356,76,14.1,2,Partly Cloudy,6.1,2021-10-30 23:00:00,23
155,204,359,77,13.9,1,Mostly Clear,7.5,2021-10-31 00:00:00,0
165,185,350,82,13.0,0,Clear,8.4,2021-10-31 01:00:00,1
176,148,324,87,12.0,0,Clear,8.6,2021-10-31 02:00:00,2
81,97,178,92,11.2,0,Clear,8.1,2021-10-31 03:00:00,3
26,25,51,94,10.8,0,Clear,7.1,2021-10-31 04:00:00,4
12,21,33,95,10.8,1,Mostly Clear,6.6,2021-10-31 05:00:00,5
16,37,53,96,10.6,2,Partly Cloudy,8.4,2021-10-31 06:00:00,6
25,51,76,96,10.9,2,Partly Cloudy,8.1,2021-10-31 07:00:00,7
73,147,220,96,11.1,2,Partly Cloudy,8.7,2021-10-31 08:00:00,8
105,254,359,92,12.3,1,Mostly Clear,7.6,2021-10-31 09:00:00,9
214,407,621,85,14.0,0,Clear,8.9,2021-10-31 10:00:00,10
268,509,777,76,15.8,0,Clear,12.3,2021-10-31 11:00:00,11
372,602,974,71,17.1,0,Clear,16.4,2021-10-31 12:00:00,12
385,570,955,69,17.7,1,Mostly Clear,17.3,2021-10-31 13:00:00,13
385,528,913,68,17.2,51,Light Drizzle,19.7,2021-10-31 14:00:00,14
328,526,854,62,18.2,1,Mostly Clear,19.1,2021-10-31 15:00:00,15
381,586,967,60,18.2,0,Clear,19.6,2021-10-31 16:00:00,16
334,572,906,59,17.8,0,Clear,18.0,2021-10-31 17:00:00,17
193,441,634,60,16.8,2,Partly Cloudy,14.5,2021-10-31 18:00:00,18
128,307,435,60,16.3,0,Clear,14.8,2021-10-31 19:00:00,19
99,254,353,62,15.4,0,Clear,13.4,2021-10-31 20:00:00,20
70,178,248,65,14.7,0,Clear,13.3,2021-10-31 21:00:00,21
64,143,207,68,14.0,0,Clear,13.0,2021-10-31 22:00:00,22
38,80,118,70,13.4,0,Clear,13.0,2021-10-31 23:00:00,23
22,40,62,72,12.9,0,Clear,12.8,2021-11-01 00:00:00,0
17,21,38,74,12.3,0,Clear,10.5,2021-11-01 01:00:00,1
17,8,25,78,11.5,0,Clear,8.5,2021-11-01 02:00:00,2
3,6,9,82,10.7,0,Clear,8.8,2021-11-01 03:00:00,3
5,12,17,84,10.3,0,Clear,9.0,2021-11-01 04:00:00,4
14,43,57,85,10.0,0,Clear,9.8,2021-11-01 05:00:00,5
32,114,146,85,10.0,1,Mostly Clear,9.4,2021-11-01 06:00:00,6
62,365,427,85,9.9,2,Partly Cloudy,9.2,2021-11-01 07:00:00,7
112,533,645,86,9.7,1,Mostly Clear,9.0,2021-11-01 08:00:00,8
83,379,462,78,11.4,0,Clear,11.6,2021-11-01 09:00:00,9
118,278,396,57,13.1,0,Clear,16.8,2021-11-01 10:00:00,10
125,293,418,51,13.6,0,Clear,15.8,2021-11-01 11:00:00,11
194,361,555,47,14.2,0,Clear,14.3,2021-11-01 12:00:00,12
172,303,475,44,14.8,0,Clear,13.8,2021-11-01 13:00:00,13
166,331,497,43,15.2,0,Clear,13.4,2021-11-01 14:00:00,14
192,412,604,40,15.9,0,Clear,12.5,2021-11-01 15:00:00,15
251,552,803,40,15.7,0,Clear,11.1,2021-11-01 16:00:00,16
273,891,1164,42,15.2,0,Clear,9.3,2021-11-01 17:00:00,17
228,771,999,51,14.0,0,Clear,6.0,2021-11-01 18:00:00,18
148,486,634,64,12.1,0,Clear,5.5,2021-11-01 19:00:00,19
91,280,371,69,10.7,1,Mostly Clear,6.1,2021-11-01 20:00:00,20
65,208,273,71,9.9,1,Mostly Clear,5.8,2021-11-01 21:00:00,21
53,143,196,73,9.4,1,Mostly Clear,6.3,2021-11-01 22:00:00,22
27,78,105,76,8.8,1,Mostly Clear,6.0,2021-11-01 23:00:00,23
21,29,50,78,8.3,1,Mostly Clear,5.4,2021-11-02 00:00:00,0
11,15,26,82,7.8,0,Clear,5.2,2021-11-02 01:00:00,1
6,12,18,82,7.4,1,Mostly Clear,6.1,2021-11-02 02:00:00,2
1,2,3,77,7.7,1,Mostly Clear,5.1,2021-11-02 03:00:00,3
4,13,17,76,8.4,2,Partly Cloudy,4.3,2021-11-02 04:00:00,4
15,42,57,79,8.3,2,Partly Cloudy,3.3,2021-11-02 05:00:00,5
40,160,200,80,8.4,2,Partly Cloudy,4.2,2021-11-02 06:00:00,6
62,393,455,81,7.7,2,Partly Cloudy,6.6,2021-11-02 07:00:00,7
116,644,760,77,8.2,2,Partly Cloudy,7.8,2021-11-02 08:00:00,8
83,360,443,71,9.2,51,Light Drizzle,9.5,2021-11-02 09:00:00,9
71,228,299,74,9.4,51,Light Drizzle,10.0,2021-11-02 10:00:00,10
35,165,200,81,9.1,53,Heavy Drizzle,7.8,2021-11-02 11:00:00,11
30,163,193,85,8.9,53,Heavy Drizzle,6.6,2021-11-02 12:00:00,12
30,132,162,86,8.8,53,Heavy Drizzle,6.0,2021-11-02 13:00:00,13
22,145,167,85,8.9,53,Heavy Drizzle,5.2,2021-11-02 14:00:00,14
43,171,214,88,8.9,53,Heavy Drizzle,5.9,2021-11-02 15:00:00,15
45,221,266,89,8.8,53,Heavy Drizzle,5.3,2021-11-02 16:00:00,16
101,521,622,90,8.9,51,Light Drizzle,4.6,2021-11-02 17:00:00,17
123,548,671,92,8.7,51,Light Drizzle,1.0,2021-11-02 18:00:00,18
81,391,472,92,8.4,2,Partly Cloudy,3.1,2021-11-02 19:00:00,19
75,246,321,94,8.0,0,Clear,4.6,2021-11-02 20:00:00,20
61,181,242,96,7.2,0,Clear,6.8,2021-11-02 21:00:00,21
52,151,203,97,6.4,0,Clear,8.0,2021-11-02 22:00:00,22
33,62,95,97,5.9,0,Clear,8.4,2021-11-02 23:00:00,23
18,36,54,96,5.3,0,Clear,8.1,2021-11-03 00:00:00,0
9,17,26,94,4.8,0,Clear,9.0,2021-11-03 01:00:00,1
5,10,15,92,4.3,0,Clear,9.7,2021-11-03 02:00:00,2
3,7,10,84,4.0,0,Clear,9.6,2021-11-03 03:00:00,3
6,6,12,83,3.7,0,Clear,8.5,2021-11-03 04:00:00,4
11,45,56,81,3.5,0,Clear,7.5,2021-11-03 05:00:00,5
33,150,183,80,3.3,0,Clear,7.6,2021-11-03 06:00:00,6
65,394,459,80,3.1,0,Clear,8.4,2021-11-03 07:00:00,7
128,582,710,81,2.9,0,Clear,7.4,2021-11-03 08:00:00,8
72,417,489,81,4.5,0,Clear,8.8,2021-11-03 09:00:00,9
71,254,325,69,7.0,0,Clear,8.9,2021-11-03 10:00:00,10
78,241,319,56,8.6,0,Clear,11.2,2021-11-03 11:00:00,11
108,355,463,46,9.6,0,Clear,14.3,2021-11-03 12:00:00,12
115,331,446,43,10.2,0,Clear,13.7,2021-11-03 13:00:00,13
124,331,455,40,10.7,1,Mostly Clear,14.5,2021-11-03 14:00:00,14
151,414,565,37,11.3,1,Mostly Clear,13.3,2021-11-03 15:00:00,15
166,535,701,35,11.3,0,Clear,12.3,2021-11-03 16:00:00,16
240,840,1080,34,10.9,1,Mostly Clear,9.9,2021-11-03 17:00:00,17
201,748,949,43,9.8,1,Mostly Clear,5.5,2021-11-03 18:00:00,18
106,537,643,60,8.4,1,Mostly Clear,5.8,2021-11-03 19:00:00,19
78,294,372,62,7.3,1,Mostly Clear,5.4,2021-11-03 20:00:00,20
73,265,338,63,6.5,1,Mostly Clear,6.4,2021-11-03 21:00:00,21
46,187,233,60,6.1,1,Mostly Clear,5.7,2021-11-03 22:00:00,22
45,83,128,60,5.9,1,Mostly Clear,5.8,2021-11-03 23:00:00,23
17,23,40,64,5.5,1,Mostly Clear,5.2,2021-11-04 00:00:00,0
5,14,19,67,5.2,1,Mostly Clear,5.8,2021-11-04 01:00:00,1
3,9,12,69,4.9,1,Mostly Clear,6.5,2021-11-04 02:00:00,2
8,5,13,72,4.5,1,Mostly Clear,7.0,2021-11-04 03:00:00,3
7,4,11,74,3.9,0,Clear,7.2,2021-11-04 04:00:00,4
17,45,62,76,3.3,0,Clear,7.2,2021-11-04 05:00:00,5
30,149,179,78,2.8,1,Mostly Clear,5.0,2021-11-04 06:00:00,6
54,349,403,80,2.5,1,Mostly Clear,5.5,2021-11-04 07:00:00,7
91,611,702,82,2.5,1,Mostly Clear,5.4,2021-11-04 08:00:00,8
74,411,485,81,4.2,1,Mostly Clear,6.1,2021-11-04 09:00:00,9
72,268,340,64,7.3,1,Mostly Clear,4.3,2021-11-04 10:00:00,10
82,262,344,55,9.1,1,Mostly Clear,5.0,2021-11-04 11:00:00,11
136,352,488,47,10.2,1,Mostly Clear,3.4,2021-11-04 12:00:00,12
116,308,424,44,10.6,1,Mostly Clear,4.1,2021-11-04 13:00:00,13
162,315,477,43,10.9,2,Partly Cloudy,4.3,2021-11-04 14:00:00,14
195,407,602,41,11.0,1,Mostly Clear,3.8,2021-11-04 15:00:00,15
171,491,662,41,10.9,2,Partly Cloudy,3.6,2021-11-04 16:00:00,16
229,824,1053,42,10.6,2,Partly Cloudy,4.0,2021-11-04 17:00:00,17
215,763,978,48,9.8,2,Partly Cloudy,3.3,2021-11-04 18:00:00,18
158,487,645,55,8.6,1,Mostly Clear,3.7,2021-11-04 19:00:00,19
104,336,440,65,7.0,0,Clear,4.7,2021-11-04 20:00:00,20
77,256,333,72,5.8,0,Clear,5.6,2021-11-04 21:00:00,21
76,175,251,74,5.0,0,Clear,6.6,2021-11-04 22:00:00,22
51,121,172,69,5.7,0,Clear,7.6,2021-11-04 23:00:00,23
24,48,72,70,5.8,0,Clear,6.2,2021-11-05 00:00:00,0
17,35,52,83,3.4,0,Clear,7.0,2021-11-05 01:00:00,1
11,9,20,86,2.7,0,Clear,6.9,2021-11-05 02:00:00,2
3,9,12,88,2.1,0,Clear,7.2,2021-11-05 03:00:00,3
6,8,14,88,1.7,0,Clear,7.6,2021-11-05 04:00:00,4
12,48,60,88,1.3,0,Clear,7.8,2021-11-05 05:00:00,5
31,123,154,87,1.0,0,Clear,8.1,2021-11-05 06:00:00,6
43,305,348,86,0.8,0,Clear,8.2,2021-11-05 07:00:00,7
86,425,511,84,0.9,0,Clear,8.3,2021-11-05 08:00:00,8
137,349,486,78,3.2,0,Clear,9.3,2021-11-05 09:00:00,9
117,259,376,62,6.7,0,Clear,6.5,2021-11-05 10:00:00,10
165,321,486,53,8.9,0,Clear,6.1,2021-11-05 11:00:00,11
183,403,586,43,10.3,0,Clear,10.0,2021-11-05 12:00:00,12
217,362,579,40,10.9,0,Clear,11.8,2021-11-05 13:00:00,13
252,451,703,39,11.3,0,Clear,10.3,2021-11-05 14:00:00,14
266,427,693,37,11.8,0,Clear,8.8,2021-11-05 15:00:00,15
271,525,796,37,11.6,1,Mostly Clear,8.1,2021-11-05 16:00:00,16
302,745,1047,39,11.1,1,Mostly Clear,5.8,2021-11-05 17:00:00,17
245,603,848,47,9.9,1,Mostly Clear,5.9,2021-11-05 18:00:00,18
166,455,621,60,8.0,1,Mostly Clear,5.4,2021-11-05 19:00:00,19
104,300,404,66,6.9,1,Mostly Clear,6.0,2021-11-05 20:00:00,20
97,210,307,60,7.7,1,Mostly Clear,5.8,2021-11-05 21:00:00,21
95,183,278,61,7.6,0,Clear,7.0,2021-11-05 22:00:00,22
73,134,207,66,6.5,0,Clear,6.2,2021-11-05 23:00:00,23
65,148,213,76,4.4,0,Clear,7.1,2021-11-06 00:00:00,0
41,97,138,77,4.1,0,Clear,6.2,2021-11-06 01:00:00,1
32,65,97,81,3.3,1,Mostly Clear,7.1,2021-11-06 02:00:00,2
20,20,40,84,1.9,1,Mostly Clear,7.1,2021-11-06 03:00:00,3
12,9,21,85,1.6,1,Mostly Clear,7.8,2021-11-06 04:00:00,4
8,7,15,85,1.3,1,Mostly Clear,7.8,2021-11-06 05:00:00,5
18,39,57,85,1.0,0,Clear,7.3,2021-11-06 06:00:00,6
20,90,110,84,0.8,0,Clear,8.0,2021-11-06 07:00:00,7
57,199,256,83,0.9,0,Clear,9.9,2021-11-06 08:00:00,8
110,287,397,80,3.1,0,Clear,10.7,2021-11-06 09:00:00,9
191,370,561,60,7.7,0,Clear,8.1,2021-11-06 10:00:00,10
307,490,797,51,10.0,0,Clear,9.4,2021-11-06 11:00:00,11
367,499,866,48,11.4,1,Mostly Clear,12.0,2021-11-06 12:00:00,12
379,530,909,49,12.2,1,Mostly Clear,11.3,2021-11-06 13:00:00,13
442,545,987,49,12.6,1,Mostly Clear,10.6,2021-11-06 14:00:00,14
398,581,979,49,12.5,2,Partly Cloudy,10.3,2021-11-06 15:00:00,15
476,614,1090,51,12.2,2,Partly Cloudy,10.1,2021-11-06 16:00:00,16
380,599,979,55,11.6,3,Cloudy,7.9,2021-11-06 17:00:00,17
237,435,672,60,10.5,3,Cloudy,5.9,2021-11-06 18:00:00,18
146,335,481,64,9.8,3,Cloudy,7.2,2021-11-06 19:00:00,19
118,299,417,68,9.2,3,Cloudy,7.8,2021-11-06 20:00:00,20
99,217,316,69,8.7,3,Cloudy,7.7,2021-11-06 21:00:00,21
103,228,331,72,8.1,2,Partly Cloudy,7.6,2021-11-06 22:00:00,22
92,191,283,74,7.6,1,Mostly Clear,8.1,2021-11-06 23:00:00,23
91,147,238,76,7.3,1,Mostly Clear,7.7,2021-11-07 00:00:00,0
94,136,230,79,6.7,1,Mostly Clear,8.1,2021-11-07 01:00:00,1
28,30,58,82,6.0,1,Mostly Clear,9.0,2021-11-07 02:00:00,2
10,6,16,85,5.6,1,Mostly Clear,9.2,2021-11-07 03:00:00,3
13,11,24,85,5.3,1,Mostly Clear,9.6,2021-11-07 04:00:00,4
8,12,20,85,5.0,1,Mostly Clear,8.9,2021-11-07 05:00:00,5
14,38,52,85,4.7,1,Mostly Clear,8.6,2021-11-07 06:00:00,6
26,78,104,85,4.3,1,Mostly Clear,10.5,2021-11-07 07:00:00,7
66,184,250,84,4.1,1,Mostly Clear,9.8,2021-11-07 08:00:00,8
164,323,487,79,5.4,1,Mostly Clear,11.2,2021-11-07 09:00:00,9
239,466,705,67,8.1,1,Mostly Clear,9.2,2021-11-07 10:00:00,10
244,513,757,59,10.3,1,Mostly Clear,10.2,2021-11-07 11:00:00,11
331,580,911,54,11.6,1,Mostly Clear,12.3,2021-11-07 12:00:00,12
334,634,968,49,12.4,1,Mostly Clear,11.6,2021-11-07 13:00:00,13
323,598,921,47,12.7,1,Mostly Clear,10.0,2021-11-07 14:00:00,14
287,608,895,42,13.2,1,Mostly Clear,9.1,2021-11-07 15:00:00,15
298,563,861,42,13.1,1,Mostly Clear,9.1,2021-11-07 16:00:00,16
214,492,706,46,12.4,1,Mostly Clear,7.6,2021-11-07 17:00:00,17
109,338,447,52,10.9,1,Mostly Clear,7.4,2021-11-07 18:00:00,18
74,202,276,57,9.7,1,Mostly Clear,9.2,2021-11-07 19:00:00,19
77,227,304,61,8.8,1,Mostly Clear,10.2,2021-11-07 20:00:00,20
64,149,213,64,8.0,1,Mostly Clear,10.6,2021-11-07 21:00:00,21
52,127,179,65,7.4,1,Mostly Clear,12.1,2021-11-07 22:00:00,22
34,58,92,66,7.0,0,Clear,12.4,2021-11-07 23:00:00,23
18,24,42,67,6.7,0,Clear,11.5,2021-11-08 00:00:00,0
8,11,19,68,6.5,0,Clear,12.0,2021-11-08 01:00:00,1
7,8,15,69,6.6,0,Clear,13.5,2021-11-08 02:00:00,2
3,2,5,65,6.8,0,Clear,13.7,2021-11-08 03:00:00,3
3,11,14,66,6.9,0,Clear,14.0,2021-11-08 04:00:00,4
9,49,58,68,6.9,0,Clear,13.7,2021-11-08 05:00:00,5
33,169,202,69,7.0,0,Clear,13.8,2021-11-08 06:00:00,6
56,430,486,71,6.9,0,Clear,12.9,2021-11-08 07:00:00,7
89,601,690,75,6.7,0,Clear,11.9,2021-11-08 08:00:00,8
77,367,444,74,8.1,0,Clear,12.6,2021-11-08 09:00:00,9
127,291,418,65,11.1,0,Clear,11.8,2021-11-08 10:00:00,10
127,278,405,59,13.7,0,Clear,11.9,2021-11-08 11:00:00,11
142,365,507,55,15.7,0,Clear,11.8,2021-11-08 12:00:00,12
143,371,514,52,17.2,0,Clear,11.4,2021-11-08 13:00:00,13
177,351,528,50,18.2,0,Clear,10.9,2021-11-08 14:00:00,14
191,454,645,48,19.2,0,Clear,10.2,2021-11-08 15:00:00,15
206,603,809,48,19.1,0,Clear,9.2,2021-11-08 16:00:00,16
225,815,1040,55,18.0,0,Clear,7.1,2021-11-08 17:00:00,17
172,734,906,61,16.0,0,Clear,8.2,2021-11-08 18:00:00,18
92,430,522,68,14.1,0,Clear,7.9,2021-11-08 19:00:00,19
83,306,389,73,12.7,0,Clear,7.6,2021-11-08 20:00:00,20
95,256,351,78,11.4,0,Clear,6.5,2021-11-08 21:00:00,21
45,142,187,82,10.3,0,Clear,6.4,2021-11-08 22:00:00,22
35,58,93,86,9.3,0,Clear,7.0,2021-11-08 23:00:00,23
16,25,41,88,8.5,0,Clear,7.5,2021-11-09 00:00:00,0
6,10,16,89,7.9,0,Clear,7.8,2021-11-09 01:00:00,1
3,4,7,90,7.4,0,Clear,8.2,2021-11-09 02:00:00,2
3,5,8,87,7.2,0,Clear,8.4,2021-11-09 03:00:00,3
3,13,16,87,7.0,0,Clear,8.6,2021-11-09 04:00:00,4
13,47,60,87,6.8,0,Clear,8.6,2021-11-09 05:00:00,5
28,170,198,88,6.4,0,Clear,9.7,2021-11-09 06:00:00,6
78,454,532,89,6.1,0,Clear,8.9,2021-11-09 07:00:00,7
135,745,880,90,5.9,0,Clear,8.0,2021-11-09 08:00:00,8
116,436,552,87,8.0,0,Clear,9.4,2021-11-09 09:00:00,9
131,299,430,67,13.3,0,Clear,6.9,2021-11-09 10:00:00,10
144,333,477,56,16.6,0,Clear,5.8,2021-11-09 11:00:00,11
163,414,577,48,18.8,0,Clear,5.9,2021-11-09 12:00:00,12
138,367,505,44,20.2,0,Clear,6.5,2021-11-09 13:00:00,13
174,405,579,42,21.0,0,Clear,7.2,2021-11-09 14:00:00,14
233,473,706,40,21.7,0,Clear,7.0,2021-11-09 15:00:00,15
245,673,918,42,21.4,0,Clear,6.4,2021-11-09 16:00:00,16
247,900,1147,51,20.2,0,Clear,6.0,2021-11-09 17:00:00,17
219,795,1014,56,18.1,0,Clear,9.4,2021-11-09 18:00:00,18
142,521,663,64,15.7,0,Clear,7.6,2021-11-09 19:00:00,19
121,356,477,70,14.1,0,Clear,8.6,2021-11-09 20:00:00,20
97,258,355,75,12.9,0,Clear,9.2,2021-11-09 21:00:00,21
64,182,246,79,11.9,0,Clear,8.6,2021-11-09 22:00:00,22
42,94,136,83,11.0,0,Clear,8.2,2021-11-09 23:00:00,23
19,28,47,85,10.1,0,Clear,8.2,2021-11-10 00:00:00,0
8,15,23,87,9.4,1,Mostly Clear,7.6,2021-11-10 01:00:00,1
6,9,15,87,9.1,1,Mostly Clear,8.0,2021-11-10 02:00:00,2
2,3,5,82,9.1,2,Partly Cloudy,8.2,2021-11-10 03:00:00,3
6,11,17,81,9.0,3,Cloudy,8.0,2021-11-10 04:00:00,4
15,38,53,75,9.7,3,Cloudy,10.2,2021-11-10 05:00:00,5
33,191,224,67,11.1,3,Cloudy,12.0,2021-11-10 06:00:00,6
95,525,620,64,12.0,2,Partly Cloudy,10.3,2021-11-10 07:00:00,7
156,804,960,64,12.5,0,Clear,10.2,2021-11-10 08:00:00,8
116,472,588,65,13.3,0,Clear,10.7,2021-11-10 09:00:00,9
112,339,451,63,15.2,0,Clear,11.2,2021-11-10 10:00:00,10
125,307,432,59,16.7,0,Clear,11.8,2021-11-10 11:00:00,11
166,422,588,58,17.9,0,Clear,10.9,2021-11-10 12:00:00,12
161,402,563,56,18.7,0,Clear,9.6,2021-11-10 13:00:00,13
172,426,598,55,19.3,0,Clear,7.2,2021-11-10 14:00:00,14
221,504,725,50,20.7,0,Clear,5.5,2021-11-10 15:00:00,15
241,668,909,50,20.6,0,Clear,4.3,2021-11-10 16:00:00,16
272,952,1224,56,19.7,0,Clear,2.9,2021-11-10 17:00:00,17
212,799,1011,62,18.0,0,Clear,4.0,2021-11-10 18:00:00,18
191,603,794,72,15.6,0,Clear,5.9,2021-11-10 19:00:00,19
134,402,536,79,13.9,0,Clear,6.9,2021-11-10 20:00:00,20
102,307,409,84,12.7,0,Clear,7.5,2021-11-10 21:00:00,21
85,207,292,86,12.0,0,Clear,9.4,2021-11-10 22:00:00,22
64,143,207,87,11.5,0,Clear,10.1,2021-11-10 23:00:00,23
34,70,104,87,11.1,0,Clear,9.8,2021-11-11 00:00:00,0
30,38,68,87,10.8,0,Clear,9.1,2021-11-11 01:00:00,1
16,21,37,88,10.4,0,Clear,9.1,2021-11-11 02:00:00,2
6,7,13,84,10.1,0,Clear,9.4,2021-11-11 03:00:00,3
13,13,26,85,9.9,1,Mostly Clear,10.5,2021-11-11 04:00:00,4
18,29,47,86,9.7,1,Mostly Clear,10.5,2021-11-11 05:00:00,5
32,116,148,89,9.5,1,Mostly Clear,9.0,2021-11-11 06:00:00,6
71,278,349,91,9.3,0,Clear,9.7,2021-11-11 07:00:00,7
109,497,606,94,9.2,1,Mostly Clear,10.1,2021-11-11 08:00:00,8
140,443,583,94,10.5,1,Mostly Clear,10.5,2021-11-11 09:00:00,9
162,428,590,84,13.8,1,Mostly Clear,10.0,2021-11-11 10:00:00,10
226,497,723,76,15.9,1,Mostly Clear,11.4,2021-11-11 11:00:00,11
273,560,833,71,17.6,1,Mostly Clear,12.7,2021-11-11 12:00:00,12
265,533,798,68,18.8,1,Mostly Clear,13.8,2021-11-11 13:00:00,13
313,578,891,65,19.8,1,Mostly Clear,14.5,2021-11-11 14:00:00,14
333,598,931,67,19.7,1,Mostly Clear,16.0,2021-11-11 15:00:00,15
317,647,964,70,19.4,1,Mostly Clear,16.6,2021-11-11 16:00:00,16
284,750,1034,73,18.8,1,Mostly Clear,15.7,2021-11-11 17:00:00,17
184,659,843,79,17.2,1,Mostly Clear,14.3,2021-11-11 18:00:00,18
163,452,615,83,16.1,1,Mostly Clear,13.8,2021-11-11 19:00:00,19
111,329,440,83,15.5,2,Partly Cloudy,13.8,2021-11-11 20:00:00,20
119,261,380,81,15.3,2,Partly Cloudy,14.3,2021-11-11 21:00:00,21
109,185,294,80,15.5,2,Partly Cloudy,14.9,2021-11-11 22:00:00,22
85,145,230,82,15.9,2,Partly Cloudy,16.8,2021-11-11 23:00:00,23
56,83,139,86,16.1,51,Light Drizzle,18.2,2021-11-12 00:00:00,0
31,31,62,88,16.3,51,Light Drizzle,19.2,2021-11-12 01:00:00,1
4,14,18,88,16.4,51,Light Drizzle,19.1,2021-11-12 02:00:00,2
6,3,9,89,16.9,51,Light Drizzle,19.7,2021-11-12 03:00:00,3
4,7,11,90,16.8,53,Heavy Drizzle,20.5,2021-11-12 04:00:00,4
4,17,21,94,16.6,55,Heavy Drizzle,20.5,2021-11-12 05:00:00,5
17,65,82,95,16.6,55,Heavy Drizzle,17.3,2021-11-12 06:00:00,6
29,156,185,96,16.5,61,Light Rain,16.0,2021-11-12 07:00:00,7
43,218,261,97,16.5,63,Rain,11.0,2021-11-12 08:00:00,8
93,272,365,95,15.2,63,Rain,10.1,2021-11-12 09:00:00,9
132,275,407,88,12.7,53,Heavy Drizzle,16.1,2021-11-12 10:00:00,10
190,342,532,86,12.5,51,Light Drizzle,12.5,2021-11-12 11:00:00,11
215,412,627,68,14.5,2,Partly Cloudy,11.5,2021-11-12 12:00:00,12
261,440,701,54,16.3,0,Clear,12.6,2021-11-12 13:00:00,13
349,487,836,44,17.2,0,Clear,7.9,2021-11-12 14:00:00,14
395,549,944,45,17.8,0,Clear,9.2,2021-11-12 15:00:00,15
381,668,1049,43,17.7,0,Clear,6.5,2021-11-12 16:00:00,16
332,685,1017,48,17.0,0,Clear,5.0,2021-11-12 17:00:00,17
230,572,802,47,16.4,0,Clear,0.8,2021-11-12 18:00:00,18
163,428,591,69,12.9,0,Clear,4.0,2021-11-12 19:00:00,19
161,354,515,75,11.3,0,Clear,6.4,2021-11-12 20:00:00,20
134,262,396,81,10.5,0,Clear,8.3,2021-11-12 21:00:00,21
75,173,248,86,9.8,0,Clear,8.7,2021-11-12 22:00:00,22
92,197,289,88,9.2,0,Clear,8.4,2021-11-12 23:00:00,23
79,140,219,86,8.7,0,Clear,8.0,2021-11-13 00:00:00,0
69,107,176,83,8.3,0,Clear,8.0,2021-11-13 01:00:00,1
52,60,112,80,7.9,0,Clear,7.6,2021-11-13 02:00:00,2
29,24,53,86,7.5,0,Clear,7.9,2021-11-13 03:00:00,3
13,12,25,82,7.4,0,Clear,8.7,2021-11-13 04:00:00,4
21,18,39,81,7.5,0,Clear,10.0,2021-11-13 05:00:00,5
29,72,101,80,7.6,0,Clear,10.0,2021-11-13 06:00:00,6
139,220,359,80,7.8,1,Mostly Clear,9.5,2021-11-13 07:00:00,7
166,275,441,81,7.9,2,Partly Cloudy,8.6,2021-11-13 08:00:00,8
306,422,728,80,9.1,2,Partly Cloudy,7.9,2021-11-13 09:00:00,9
408,507,915,72,10.6,2,Partly Cloudy,6.1,2021-11-13 10:00:00,10
336,444,780,68,11.1,1,Mostly Clear,9.4,2021-11-13 11:00:00,11
234,374,608,64,11.1,51,Light Drizzle,15.6,2021-11-13 12:00:00,12
345,482,827,68,10.2,51,Light Drizzle,28.6,2021-11-13 13:00:00,13
396,450,846,56,10.8,1,Mostly Clear,19.1,2021-11-13 14:00:00,14
386,494,880,62,9.3,1,Mostly Clear,24.0,2021-11-13 15:00:00,15
289,489,778,51,9.9,0,Clear,21.8,2021-11-13 16:00:00,16
218,395,613,41,9.7,0,Clear,19.5,2021-11-13 17:00:00,17
120,344,464,40,8.8,0,Clear,15.1,2021-11-13 18:00:00,18
95,258,353,41,8.1,0,Clear,13.2,2021-11-13 19:00:00,19
88,190,278,44,7.5,0,Clear,13.7,2021-11-13 20:00:00,20
59,177,236,47,6.9,0,Clear,12.9,2021-11-13 21:00:00,21
75,152,227,50,6.2,0,Clear,11.8,2021-11-13 22:00:00,22
73,127,200,52,5.7,0,Clear,11.3,2021-11-13 23:00:00,23
52,130,182,56,4.9,0,Clear,10.8,2021-11-14 00:00:00,0
81,105,186,62,4.0,0,Clear,9.7,2021-11-14 01:00:00,1
31,61,92,67,3.2,0,Clear,9.0,2021-11-14 02:00:00,2
14,17,31,71,2.5,0,Clear,8.6,2021-11-14 03:00:00,3
7,18,25,75,1.9,0,Clear,7.6,2021-11-14 04:00:00,4
10,11,21,77,1.5,0,Clear,8.0,2021-11-14 05:00:00,5
8,29,37,78,1.2,0,Clear,7.3,2021-11-14 06:00:00,6
30,51,81,80,1.1,0,Clear,6.8,2021-11-14 07:00:00,7
57,139,196,82,0.9,0,Clear,8.1,2021-11-14 08:00:00,8
120,278,398,82,2.5,1,Mostly Clear,9.0,2021-11-14 09:00:00,9
192,373,565,63,5.7,1,Mostly Clear,8.0,2021-11-14 10:00:00,10
206,442,648,56,6.8,1,Mostly Clear,8.9,2021-11-14 11:00:00,11
234,437,671,52,7.7,3,Cloudy,8.4,2021-11-14 12:00:00,12
245,466,711,50,8.4,2,Partly Cloudy,10.8,2021-11-14 13:00:00,13
295,446,741,49,8.8,0,Clear,13.2,2021-11-14 14:00:00,14
204,435,639,45,9.5,0,Clear,14.5,2021-11-14 15:00:00,15
187,403,590,43,9.7,0,Clear,15.3,2021-11-14 16:00:00,16
147,351,498,42,9.5,2,Partly Cloudy,13.1,2021-11-14 17:00:00,17
91,272,363,44,9.0,2,Partly Cloudy,9.3,2021-11-14 18:00:00,18
81,206,287,46,8.8,2,Partly Cloudy,9.1,2021-11-14 19:00:00,19
46,147,193,48,8.6,2,Partly Cloudy,10.6,2021-11-14 20:00:00,20
58,145,203,49,8.6,2,Partly Cloudy,12.3,2021-11-14 21:00:00,21
42,102,144,52,8.3,1,Mostly Clear,10.0,2021-11-14 22:00:00,22
38,55,93,55,8.0,1,Mostly Clear,8.9,2021-11-14 23:00:00,23
15,24,39,56,7.9,1,Mostly Clear,9.7,2021-11-15 00:00:00,0
7,8,15,59,7.2,0,Clear,10.5,2021-11-15 01:00:00,1
10,7,17,62,6.6,0,Clear,9.6,2021-11-15 02:00:00,2
3,2,5,69,5.7,51,Light Drizzle,10.3,2021-11-15 03:00:00,3
9,4,13,71,5.9,2,Partly Cloudy,14.2,2021-11-15 04:00:00,4
18,33,51,68,5.7,0,Clear,19.1,2021-11-15 05:00:00,5
39,140,179,63,4.9,0,Clear,15.5,2021-11-15 06:00:00,6
62,353,415,61,4.3,0,Clear,12.6,2021-11-15 07:00:00,7
100,520,620,62,4.0,0,Clear,10.8,2021-11-15 08:00:00,8
54,298,352,63,4.5,3,Cloudy,14.3,2021-11-15 09:00:00,9
83,223,306,58,5.8,3,Cloudy,17.3,2021-11-15 10:00:00,10
100,228,328,54,7.3,0,Clear,22.3,2021-11-15 11:00:00,11
113,252,365,49,8.8,2,Partly Cloudy,27.1,2021-11-15 12:00:00,12
109,248,357,46,9.5,2,Partly Cloudy,28.5,2021-11-15 13:00:00,13
107,293,400,46,9.6,1,Mostly Clear,24.5,2021-11-15 14:00:00,14
109,318,427,44,9.8,0,Clear,22.4,2021-11-15 15:00:00,15
131,428,559,43,9.6,0,Clear,20.9,2021-11-15 16:00:00,16
130,611,741,41,9.0,0,Clear,17.4,2021-11-15 17:00:00,17
115,548,663,43,7.9,0,Clear,13.2,2021-11-15 18:00:00,18
59,388,447,45,6.9,0,Clear,11.6,2021-11-15 19:00:00,19
42,217,259,46,6.1,0,Clear,8.9,2021-11-15 20:00:00,20
53,198,251,48,5.4,0,Clear,7.6,2021-11-15 21:00:00,21
29,108,137,51,4.7,0,Clear,8.3,2021-11-15 22:00:00,22
17,56,73,56,4.0,0,Clear,9.4,2021-11-15 23:00:00,23
15,27,42,60,3.4,0,Clear,9.5,2021-11-16 00:00:00,0
8,9,17,63,2.9,0,Clear,9.0,2021-11-16 01:00:00,1
4,3,7,67,2.4,0,Clear,9.3,2021-11-16 02:00:00,2
5,5,10,71,2.0,0,Clear,9.2,2021-11-16 03:00:00,3
1,7,8,74,1.5,0,Clear,8.8,2021-11-16 04:00:00,4
11,43,54,77,1.1,0,Clear,8.4,2021-11-16 05:00:00,5
23,156,179,79,0.9,0,Clear,7.6,2021-11-16 06:00:00,6
58,409,467,79,0.8,0,Clear,8.1,2021-11-16 07:00:00,7
96,635,731,79,1.0,0,Clear,8.9,2021-11-16 08:00:00,8
94,400,494,75,2.7,0,Clear,7.3,2021-11-16 09:00:00,9
119,229,348,63,5.9,0,Clear,4.6,2021-11-16 10:00:00,10
92,266,358,54,8.0,0,Clear,6.5,2021-11-16 11:00:00,11
117,358,475,54,9.3,0,Clear,8.3,2021-11-16 12:00:00,12
105,292,397,53,10.3,0,Clear,7.9,2021-11-16 13:00:00,13
104,353,457,52,11.1,0,Clear,7.2,2021-11-16 14:00:00,14
135,377,512,49,12.0,0,Clear,6.9,2021-11-16 15:00:00,15
142,537,679,48,12.1,1,Mostly Clear,6.8,2021-11-16 16:00:00,16
164,726,890,50,11.8,2,Partly Cloudy,4.0,2021-11-16 17:00:00,17
135,599,734,58,10.9,1,Mostly Clear,1.4,2021-11-16 18:00:00,18
114,449,563,64,8.9,0,Clear,3.4,2021-11-16 19:00:00,19
80,348,428,70,7.6,0,Clear,5.2,2021-11-16 20:00:00,20
60,209,269,75,6.6,0,Clear,4.8,2021-11-16 21:00:00,21
60,186,246,79,5.8,0,Clear,7.4,2021-11-16 22:00:00,22
32,82,114,82,5.3,0,Clear,6.1,2021-11-16 23:00:00,23
15,27,42,86,4.9,0,Clear,6.6,2021-11-17 00:00:00,0
9,9,18,89,4.6,0,Clear,6.6,2021-11-17 01:00:00,1
3,1,4,91,4.4,0,Clear,6.9,2021-11-17 02:00:00,2
1,7,8,91,4.3,0,Clear,7.1,2021-11-17 03:00:00,3
3,7,10,93,4.3,1,Mostly Clear,7.1,2021-11-17 04:00:00,4
12,41,53,94,4.4,1,Mostly Clear,7.1,2021-11-17 05:00:00,5
32,154,186,95,4.4,1,Mostly Clear,7.9,2021-11-17 06:00:00,6
77,417,494,95,4.2,0,Clear,8.2,2021-11-17 07:00:00,7
119,641,760,95,4.6,1,Mostly Clear,6.8,2021-11-17 08:00:00,8
106,408,514,93,6.1,1,Mostly Clear,4.3,2021-11-17 09:00:00,9
107,276,383,79,8.8,2,Partly Cloudy,3.7,2021-11-17 10:00:00,10
115,303,418,69,10.8,2,Partly Cloudy,4.2,2021-11-17 11:00:00,11
107,391,498,64,12.3,1,Mostly Clear,4.7,2021-11-17 12:00:00,12
130,345,475,61,13.8,1,Mostly Clear,5.4,2021-11-17 13:00:00,13
148,399,547,58,15.6,1,Mostly Clear,7.5,2021-11-17 14:00:00,14
189,434,623,57,15.9,0,Clear,9.8,2021-11-17 15:00:00,15
183,571,754,58,16.2,0,Clear,10.2,2021-11-17 16:00:00,16
207,800,1007,62,15.4,0,Clear,8.3,2021-11-17 17:00:00,17
151,713,864,71,13.4,0,Clear,8.1,2021-11-17 18:00:00,18
126,514,640,78,12.5,1,Mostly Clear,9.4,2021-11-17 19:00:00,19
93,353,446,84,12.2,1,Mostly Clear,10.0,2021-11-17 20:00:00,20
82,249,331,88,12.3,0,Clear,11.3,2021-11-17 21:00:00,21
70,196,266,89,12.6,0,Clear,13.0,2021-11-17 22:00:00,22
34,130,164,88,12.7,0,Clear,14.1,2021-11-17 23:00:00,23
26,33,59,86,12.6,0,Clear,14.7,2021-11-18 00:00:00,0
8,15,23,85,12.4,0,Clear,14.8,2021-11-18 01:00:00,1
10,12,22,86,12.2,0,Clear,14.5,2021-11-18 02:00:00,2
4,3,7,82,12.1,0,Clear,13.9,2021-11-18 03:00:00,3
7,8,15,85,11.7,0,Clear,13.2,2021-11-18 04:00:00,4
9,48,57,88,11.2,0,Clear,12.2,2021-11-18 05:00:00,5
34,143,177,90,10.9,0,Clear,11.0,2021-11-18 06:00:00,6
67,427,494,91,10.7,0,Clear,11.0,2021-11-18 07:00:00,7
130,623,753,91,10.6,0,Clear,11.4,2021-11-18 08:00:00,8
127,419,546,88,11.5,0,Clear,13.1,2021-11-18 09:00:00,9
115,291,406,79,13.9,0,Clear,13.2,2021-11-18 10:00:00,10
165,311,476,69,16.3,0,Clear,15.4,2021-11-18 11:00:00,11
174,438,612,61,18.3,0,Clear,16.6,2021-11-18 12:00:00,12
205,410,615,56,19.8,0,Clear,17.7,2021-11-18 13:00:00,13
205,475,680,53,20.9,0,Clear,18.2,2021-11-18 14:00:00,14
204,480,684,49,22.0,0,Clear,17.9,2021-11-18 15:00:00,15
245,669,914,49,21.9,0,Clear,16.8,2021-11-18 16:00:00,16
223,772,995,50,21.1,1,Mostly Clear,16.4,2021-11-18 17:00:00,17
144,522,666,52,19.9,2,Partly Cloudy,14.3,2021-11-18 18:00:00,18
69,307,376,66,17.8,51,Light Drizzle,10.4,2021-11-18 19:00:00,19
52,223,275,87,13.4,53,Heavy Drizzle,19.5,2021-11-18 20:00:00,20
50,172,222,89,11.1,53,Heavy Drizzle,20.9,2021-11-18 21:00:00,21
67,164,231,86,9.3,55,Heavy Drizzle,18.7,2021-11-18 22:00:00,22
54,129,183,85,8.2,55,Heavy Drizzle,18.9,2021-11-18 23:00:00,23
20,53,73,76,7.8,51,Light Drizzle,19.7,2021-11-19 00:00:00,0
13,19,32,65,7.7,1,Mostly Clear,21.0,2021-11-19 01:00:00,1
9,12,21,57,7.2,0,Clear,20.4,2021-11-19 02:00:00,2
5,8,13,48,7.3,0,Clear,18.5,2021-11-19 03:00:00,3
8,10,18,49,6.6,0,Clear,15.8,2021-11-19 04:00:00,4
9,34,43,49,6.1,0,Clear,14.3,2021-11-19 05:00:00,5
31,141,172,49,5.7,2,Partly Cloudy,14.0,2021-11-19 06:00:00,6
69,360,429,48,5.4,0,Clear,14.7,2021-11-19 07:00:00,7
104,454,558,48,5.0,0,Clear,15.0,2021-11-19 08:00:00,8
83,336,419,44,4.9,0,Clear,16.3,2021-11-19 09:00:00,9
110,223,333,42,5.1,0,Clear,21.8,2021-11-19 10:00:00,10
96,254,350,42,5.7,0,Clear,21.7,2021-11-19 11:00:00,11
122,329,451,42,6.5,0,Clear,21.4,2021-11-19 12:00:00,12
118,332,450,41,7.2,0,Clear,20.6,2021-11-19 13:00:00,13
121,397,518,40,7.8,0,Clear,19.6,2021-11-19 14:00:00,14
155,415,570,39,8.2,0,Clear,19.2,2021-11-19 15:00:00,15
171,504,675,39,7.9,0,Clear,18.9,2021-11-19 16:00:00,16
143,569,712,40,7.2,0,Clear,17.6,2021-11-19 17:00:00,17
141,518,659,42,6.2,0,Clear,13.8,2021-11-19 18:00:00,18
98,355,453,45,5.3,0,Clear,14.0,2021-11-19 19:00:00,19
64,208,272,47,4.7,0,Clear,12.4,2021-11-19 20:00:00,20
57,160,217,50,4.0,0,Clear,10.9,2021-11-19 21:00:00,21
48,158,206,53,3.4,0,Clear,10.1,2021-11-19 22:00:00,22
60,124,184,60,2.6,0,Clear,6.9,2021-11-19 23:00:00,23
48,114,162,69,1.5,0,Clear,5.9,2021-11-20 00:00:00,0
55,70,125,72,1.0,0,Clear,6.1,2021-11-20 01:00:00,1
28,49,77,73,0.8,0,Clear,6.1,2021-11-20 02:00:00,2
16,18,34,78,0.0,0,Clear,5.9,2021-11-20 03:00:00,3
6,15,21,79,-0.3,0,Clear,5.6,2021-11-20 04:00:00,4
3,13,16,80,-0.4,0,Clear,4.8,2021-11-20 05:00:00,5
12,40,52,81,-0.6,0,Clear,4.7,2021-11-20 06:00:00,6
21,75,96,82,-0.7,0,Clear,4.7,2021-11-20 07:00:00,7
52,147,199,81,-0.4,0,Clear,5.0,2021-11-20 08:00:00,8
105,302,407,76,1.3,0,Clear,3.1,2021-11-20 09:00:00,9
149,361,510,66,3.8,1,Mostly Clear,1.8,2021-11-20 10:00:00,10
234,489,723,61,6.0,1,Mostly Clear,4.3,2021-11-20 11:00:00,11
249,507,756,56,7.3,1,Mostly Clear,6.9,2021-11-20 12:00:00,12
303,410,713,53,8.1,1,Mostly Clear,7.4,2021-11-20 13:00:00,13
291,463,754,52,8.5,2,Partly Cloudy,8.7,2021-11-20 14:00:00,14
279,473,752,50,8.2,2,Partly Cloudy,9.7,2021-11-20 15:00:00,15
206,410,616,51,8.1,2,Partly Cloudy,10.0,2021-11-20 16:00:00,16
105,310,415,52,7.8,2,Partly Cloudy,9.4,2021-11-20 17:00:00,17
90,301,391,57,6.9,2,Partly Cloudy,9.0,2021-11-20 18:00:00,18
83,207,290,60,6.5,1,Mostly Clear,8.4,2021-11-20 19:00:00,19
66,187,253,65,6.0,1,Mostly Clear,5.8,2021-11-20 20:00:00,20
70,154,224,73,5.1,1,Mostly Clear,7.2,2021-11-20 21:00:00,21
66,167,233,81,4.0,0,Clear,7.4,2021-11-20 22:00:00,22
52,130,182,86,3.3,1,Mostly Clear,9.3,2021-11-20 23:00:00,23
40,93,133,88,3.1,1,Mostly Clear,8.6,2021-11-21 00:00:00,0
50,52,102,90,3.0,1,Mostly Clear,8.7,2021-11-21 01:00:00,1
42,59,101,91,3.0,2,Partly Cloudy,9.7,2021-11-21 02:00:00,2
35,21,56,93,3.0,2,Partly Cloudy,9.8,2021-11-21 03:00:00,3
10,23,33,93,3.0,2,Partly Cloudy,8.3,2021-11-21 04:00:00,4
12,14,26,94,2.7,2,Partly Cloudy,8.0,2021-11-21 05:00:00,5
15,41,56,92,2.7,1,Mostly Clear,7.3,2021-11-21 06:00:00,6
13,44,57,92,2.5,1,Mostly Clear,7.1,2021-11-21 07:00:00,7
45,138,183,91,2.3,1,Mostly Clear,6.6,2021-11-21 08:00:00,8
99,223,322,89,2.9,1,Mostly Clear,7.7,2021-11-21 09:00:00,9
177,324,501,72,6.1,1,Mostly Clear,6.3,2021-11-21 10:00:00,10
199,395,594,63,8.0,1,Mostly Clear,7.4,2021-11-21 11:00:00,11
241,422,663,57,10.2,1,Mostly Clear,9.0,2021-11-21 12:00:00,12
209,445,654,55,11.8,2,Partly Cloudy,11.0,2021-11-21 13:00:00,13
257,371,628,57,12.2,3,Cloudy,11.0,2021-11-21 14:00:00,14
271,423,694,57,11.5,3,Cloudy,10.7,2021-11-21 15:00:00,15
190,409,599,60,11.3,3,Cloudy,8.6,2021-11-21 16:00:00,16
131,309,440,64,10.7,3,Cloudy,8.8,2021-11-21 17:00:00,17
97,276,373,69,10.0,2,Partly Cloudy,8.1,2021-11-21 18:00:00,18
98,200,298,74,9.5,2,Partly Cloudy,8.1,2021-11-21 19:00:00,19
65,141,206,76,9.2,3,Cloudy,10.0,2021-11-21 20:00:00,20
43,101,144,77,9.4,3,Cloudy,12.1,2021-11-21 21:00:00,21
39,73,112,77,9.7,3,Cloudy,12.9,2021-11-21 22:00:00,22
29,67,96,78,10.0,3,Cloudy,12.7,2021-11-21 23:00:00,23
14,18,32,79,10.0,3,Cloudy,12.5,2021-11-22 00:00:00,0
8,9,17,80,9.9,3,Cloudy,12.2,2021-11-22 01:00:00,1
5,9,14,82,9.7,51,Light Drizzle,11.7,2021-11-22 02:00:00,2
0,5,5,92,9.1,53,Heavy Drizzle,10.8,2021-11-22 03:00:00,3
4,9,13,93,8.7,53,Heavy Drizzle,10.0,2021-11-22 04:00:00,4
14,29,43,94,8.4,53,Heavy Drizzle,9.4,2021-11-22 05:00:00,5
20,109,129,94,8.0,53,Heavy Drizzle,6.4,2021-11-22 06:00:00,6
35,260,295,94,7.7,51,Light Drizzle,6.4,2021-11-22 07:00:00,7
60,437,497,94,7.5,3,Cloudy,8.2,2021-11-22 08:00:00,8
79,282,361,91,7.7,2,Partly Cloudy,8.4,2021-11-22 09:00:00,9
110,236,346,89,8.2,2,Partly Cloudy,9.5,2021-11-22 10:00:00,10
132,234,366,85,8.9,1,Mostly Clear,11.2,2021-11-22 11:00:00,11
138,266,404,76,9.7,1,Mostly Clear,12.5,2021-11-22 12:00:00,12
163,275,438,67,10.2,1,Mostly Clear,15.0,2021-11-22 13:00:00,13
189,316,505,54,10.3,1,Mostly Clear,17.8,2021-11-22 14:00:00,14
176,396,572,48,11.1,2,Partly Cloudy,19.6,2021-11-22 15:00:00,15
168,402,570,43,10.3,1,Mostly Clear,19.2,2021-11-22 16:00:00,16
146,518,664,42,8.8,0,Clear,17.7,2021-11-22 17:00:00,17
109,420,529,43,7.4,1,Mostly Clear,15.0,2021-11-22 18:00:00,18
62,305,367,44,6.1,2,Partly Cloudy,16.9,2021-11-22 19:00:00,19
43,180,223,42,5.4,3,Cloudy,17.5,2021-11-22 20:00:00,20
55,159,214,42,4.8,0,Clear,16.9,2021-11-22 21:00:00,21
27,91,118,43,4.1,0,Clear,16.0,2021-11-22 22:00:00,22
19,56,75,43,3.6,0,Clear,15.6,2021-11-22 23:00:00,23
16,26,42,44,3.0,0,Clear,14.2,2021-11-23 00:00:00,0
4,10,14,46,2.5,0,Clear,13.4,2021-11-23 01:00:00,1
3,4,7,48,2.0,0,Clear,14.0,2021-11-23 02:00:00,2
7,5,12,50,1.4,0,Clear,14.1,2021-11-23 03:00:00,3
6,13,19,51,1.1,0,Clear,14.0,2021-11-23 04:00:00,4
9,33,42,54,0.8,0,Clear,13.5,2021-11-23 05:00:00,5
24,108,132,56,0.6,0,Clear,14.8,2021-11-23 06:00:00,6
49,266,315,57,0.5,0,Clear,13.7,2021-11-23 07:00:00,7
74,389,463,60,0.3,0,Clear,12.5,2021-11-23 08:00:00,8
77,258,335,63,0.7,0,Clear,11.9,2021-11-23 09:00:00,9
95,216,311,57,2.3,0,Clear,14.2,2021-11-23 10:00:00,10
91,202,293,51,3.6,0,Clear,16.6,2021-11-23 11:00:00,11
147,300,447,46,4.8,0,Clear,18.6,2021-11-23 12:00:00,12
122,252,374,39,5.8,1,Mostly Clear,20.8,2021-11-23 13:00:00,13
140,281,421,34,6.4,1,Mostly Clear,20.2,2021-11-23 14:00:00,14
124,323,447,31,6.4,2,Partly Cloudy,19.7,2021-11-23 15:00:00,15
141,407,548,30,6.3,2,Partly Cloudy,19.5,2021-11-23 16:00:00,16
129,448,577,30,5.9,2,Partly Cloudy,17.0,2021-11-23 17:00:00,17
95,368,463,33,5.0,0,Clear,12.3,2021-11-23 18:00:00,18
63,215,278,36,3.9,0,Clear,10.8,2021-11-23 19:00:00,19
36,164,200,39,3.1,0,Clear,11.6,2021-11-23 20:00:00,20
37,112,149,42,2.4,0,Clear,12.7,2021-11-23 21:00:00,21
30,81,111,45,1.9,0,Clear,12.4,2021-11-23 22:00:00,22
17,39,56,48,1.3,0,Clear,11.4,2021-11-23 23:00:00,23
10,22,32,51,0.8,0,Clear,11.3,2021-11-24 00:00:00,0
18,16,34,54,0.2,0,Clear,10.8,2021-11-24 01:00:00,1
6,7,13,57,-0.3,0,Clear,9.7,2021-11-24 02:00:00,2
2,3,5,60,-0.8,0,Clear,8.6,2021-11-24 03:00:00,3
8,11,19,64,-1.4,0,Clear,8.3,2021-11-24 04:00:00,4
11,25,36,68,-1.9,0,Clear,8.1,2021-11-24 05:00:00,5
18,69,87,70,-2.1,0,Clear,7.6,2021-11-24 06:00:00,6
29,142,171,68,-1.8,0,Clear,6.1,2021-11-24 07:00:00,7
52,212,264,70,-1.9,0,Clear,5.8,2021-11-24 08:00:00,8
53,219,272,68,-0.5,0,Clear,7.4,2021-11-24 09:00:00,9
64,206,270,56,2.6,0,Clear,5.5,2021-11-24 10:00:00,10
120,231,351,47,4.6,0,Clear,5.8,2021-11-24 11:00:00,11
149,303,452,43,5.9,0,Clear,5.0,2021-11-24 12:00:00,12
183,297,480,41,6.9,0,Clear,4.3,2021-11-24 13:00:00,13
181,357,538,39,7.7,0,Clear,5.9,2021-11-24 14:00:00,14
237,353,590,39,8.4,0,Clear,6.5,2021-11-24 15:00:00,15
184,367,551,39,8.4,1,Mostly Clear,7.0,2021-11-24 16:00:00,16
124,311,435,42,7.8,1,Mostly Clear,5.1,2021-11-24 17:00:00,17
72,224,296,48,6.6,1,Mostly Clear,6.5,2021-11-24 18:00:00,18
63,211,274,56,5.0,1,Mostly Clear,6.0,2021-11-24 19:00:00,19
38,119,157,65,3.6,0,Clear,6.6,2021-11-24 20:00:00,20
47,95,142,70,2.6,0,Clear,6.9,2021-11-24 21:00:00,21
46,87,133,73,1.9,0,Clear,7.8,2021-11-24 22:00:00,22
44,47,91,73,1.5,0,Clear,8.9,2021-11-24 23:00:00,23
28,41,69,74,1.2,0,Clear,9.0,2021-11-25 00:00:00,0
29,31,60,75,0.9,0,Clear,9.5,2021-11-25 01:00:00,1
25,19,44,75,0.6,0,Clear,9.2,2021-11-25 02:00:00,2
17,16,33,75,0.4,1,Mostly Clear,8.5,2021-11-25 03:00:00,3
3,3,6,76,0.1,1,Mostly Clear,8.4,2021-11-25 04:00:00,4
6,8,14,78,0.0,1,Mostly Clear,8.2,2021-11-25 05:00:00,5
9,30,39,78,0.3,1,Mostly Clear,6.3,2021-11-25 06:00:00,6
16,62,78,79,0.3,1,Mostly Clear,6.6,2021-11-25 07:00:00,7
38,100,138,80,0.7,1,Mostly Clear,4.7,2021-11-25 08:00:00,8
61,134,195,82,1.1,1,Mostly Clear,6.3,2021-11-25 09:00:00,9
123,171,294,65,4.0,1,Mostly Clear,5.1,2021-11-25 10:00:00,10
158,204,362,58,6.2,1,Mostly Clear,4.4,2021-11-25 11:00:00,11
212,206,418,53,8.6,1,Mostly Clear,4.1,2021-11-25 12:00:00,12
223,179,402,48,10.8,1,Mostly Clear,3.7,2021-11-25 13:00:00,13
207,222,429,45,12.3,1,Mostly Clear,5.1,2021-11-25 14:00:00,14
214,199,413,45,13.1,0,Clear,6.6,2021-11-25 15:00:00,15
190,217,407,45,13.2,0,Clear,6.6,2021-11-25 16:00:00,16
96,119,215,51,12.3,1,Mostly Clear,5.6,2021-11-25 17:00:00,17
53,84,137,56,10.3,1,Mostly Clear,7.4,2021-11-25 18:00:00,18
42,59,101,59,9.2,1,Mostly Clear,7.0,2021-11-25 19:00:00,19
40,80,120,61,8.6,2,Partly Cloudy,7.0,2021-11-25 20:00:00,20
59,61,120,61,8.6,1,Mostly Clear,6.3,2021-11-25 21:00:00,21
37,67,104,63,8.4,3,Cloudy,6.0,2021-11-25 22:00:00,22
18,47,65,65,8.1,3,Cloudy,7.1,2021-11-25 23:00:00,23
6,11,17,70,8.1,3,Cloudy,8.7,2021-11-26 00:00:00,0
2,6,8,80,7.8,53,Heavy Drizzle,7.9,2021-11-26 01:00:00,1
0,3,3,91,7.4,53,Heavy Drizzle,6.3,2021-11-26 02:00:00,2
5,2,7,92,7.8,61,Light Rain,7.3,2021-11-26 03:00:00,3
3,5,8,94,7.8,53,Heavy Drizzle,7.6,2021-11-26 04:00:00,4
3,5,8,95,7.9,51,Light Drizzle,10.4,2021-11-26 05:00:00,5
7,29,36,94,7.9,1,Mostly Clear,10.0,2021-11-26 06:00:00,6
17,56,73,91,7.5,1,Mostly Clear,15.5,2021-11-26 07:00:00,7
38,91,129,88,6.5,0,Clear,19.3,2021-11-26 08:00:00,8
73,142,215,82,5.9,0,Clear,20.6,2021-11-26 09:00:00,9
112,143,255,66,6.2,0,Clear,23.0,2021-11-26 10:00:00,10
135,162,297,47,6.5,0,Clear,27.2,2021-11-26 11:00:00,11
141,196,337,43,6.2,0,Clear,25.6,2021-11-26 12:00:00,12
186,209,395,43,6.1,0,Clear,25.8,2021-11-26 13:00:00,13
155,266,421,41,6.2,0,Clear,27.6,2021-11-26 14:00:00,14
133,208,341,38,6.9,1,Mostly Clear,28.7,2021-11-26 15:00:00,15
109,196,305,38,6.0,3,Cloudy,29.1,2021-11-26 16:00:00,16
82,158,240,38,5.0,1,Mostly Clear,25.9,2021-11-26 17:00:00,17
49,137,186,39,4.0,0,Clear,19.5,2021-11-26 18:00:00,18
41,110,151,41,3.2,0,Clear,19.2,2021-11-26 19:00:00,19
51,69,120,42,2.6,0,Clear,20.0,2021-11-26 20:00:00,20
26,62,88,44,2.1,0,Clear,19.7,2021-11-26 21:00:00,21
43,60,103,46,1.6,0,Clear,18.9,2021-11-26 22:00:00,22
29,47,76,48,1.3,0,Clear,18.6,2021-11-26 23:00:00,23
22,49,71,49,1.0,0,Clear,18.5,2021-11-27 00:00:00,0
26,30,56,50,0.8,0,Clear,18.8,2021-11-27 01:00:00,1
21,21,42,51,0.6,0,Clear,18.4,2021-11-27 02:00:00,2
16,11,27,51,0.6,0,Clear,17.4,2021-11-27 03:00:00,3
4,7,11,51,0.4,0,Clear,16.7,2021-11-27 04:00:00,4
4,10,14,51,0.2,0,Clear,16.6,2021-11-27 05:00:00,5
9,23,32,51,0.0,1,Mostly Clear,13.6,2021-11-27 06:00:00,6
10,45,55,52,-0.1,2,Partly Cloudy,11.9,2021-11-27 07:00:00,7
26,82,108,53,-0.2,2,Partly Cloudy,12.0,2021-11-27 08:00:00,8
73,145,218,55,0.2,1,Mostly Clear,13.1,2021-11-27 09:00:00,9
100,163,263,52,1.6,0,Clear,14.6,2021-11-27 10:00:00,10
128,206,334,47,2.9,1,Mostly Clear,19.2,2021-11-27 11:00:00,11
177,229,406,45,4.0,0,Clear,17.6,2021-11-27 12:00:00,12
165,208,373,43,5.1,1,Mostly Clear,17.7,2021-11-27 13:00:00,13
152,255,407,41,5.9,0,Clear,16.9,2021-11-27 14:00:00,14
186,289,475,40,6.2,0,Clear,15.0,2021-11-27 15:00:00,15
156,297,453,40,6.3,0,Clear,14.5,2021-11-27 16:00:00,16
103,198,301,41,5.9,1,Mostly Clear,9.7,2021-11-27 17:00:00,17
77,166,243,47,5.0,2,Partly Cloudy,6.9,2021-11-27 18:00:00,18
63,149,212,46,4.9,2,Partly Cloudy,3.3,2021-11-27 19:00:00,19
53,114,167,68,3.1,1,Mostly Clear,3.8,2021-11-27 20:00:00,20
52,88,140,65,3.2,2,Partly Cloudy,5.1,2021-11-27 21:00:00,21
53,96,149,62,3.4,2,Partly Cloudy,6.3,2021-11-27 22:00:00,22
43,77,120,62,3.4,2,Partly Cloudy,7.5,2021-11-27 23:00:00,23
31,48,79,60,3.7,2,Partly Cloudy,7.6,2021-11-28 00:00:00,0
32,34,66,60,3.9,2,Partly Cloudy,7.3,2021-11-28 01:00:00,1
25,32,57,62,3.4,2,Partly Cloudy,6.4,2021-11-28 02:00:00,2
13,17,30,64,3.7,2,Partly Cloudy,6.9,2021-11-28 03:00:00,3
6,8,14,62,4.0,2,Partly Cloudy,7.0,2021-11-28 04:00:00,4
4,12,16,60,4.1,2,Partly Cloudy,8.4,2021-11-28 05:00:00,5
10,23,33,61,3.8,0,Clear,4.4,2021-11-28 06:00:00,6
16,42,58,65,2.9,0,Clear,5.2,2021-11-28 07:00:00,7
33,86,119,72,2.2,0,Clear,6.5,2021-11-28 08:00:00,8
96,147,243,77,2.2,0,Clear,6.8,2021-11-28 09:00:00,9
143,207,350,62,5.2,0,Clear,6.3,2021-11-28 10:00:00,10
163,328,491,55,7.6,0,Clear,6.9,2021-11-28 11:00:00,11
224,353,577,51,9.9,0,Clear,6.4,2021-11-28 12:00:00,12
241,360,601,49,11.3,0,Clear,5.8,2021-11-28 13:00:00,13
306,407,713,49,11.9,0,Clear,8.0,2021-11-28 14:00:00,14
216,382,598,43,13.5,0,Clear,8.9,2021-11-28 15:00:00,15
210,395,605,42,13.5,2,Partly Cloudy,8.6,2021-11-28 16:00:00,16
129,271,400,52,12.1,2,Partly Cloudy,5.6,2021-11-28 17:00:00,17
90,218,308,62,10.3,1,Mostly Clear,6.0,2021-11-28 18:00:00,18
59,170,229,71,7.9,1,Mostly Clear,7.3,2021-11-28 19:00:00,19
35,112,147,73,6.6,1,Mostly Clear,8.7,2021-11-28 20:00:00,20
49,94,143,73,6.3,1,Mostly Clear,9.0,2021-11-28 21:00:00,21
40,75,115,71,6.3,2,Partly Cloudy,7.2,2021-11-28 22:00:00,22
22,45,67,66,6.2,2,Partly Cloudy,5.8,2021-11-28 23:00:00,23
8,18,26,58,6.2,3,Cloudy,6.8,2021-11-29 00:00:00,0
12,5,17,55,5.7,3,Cloudy,11.7,2021-11-29 01:00:00,1
1,8,9,54,5.2,3,Cloudy,15.1,2021-11-29 02:00:00,2
1,5,6,54,5.0,1,Mostly Clear,16.3,2021-11-29 03:00:00,3
5,6,11,54,4.1,0,Clear,18.0,2021-11-29 04:00:00,4
12,26,38,57,3.1,0,Clear,17.7,2021-11-29 05:00:00,5
15,103,118,60,2.3,0,Clear,16.8,2021-11-29 06:00:00,6
65,305,370,62,1.9,0,Clear,15.3,2021-11-29 07:00:00,7
80,411,491,64,1.7,0,Clear,14.2,2021-11-29 08:00:00,8
78,262,340,65,2.1,0,Clear,15.3,2021-11-29 09:00:00,9
46,183,229,62,3.6,0,Clear,15.5,2021-11-29 10:00:00,10
75,182,257,51,5.2,0,Clear,19.7,2021-11-29 11:00:00,11
78,231,309,47,6.1,1,Mostly Clear,22.5,2021-11-29 12:00:00,12
60,224,284,43,6.7,3,Cloudy,23.3,2021-11-29 13:00:00,13
73,214,287,41,7.1,2,Partly Cloudy,20.7,2021-11-29 14:00:00,14
130,297,427,43,7.1,2,Partly Cloudy,18.8,2021-11-29 15:00:00,15
106,397,503,40,7.3,1,Mostly Clear,18.6,2021-11-29 16:00:00,16
123,485,608,40,7.0,2,Partly Cloudy,13.6,2021-11-29 17:00:00,17
107,424,531,42,6.3,1,Mostly Clear,10.5,2021-11-29 18:00:00,18
87,269,356,49,4.7,1,Mostly Clear,8.2,2021-11-29 19:00:00,19
46,182,228,55,3.5,0,Clear,8.0,2021-11-29 20:00:00,20
34,131,165,60,2.5,0,Clear,7.3,2021-11-29 21:00:00,21
25,54,79,65,1.6,0,Clear,8.0,2021-11-29 22:00:00,22
21,36,57,69,0.7,1,Mostly Clear,8.4,2021-11-29 23:00:00,23
10,18,28,73,-0.0,2,Partly Cloudy,7.1,2021-11-30 00:00:00,0
4,6,10,75,-0.5,3,Cloudy,6.1,2021-11-30 01:00:00,1
2,9,11,76,-0.7,3,Cloudy,5.4,2021-11-30 02:00:00,2
0,1,1,79,0.5,3,Cloudy,6.4,2021-11-30 03:00:00,3
5,10,15,79,0.9,3,Cloudy,6.4,2021-11-30 04:00:00,4
16,42,58,81,0.5,1,Mostly Clear,6.2,2021-11-30 05:00:00,5
25,136,161,83,-0.1,2,Partly Cloudy,5.8,2021-11-30 06:00:00,6
67,336,403,85,-0.6,2,Partly Cloudy,5.4,2021-11-30 07:00:00,7
81,504,585,84,-0.4,2,Partly Cloudy,6.9,2021-11-30 08:00:00,8
61,289,350,82,0.7,2,Partly Cloudy,9.0,2021-11-30 09:00:00,9
53,178,231,68,3.4,2,Partly Cloudy,10.6,2021-11-30 10:00:00,10
63,207,270,62,4.3,1,Mostly Clear,10.8,2021-11-30 11:00:00,11
78,275,353,53,5.6,1,Mostly Clear,12.5,2021-11-30 12:00:00,12
95,245,340,47,7.0,1,Mostly Clear,13.5,2021-11-30 13:00:00,13
102,257,359,45,8.0,1,Mostly Clear,12.2,2021-11-30 14:00:00,14
109,324,433,41,9.9,2,Partly Cloudy,10.9,2021-11-30 15:00:00,15
113,438,551,41,10.4,1,Mostly Clear,9.4,2021-11-30 16:00:00,16
149,629,778,47,9.6,0,Clear,4.8,2021-11-30 17:00:00,17
123,518,641,52,8.1,0,Clear,4.2,2021-11-30 18:00:00,18
114,343,457,60,6.4,0,Clear,4.8,2021-11-30 19:00:00,19
53,249,302,67,5.0,0,Clear,5.9,2021-11-30 20:00:00,20
46,180,226,73,4.2,0,Clear,7.3,2021-11-30 21:00:00,21
59,116,175,77,3.6,0,Clear,8.2,2021-11-30 22:00:00,22
40,65,105,80,3.0,0,Clear,8.7,2021-11-30 23:00:00,23
9,31,40,83,2.5,0,Clear,10.1,2021-12-01 00:00:00,0
8,12,20,85,1.9,0,Clear,10.0,2021-12-01 01:00:00,1
2,1,3,87,1.5,0,Clear,10.4,2021-12-01 02:00:00,2
2,5,7,81,1.3,0,Clear,10.2,2021-12-01 03:00:00,3
2,8,10,82,1.0,0,Clear,9.2,2021-12-01 04:00:00,4
12,32,44,84,0.7,0,Clear,8.2,2021-12-01 05:00:00,5
23,115,138,85,0.4,0,Clear,8.7,2021-12-01 06:00:00,6
68,333,401,86,0.3,0,Clear,9.0,2021-12-01 07:00:00,7
140,527,667,87,0.4,0,Clear,8.7,2021-12-01 08:00:00,8
76,337,413,87,0.9,0,Clear,5.3,2021-12-01 09:00:00,9
76,245,321,81,4.8,0,Clear,5.1,2021-12-01 10:00:00,10
86,225,311,63,8.5,0,Clear,2.9,2021-12-01 11:00:00,11
121,308,429,55,9.5,0,Clear,2.2,2021-12-01 12:00:00,12
129,302,431,51,10.5,0,Clear,3.9,2021-12-01 13:00:00,13
114,325,439,48,11.4,0,Clear,6.3,2021-12-01 14:00:00,14
140,358,498,45,13.1,1,Mostly Clear,7.6,2021-12-01 15:00:00,15
146,489,635,46,12.9,0,Clear,9.0,2021-12-01 16:00:00,16
199,650,849,53,11.6,3,Cloudy,7.5,2021-12-01 17:00:00,17
178,554,732,60,9.9,3,Cloudy,7.9,2021-12-01 18:00:00,18
102,402,504,67,8.7,3,Cloudy,9.5,2021-12-01 19:00:00,19
76,255,331,68,8.6,51,Light Drizzle,10.5,2021-12-01 20:00:00,20
84,208,292,68,8.5,3,Cloudy,11.4,2021-12-01 21:00:00,21
62,118,180,68,8.4,3,Cloudy,11.6,2021-12-01 22:00:00,22
28,64,92,69,8.2,3,Cloudy,12.0,2021-12-01 23:00:00,23
17,39,56,70,8.2,3,Cloudy,11.6,2021-12-02 00:00:00,0
7,16,23,70,8.4,3,Cloudy,12.4,2021-12-02 01:00:00,1
8,6,14,69,8.7,2,Partly Cloudy,13.3,2021-12-02 02:00:00,2
2,2,4,70,8.6,1,Mostly Clear,12.5,2021-12-02 03:00:00,3
8,6,14,70,8.8,1,Mostly Clear,12.4,2021-12-02 04:00:00,4
14,38,52,70,8.6,51,Light Drizzle,12.6,2021-12-02 05:00:00,5
36,112,148,70,8.6,1,Mostly Clear,8.2,2021-12-02 06:00:00,6
77,315,392,71,8.2,2,Partly Cloudy,9.1,2021-12-02 07:00:00,7
127,559,686,74,7.7,1,Mostly Clear,10.1,2021-12-02 08:00:00,8
117,338,455,76,7.8,2,Partly Cloudy,10.3,2021-12-02 09:00:00,9
108,212,320,71,9.6,2,Partly Cloudy,11.8,2021-12-02 10:00:00,10
96,242,338,67,11.2,3,Cloudy,12.4,2021-12-02 11:00:00,11
142,331,473,63,12.9,2,Partly Cloudy,14.4,2021-12-02 12:00:00,12
163,314,477,62,14.3,0,Clear,14.6,2021-12-02 13:00:00,13
171,328,499,58,16.2,1,Mostly Clear,18.4,2021-12-02 14:00:00,14
219,426,645,50,17.8,0,Clear,19.3,2021-12-02 15:00:00,15
220,547,767,50,17.8,1,Mostly Clear,20.7,2021-12-02 16:00:00,16
231,687,918,51,17.0,1,Mostly Clear,18.2,2021-12-02 17:00:00,17
238,604,842,54,15.7,2,Partly Cloudy,15.9,2021-12-02 18:00:00,18
129,442,571,57,14.9,51,Light Drizzle,16.8,2021-12-02 19:00:00,19
98,255,353,64,13.8,1,Mostly Clear,14.7,2021-12-02 20:00:00,20
93,251,344,67,13.3,1,Mostly Clear,11.2,2021-12-02 21:00:00,21
116,199,315,72,12.2,1,Mostly Clear,11.2,2021-12-02 22:00:00,22
81,112,193,76,11.5,0,Clear,13.3,2021-12-02 23:00:00,23
25,50,75,80,11.1,0,Clear,14.4,2021-12-03 00:00:00,0
17,29,46,78,10.7,0,Clear,14.9,2021-12-03 01:00:00,1
10,10,20,72,10.2,0,Clear,13.8,2021-12-03 02:00:00,2
5,15,20,58,10.9,1,Mostly Clear,12.8,2021-12-03 03:00:00,3
8,20,28,55,10.0,1,Mostly Clear,12.3,2021-12-03 04:00:00,4
11,35,46,55,9.0,1,Mostly Clear,11.5,2021-12-03 05:00:00,5
42,125,167,56,8.0,0,Clear,11.2,2021-12-03 06:00:00,6
83,307,390,59,6.9,0,Clear,7.8,2021-12-03 07:00:00,7
105,480,585,69,5.7,0,Clear,8.7,2021-12-03 08:00:00,8
129,371,500,76,5.0,0,Clear,7.1,2021-12-03 09:00:00,9
137,246,383,59,8.1,0,Clear,7.9,2021-12-03 10:00:00,10
150,255,405,50,9.2,0,Clear,14.3,2021-12-03 11:00:00,11
136,287,423,48,9.9,0,Clear,14.5,2021-12-03 12:00:00,12
152,313,465,45,10.5,1,Mostly Clear,14.8,2021-12-03 13:00:00,13
154,328,482,43,11.0,1,Mostly Clear,15.8,2021-12-03 14:00:00,14
176,402,578,43,12.1,1,Mostly Clear,14.8,2021-12-03 15:00:00,15
203,451,654,43,12.0,1,Mostly Clear,12.5,2021-12-03 16:00:00,16
203,565,768,45,11.4,0,Clear,8.9,2021-12-03 17:00:00,17
189,509,698,49,10.1,1,Mostly Clear,6.8,2021-12-03 18:00:00,18
150,352,502,56,8.6,0,Clear,5.8,2021-12-03 19:00:00,19
124,271,395,67,7.2,0,Clear,6.5,2021-12-03 20:00:00,20
116,199,315,70,6.2,0,Clear,1.3,2021-12-03 21:00:00,21
119,161,280,62,7.0,1,Mostly Clear,1.8,2021-12-03 22:00:00,22
105,177,282,62,6.9,1,Mostly Clear,4.4,2021-12-03 23:00:00,23
84,142,226,64,6.6,1,Mostly Clear,5.4,2021-12-04 00:00:00,0
66,94,160,67,6.2,2,Partly Cloudy,2.0,2021-12-04 01:00:00,1
51,57,108,73,5.7,2,Partly Cloudy,3.3,2021-12-04 02:00:00,2
20,17,37,72,5.6,1,Mostly Clear,3.9,2021-12-04 03:00:00,3
7,17,24,77,5.4,2,Partly Cloudy,5.2,2021-12-04 04:00:00,4
5,11,16,77,5.2,1,Mostly Clear,6.1,2021-12-04 05:00:00,5
22,32,54,78,5.1,1,Mostly Clear,7.8,2021-12-04 06:00:00,6
33,77,110,81,4.7,1,Mostly Clear,8.5,2021-12-04 07:00:00,7
62,189,251,85,4.1,0,Clear,7.7,2021-12-04 08:00:00,8
142,332,474,87,4.1,0,Clear,7.8,2021-12-04 09:00:00,9
248,372,620,72,7.5,0,Clear,6.9,2021-12-04 10:00:00,10
275,443,718,61,9.7,0,Clear,6.8,2021-12-04 11:00:00,11
360,445,805,55,11.3,0,Clear,5.6,2021-12-04 12:00:00,12
390,450,840,52,12.3,0,Clear,3.0,2021-12-04 13:00:00,13
439,496,935,50,13.1,1,Mostly Clear,3.4,2021-12-04 14:00:00,14
433,559,992,46,13.4,1,Mostly Clear,4.7,2021-12-04 15:00:00,15
386,449,835,45,13.4,1,Mostly Clear,6.4,2021-12-04 16:00:00,16
252,362,614,49,12.6,1,Mostly Clear,5.1,2021-12-04 17:00:00,17
177,354,531,56,10.9,1,Mostly Clear,4.7,2021-12-04 18:00:00,18
194,301,495,68,8.7,1,Mostly Clear,3.8,2021-12-04 19:00:00,19
177,218,395,71,7.2,1,Mostly Clear,6.0,2021-12-04 20:00:00,20
124,171,295,68,6.6,1,Mostly Clear,10.1,2021-12-04 21:00:00,21
111,195,306,63,6.4,1,Mostly Clear,10.1,2021-12-04 22:00:00,22
97,160,257,63,5.6,0,Clear,10.7,2021-12-04 23:00:00,23
76,123,199,64,5.0,0,Clear,10.4,2021-12-05 00:00:00,0
72,97,169,66,4.4,0,Clear,11.0,2021-12-05 01:00:00,1
41,58,99,71,3.5,0,Clear,9.0,2021-12-05 02:00:00,2
42,24,66,69,3.1,0,Clear,7.5,2021-12-05 03:00:00,3
7,7,14,71,2.5,0,Clear,7.2,2021-12-05 04:00:00,4
7,12,19,73,2.0,0,Clear,6.9,2021-12-05 05:00:00,5
15,26,41,74,1.6,0,Clear,6.5,2021-12-05 06:00:00,6
18,54,72,74,1.3,0,Clear,6.4,2021-12-05 07:00:00,7
51,130,181,76,0.9,0,Clear,6.3,2021-12-05 08:00:00,8
104,216,320,76,1.6,0,Clear,7.2,2021-12-05 09:00:00,9
160,287,447,65,5.2,0,Clear,6.6,2021-12-05 10:00:00,10
226,376,602,50,7.5,0,Clear,7.9,2021-12-05 11:00:00,11
265,404,669,45,8.5,0,Clear,8.6,2021-12-05 12:00:00,12
243,372,615,41,9.2,1,Mostly Clear,8.9,2021-12-05 13:00:00,13
268,369,637,38,9.7,2,Partly Cloudy,9.4,2021-12-05 14:00:00,14
238,394,632,36,10.1,2,Partly Cloudy,9.9,2021-12-05 15:00:00,15
223,392,615,37,9.9,2,Partly Cloudy,10.0,2021-12-05 16:00:00,16
168,298,466,40,9.5,2,Partly Cloudy,10.0,2021-12-05 17:00:00,17
100,221,321,45,8.8,2,Partly Cloudy,6.3,2021-12-05 18:00:00,18
100,170,270,52,7.8,1,Mostly Clear,6.8,2021-12-05 19:00:00,19
68,130,198,59,7.6,3,Cloudy,6.7,2021-12-05 20:00:00,20
72,114,186,64,8.0,3,Cloudy,7.9,2021-12-05 21:00:00,21
49,95,144,69,8.3,3,Cloudy,8.1,2021-12-05 22:00:00,22
36,42,78,74,8.4,3,Cloudy,6.9,2021-12-05 23:00:00,23
16,24,40,77,8.6,3,Cloudy,6.0,2021-12-06 00:00:00,0
10,12,22,81,8.6,3,Cloudy,5.2,2021-12-06 01:00:00,1
1,6,7,83,8.6,3,Cloudy,5.8,2021-12-06 02:00:00,2
5,5,10,78,8.5,3,Cloudy,7.6,2021-12-06 03:00:00,3
8,7,15,80,8.3,1,Mostly Clear,10.1,2021-12-06 04:00:00,4
15,38,53,83,8.1,0,Clear,11.6,2021-12-06 05:00:00,5
22,122,144,86,8.2,0,Clear,13.4,2021-12-06 06:00:00,6
60,317,377,90,8.3,0,Clear,15.5,2021-12-06 07:00:00,7
104,469,573,91,8.8,1,Mostly Clear,16.7,2021-12-06 08:00:00,8
95,296,391,90,9.8,1,Mostly Clear,18.5,2021-12-06 09:00:00,9
74,188,262,86,11.6,2,Partly Cloudy,18.2,2021-12-06 10:00:00,10
94,203,297,80,13.7,2,Partly Cloudy,18.6,2021-12-06 11:00:00,11
134,260,394,76,15.5,1,Mostly Clear,20.3,2021-12-06 12:00:00,12
122,250,372,71,16.9,1,Mostly Clear,21.3,2021-12-06 13:00:00,13
134,269,403,66,18.4,1,Mostly Clear,23.6,2021-12-06 14:00:00,14
141,344,485,61,19.5,2,Partly Cloudy,22.0,2021-12-06 15:00:00,15
176,446,622,62,19.2,2,Partly Cloudy,21.1,2021-12-06 16:00:00,16
189,652,841,65,18.6,2,Partly Cloudy,18.9,2021-12-06 17:00:00,17
160,543,703,76,17.1,51,Light Drizzle,18.2,2021-12-06 18:00:00,18
108,363,471,90,15.5,55,Heavy Drizzle,16.2,2021-12-06 19:00:00,19
70,195,265,82,13.2,53,Heavy Drizzle,21.7,2021-12-06 20:00:00,20
54,143,197,52,10.6,1,Mostly Clear,29.4,2021-12-06 21:00:00,21
48,96,144,39,9.6,1,Mostly Clear,29.8,2021-12-06 22:00:00,22
26,62,88,35,8.1,1,Mostly Clear,27.6,2021-12-06 23:00:00,23
11,12,23,32,6.6,0,Clear,23.8,2021-12-07 00:00:00,0
3,3,6,32,5.3,0,Clear,21.7,2021-12-07 01:00:00,1
1,5,6,34,4.4,0,Clear,18.6,2021-12-07 02:00:00,2
1,4,5,40,3.4,0,Clear,15.0,2021-12-07 03:00:00,3
2,10,12,42,2.7,0,Clear,12.1,2021-12-07 04:00:00,4
15,41,56,44,2.2,0,Clear,11.5,2021-12-07 05:00:00,5
23,113,136,46,1.6,0,Clear,7.9,2021-12-07 06:00:00,6
65,327,392,49,1.0,1,Mostly Clear,8.4,2021-12-07 07:00:00,7
108,506,614,58,0.4,1,Mostly Clear,7.3,2021-12-07 08:00:00,8
90,314,404,67,0.8,2,Partly Cloudy,3.2,2021-12-07 09:00:00,9
71,189,260,46,2.5,1,Mostly Clear,7.6,2021-12-07 10:00:00,10
63,213,276,41,3.5,1,Mostly Clear,9.0,2021-12-07 11:00:00,11
100,262,362,38,4.5,1,Mostly Clear,8.7,2021-12-07 12:00:00,12
98,273,371,36,5.2,1,Mostly Clear,9.7,2021-12-07 13:00:00,13
105,262,367,34,5.7,0,Clear,8.7,2021-12-07 14:00:00,14
120,289,409,33,6.1,0,Clear,7.2,2021-12-07 15:00:00,15
108,408,516,32,6.2,0,Clear,6.5,2021-12-07 16:00:00,16
131,555,686,31,5.8,0,Clear,2.8,2021-12-07 17:00:00,17
109,403,512,56,4.7,1,Mostly Clear,3.6,2021-12-07 18:00:00,18
101,319,420,55,3.6,1,Mostly Clear,3.8,2021-12-07 19:00:00,19
83,206,289,60,2.3,1,Mostly Clear,4.5,2021-12-07 20:00:00,20
54,153,207,65,1.1,1,Mostly Clear,5.2,2021-12-07 21:00:00,21
52,108,160,66,0.8,1,Mostly Clear,5.5,2021-12-07 22:00:00,22
26,47,73,68,0.7,1,Mostly Clear,5.1,2021-12-07 23:00:00,23
11,19,30,66,1.2,1,Mostly Clear,5.8,2021-12-08 00:00:00,0
7,13,20,71,1.0,3,Cloudy,6.9,2021-12-08 01:00:00,1
2,6,8,74,1.1,2,Partly Cloudy,7.3,2021-12-08 02:00:00,2
4,4,8,72,1.2,2,Partly Cloudy,6.6,2021-12-08 03:00:00,3
4,4,8,69,1.9,3,Cloudy,7.0,2021-12-08 04:00:00,4
6,32,38,68,2.3,3,Cloudy,7.3,2021-12-08 05:00:00,5
23,100,123,70,2.3,3,Cloudy,5.7,2021-12-08 06:00:00,6
67,278,345,70,2.3,3,Cloudy,4.3,2021-12-08 07:00:00,7
121,462,583,68,2.5,3,Cloudy,5.8,2021-12-08 08:00:00,8
75,298,373,69,2.8,3,Cloudy,6.1,2021-12-08 09:00:00,9
51,192,243,65,3.3,71,Light Snow,7.3,2021-12-08 10:00:00,10
74,185,259,66,3.4,71,Light Snow,7.1,2021-12-08 11:00:00,11
62,225,287,70,3.4,71,Light Snow,5.9,2021-12-08 12:00:00,12
88,234,322,74,3.2,73,Snow,6.0,2021-12-08 13:00:00,13
87,204,291,77,3.2,71,Light Snow,5.9,2021-12-08 14:00:00,14
111,258,369,55,5.6,1,Mostly Clear,5.2,2021-12-08 15:00:00,15
135,362,497,55,5.8,2,Partly Cloudy,5.1,2021-12-08 16:00:00,16
167,523,690,55,5.7,1,Mostly Clear,6.4,2021-12-08 17:00:00,17
122,453,575,62,4.8,2,Partly Cloudy,5.6,2021-12-08 18:00:00,18
121,294,415,75,3.4,2,Partly Cloudy,6.5,2021-12-08 19:00:00,19
70,203,273,78,2.2,1,Mostly Clear,7.3,2021-12-08 20:00:00,20
80,141,221,75,2.0,0,Clear,10.6,2021-12-08 21:00:00,21
57,130,187,67,2.7,0,Clear,15.5,2021-12-08 22:00:00,22
27,61,88,64,2.3,0,Clear,15.8,2021-12-08 23:00:00,23
12,24,36,62,1.8,0,Clear,13.5,2021-12-09 00:00:00,0
2,9,11,62,1.3,0,Clear,12.8,2021-12-09 01:00:00,1
4,12,16,63,0.7,0,Clear,11.8,2021-12-09 02:00:00,2
2,7,9,67,0.3,0,Clear,9.2,2021-12-09 03:00:00,3
4,7,11,71,-0.4,0,Clear,7.6,2021-12-09 04:00:00,4
8,30,38,78,-1.5,0,Clear,6.9,2021-12-09 05:00:00,5
25,108,133,78,-1.8,0,Clear,5.8,2021-12-09 06:00:00,6
70,263,333,77,-1.9,0,Clear,4.7,2021-12-09 07:00:00,7
96,458,554,78,-2.0,0,Clear,5.4,2021-12-09 08:00:00,8
78,294,372,76,-1.3,1,Mostly Clear,5.8,2021-12-09 09:00:00,9
71,161,232,68,1.2,1,Mostly Clear,4.7,2021-12-09 10:00:00,10
82,197,279,57,2.8,1,Mostly Clear,4.7,2021-12-09 11:00:00,11
112,271,383,52,4.0,1,Mostly Clear,1.6,2021-12-09 12:00:00,12
114,251,365,48,4.9,1,Mostly Clear,3.4,2021-12-09 13:00:00,13
116,209,325,46,5.4,1,Mostly Clear,5.4,2021-12-09 14:00:00,14
122,281,403,45,5.8,1,Mostly Clear,6.3,2021-12-09 15:00:00,15
116,371,487,46,5.5,1,Mostly Clear,8.1,2021-12-09 16:00:00,16
161,588,749,48,5.1,3,Cloudy,10.1,2021-12-09 17:00:00,17
164,478,642,52,4.4,1,Mostly Clear,7.6,2021-12-09 18:00:00,18
78,287,365,59,3.3,0,Clear,9.6,2021-12-09 19:00:00,19
78,196,274,65,2.6,1,Mostly Clear,10.7,2021-12-09 20:00:00,20
72,175,247,69,2.1,2,Partly Cloudy,11.1,2021-12-09 21:00:00,21
71,118,189,73,1.8,2,Partly Cloudy,11.0,2021-12-09 22:00:00,22
52,104,156,75,1.9,2,Partly Cloudy,12.8,2021-12-09 23:00:00,23
16,45,61,78,1.8,1,Mostly Clear,13.6,2021-12-10 00:00:00,0
12,18,30,80,1.8,0,Clear,12.6,2021-12-10 01:00:00,1
9,10,19,82,1.7,0,Clear,12.2,2021-12-10 02:00:00,2
1,4,5,77,1.8,1,Mostly Clear,12.2,2021-12-10 03:00:00,3
5,9,14,74,2.3,2,Partly Cloudy,11.5,2021-12-10 04:00:00,4
12,32,44,72,2.7,3,Cloudy,11.2,2021-12-10 05:00:00,5
33,104,137,69,3.4,3,Cloudy,8.3,2021-12-10 06:00:00,6
53,249,302,68,3.8,3,Cloudy,8.3,2021-12-10 07:00:00,7
110,414,524,68,4.0,3,Cloudy,7.6,2021-12-10 08:00:00,8
108,308,416,69,4.3,3,Cloudy,7.3,2021-12-10 09:00:00,9
117,200,317,69,5.0,3,Cloudy,6.3,2021-12-10 10:00:00,10
140,253,393,67,5.9,3,Cloudy,6.2,2021-12-10 11:00:00,11
151,284,435,65,7.2,3,Cloudy,4.8,2021-12-10 12:00:00,12
182,298,480,62,8.7,2,Partly Cloudy,4.3,2021-12-10 13:00:00,13
219,352,571,61,10.2,2,Partly Cloudy,4.0,2021-12-10 14:00:00,14
241,387,628,55,11.0,1,Mostly Clear,4.5,2021-12-10 15:00:00,15
239,463,702,55,11.3,3,Cloudy,5.1,2021-12-10 16:00:00,16
230,528,758,61,10.3,3,Cloudy,5.8,2021-12-10 17:00:00,17
180,469,649,66,9.6,3,Cloudy,7.4,2021-12-10 18:00:00,18
170,321,491,71,9.1,3,Cloudy,9.4,2021-12-10 19:00:00,19
95,207,302,78,8.4,3,Cloudy,6.6,2021-12-10 20:00:00,20
98,187,285,86,7.5,1,Mostly Clear,6.4,2021-12-10 21:00:00,21
126,169,295,92,6.7,1,Mostly Clear,8.2,2021-12-10 22:00:00,22
102,143,245,94,6.4,51,Light Drizzle,6.7,2021-12-10 23:00:00,23
90,132,222,95,6.6,3,Cloudy,6.1,2021-12-11 00:00:00,0
72,56,128,94,7.6,51,Light Drizzle,8.9,2021-12-11 01:00:00,1
65,50,115,95,8.3,3,Cloudy,8.9,2021-12-11 02:00:00,2
19,31,50,97,8.3,3,Cloudy,9.1,2021-12-11 03:00:00,3
11,7,18,97,9.1,3,Cloudy,11.3,2021-12-11 04:00:00,4
17,14,31,96,10.1,3,Cloudy,15.2,2021-12-11 05:00:00,5
12,35,47,96,11.1,3,Cloudy,17.8,2021-12-11 06:00:00,6
31,54,85,97,11.7,3,Cloudy,19.2,2021-12-11 07:00:00,7
56,159,215,97,12.4,3,Cloudy,21.3,2021-12-11 08:00:00,8
132,208,340,97,13.2,3,Cloudy,24.2,2021-12-11 09:00:00,9
201,302,503,96,14.1,3,Cloudy,25.6,2021-12-11 10:00:00,10
265,375,640,94,15.0,3,Cloudy,27.0,2021-12-11 11:00:00,11
307,406,713,91,16.0,3,Cloudy,27.6,2021-12-11 12:00:00,12
318,411,729,87,16.9,3,Cloudy,25.2,2021-12-11 13:00:00,13
370,417,787,84,17.9,3,Cloudy,20.2,2021-12-11 14:00:00,14
331,427,758,80,18.9,3,Cloudy,25.4,2021-12-11 15:00:00,15
292,425,717,79,19.1,3,Cloudy,25.6,2021-12-11 16:00:00,16
219,335,554,78,19.2,3,Cloudy,25.4,2021-12-11 17:00:00,17
145,239,384,80,19.0,51,Light Drizzle,22.3,2021-12-11 18:00:00,18
66,129,195,81,19.2,3,Cloudy,20.6,2021-12-11 19:00:00,19
43,95,138,80,19.5,51,Light Drizzle,23.0,2021-12-11 20:00:00,20
38,81,119,91,18.3,63,Rain,21.2,2021-12-11 21:00:00,21
86,115,201,85,13.8,63,Rain,22.9,2021-12-11 22:00:00,22
70,121,191,66,10.5,3,Cloudy,27.7,2021-12-11 23:00:00,23
94,105,199,46,10.0,3,Cloudy,29.7,2021-12-12 00:00:00,0
60,91,151,41,8.4,2,Partly Cloudy,28.7,2021-12-12 01:00:00,1
36,37,73,40,7.5,2,Partly Cloudy,25.9,2021-12-12 02:00:00,2
23,21,44,41,6.8,1,Mostly Clear,22.8,2021-12-12 03:00:00,3
8,10,18,42,6.4,1,Mostly Clear,21.6,2021-12-12 04:00:00,4
2,9,11,44,6.0,1,Mostly Clear,20.1,2021-12-12 05:00:00,5
17,17,34,45,5.6,0,Clear,18.2,2021-12-12 06:00:00,6
25,45,70,46,4.9,0,Clear,16.3,2021-12-12 07:00:00,7
43,106,149,49,4.1,0,Clear,13.6,2021-12-12 08:00:00,8
87,186,273,52,3.9,0,Clear,12.0,2021-12-12 09:00:00,9
161,264,425,51,4.7,0,Clear,10.7,2021-12-12 10:00:00,10
209,342,551,45,5.9,0,Clear,13.6,2021-12-12 11:00:00,11
240,420,660,42,7.0,0,Clear,14.0,2021-12-12 12:00:00,12
280,372,652,39,7.9,0,Clear,14.6,2021-12-12 13:00:00,13
273,351,624,36,8.8,0,Clear,14.8,2021-12-12 14:00:00,14
231,385,616,35,9.4,0,Clear,13.4,2021-12-12 15:00:00,15
226,406,632,34,9.5,0,Clear,12.8,2021-12-12 16:00:00,16
166,340,506,34,9.0,0,Clear,10.1,2021-12-12 17:00:00,17
135,238,373,40,7.5,0,Clear,6.7,2021-12-12 18:00:00,18
62,149,211,51,5.6,0,Clear,7.1,2021-12-12 19:00:00,19
71,132,203,61,3.9,0,Clear,7.2,2021-12-12 20:00:00,20
38,100,138,65,2.8,0,Clear,7.4,2021-12-12 21:00:00,21
41,78,119,67,2.1,0,Clear,7.5,2021-12-12 22:00:00,22
28,54,82,69,1.6,0,Clear,7.6,2021-12-12 23:00:00,23
12,17,29,70,1.3,0,Clear,7.7,2021-12-13 00:00:00,0
9,11,20,73,0.9,0,Clear,7.1,2021-12-13 01:00:00,1
5,10,15,74,0.8,0,Clear,7.3,2021-12-13 02:00:00,2
6,1,7,79,-0.4,0,Clear,7.6,2021-12-13 03:00:00,3
5,8,13,80,-0.5,0,Clear,7.6,2021-12-13 04:00:00,4
9,31,40,80,-0.5,0,Clear,7.6,2021-12-13 05:00:00,5
24,117,141,82,-0.7,1,Mostly Clear,8.0,2021-12-13 06:00:00,6
51,243,294,83,-0.8,0,Clear,6.8,2021-12-13 07:00:00,7
103,424,527,85,-1.1,0,Clear,6.4,2021-12-13 08:00:00,8
56,251,307,86,-0.9,0,Clear,7.1,2021-12-13 09:00:00,9
64,160,224,75,2.7,0,Clear,6.7,2021-12-13 10:00:00,10
114,163,277,59,5.6,0,Clear,5.6,2021-12-13 11:00:00,11
112,225,337,50,7.7,0,Clear,6.0,2021-12-13 12:00:00,12
125,244,369,44,9.4,0,Clear,5.5,2021-12-13 13:00:00,13
132,233,365,40,10.7,0,Clear,5.0,2021-12-13 14:00:00,14
145,290,435,36,11.7,0,Clear,5.7,2021-12-13 15:00:00,15
160,406,566,35,11.8,0,Clear,6.9,2021-12-13 16:00:00,16
175,491,666,41,10.6,0,Clear,6.4,2021-12-13 17:00:00,17
136,438,574,45,8.7,1,Mostly Clear,8.9,2021-12-13 18:00:00,18
92,308,400,51,7.2,1,Mostly Clear,9.8,2021-12-13 19:00:00,19
79,190,269,58,5.8,1,Mostly Clear,9.9,2021-12-13 20:00:00,20
68,137,205,62,4.7,1,Mostly Clear,9.5,2021-12-13 21:00:00,21
42,99,141,66,3.8,1,Mostly Clear,9.7,2021-12-13 22:00:00,22
30,59,89,70,3.0,1,Mostly Clear,8.9,2021-12-13 23:00:00,23
14,15,29,73,2.2,1,Mostly Clear,8.4,2021-12-14 00:00:00,0
5,15,20,74,1.6,1,Mostly Clear,8.2,2021-12-14 01:00:00,1
4,5,9,71,1.5,1,Mostly Clear,9.2,2021-12-14 02:00:00,2
5,4,9,66,1.7,1,Mostly Clear,11.2,2021-12-14 03:00:00,3
2,10,12,59,2.0,1,Mostly Clear,11.5,2021-12-14 04:00:00,4
7,38,45,57,2.2,1,Mostly Clear,11.3,2021-12-14 05:00:00,5
31,121,152,59,1.9,0,Clear,10.5,2021-12-14 06:00:00,6
66,296,362,63,1.5,0,Clear,9.8,2021-12-14 07:00:00,7
130,484,614,69,1.0,1,Mostly Clear,9.6,2021-12-14 08:00:00,8
85,286,371,73,1.1,0,Clear,9.8,2021-12-14 09:00:00,9
85,226,311,67,4.5,0,Clear,9.7,2021-12-14 10:00:00,10
105,216,321,52,8.0,0,Clear,7.9,2021-12-14 11:00:00,11
124,263,387,49,9.9,0,Clear,8.3,2021-12-14 12:00:00,12
137,246,383,47,11.3,0,Clear,7.9,2021-12-14 13:00:00,13
144,261,405,46,12.1,0,Clear,7.2,2021-12-14 14:00:00,14
188,321,509,41,13.1,0,Clear,7.2,2021-12-14 15:00:00,15
181,433,614,42,12.9,0,Clear,7.0,2021-12-14 16:00:00,16
207,578,785,48,11.8,0,Clear,4.4,2021-12-14 17:00:00,17
194,541,735,55,9.8,0,Clear,6.3,2021-12-14 18:00:00,18
125,323,448,63,7.9,0,Clear,7.8,2021-12-14 19:00:00,19
89,270,359,70,6.4,0,Clear,8.4,2021-12-14 20:00:00,20
66,146,212,77,5.1,0,Clear,8.6,2021-12-14 21:00:00,21
56,130,186,82,4.0,0,Clear,8.0,2021-12-14 22:00:00,22
29,66,95,85,3.2,0,Clear,8.5,2021-12-14 23:00:00,23
9,20,29,87,2.6,0,Clear,8.6,2021-12-15 00:00:00,0
9,14,23,89,2.1,0,Clear,8.0,2021-12-15 01:00:00,1
11,8,19,90,1.8,0,Clear,7.6,2021-12-15 02:00:00,2
1,6,7,88,1.4,0,Clear,7.4,2021-12-15 03:00:00,3
3,15,18,90,1.2,0,Clear,8.0,2021-12-15 04:00:00,4
7,40,47,92,0.9,0,Clear,8.2,2021-12-15 05:00:00,5
23,123,146,93,0.9,0,Clear,7.0,2021-12-15 06:00:00,6
64,306,370,94,0.9,0,Clear,6.6,2021-12-15 07:00:00,7
118,467,585,94,0.9,0,Clear,7.1,2021-12-15 08:00:00,8
88,280,368,95,1.7,0,Clear,6.9,2021-12-15 09:00:00,9
104,183,287,90,5.2,0,Clear,6.3,2021-12-15 10:00:00,10
101,203,304,79,8.4,0,Clear,6.0,2021-12-15 11:00:00,11
108,263,371,72,10.8,0,Clear,5.9,2021-12-15 12:00:00,12
108,271,379,68,12.3,1,Mostly Clear,6.3,2021-12-15 13:00:00,13
131,276,407,67,13.2,1,Mostly Clear,7.1,2021-12-15 14:00:00,14
153,303,456,64,13.7,1,Mostly Clear,8.4,2021-12-15 15:00:00,15
173,411,584,65,13.7,1,Mostly Clear,9.3,2021-12-15 16:00:00,16
192,537,729,70,12.8,1,Mostly Clear,6.2,2021-12-15 17:00:00,17
179,485,664,77,11.4,1,Mostly Clear,7.4,2021-12-15 18:00:00,18
126,331,457,84,10.1,1,Mostly Clear,6.9,2021-12-15 19:00:00,19
99,218,317,89,9.2,2,Partly Cloudy,7.3,2021-12-15 20:00:00,20
82,178,260,91,8.6,1,Mostly Clear,9.1,2021-12-15 21:00:00,21
60,133,193,92,8.3,1,Mostly Clear,9.7,2021-12-15 22:00:00,22
30,75,105,93,8.4,1,Mostly Clear,9.8,2021-12-15 23:00:00,23
26,15,41,93,8.5,1,Mostly Clear,10.8,2021-12-16 00:00:00,0
5,21,26,94,8.3,1,Mostly Clear,12.2,2021-12-16 01:00:00,1
12,12,24,94,8.2,1,Mostly Clear,13.2,2021-12-16 02:00:00,2
6,9,15,92,8.3,1,Mostly Clear,14.5,2021-12-16 03:00:00,3
6,10,16,90,8.1,1,Mostly Clear,14.5,2021-12-16 04:00:00,4
4,36,40,88,7.8,0,Clear,14.7,2021-12-16 05:00:00,5
26,118,144,85,7.5,0,Clear,14.7,2021-12-16 06:00:00,6
62,277,339,81,7.3,0,Clear,14.7,2021-12-16 07:00:00,7
139,450,589,77,7.1,0,Clear,15.0,2021-12-16 08:00:00,8
110,331,441,73,7.2,0,Clear,15.2,2021-12-16 09:00:00,9
86,224,310,67,8.8,0,Clear,13.6,2021-12-16 10:00:00,10
138,222,360,59,11.0,0,Clear,14.2,2021-12-16 11:00:00,11
141,293,434,54,13.0,0,Clear,14.5,2021-12-16 12:00:00,12
167,266,433,52,14.7,0,Clear,14.5,2021-12-16 13:00:00,13
204,312,516,50,16.1,1,Mostly Clear,14.5,2021-12-16 14:00:00,14
220,359,579,45,17.4,1,Mostly Clear,14.2,2021-12-16 15:00:00,15
239,491,730,47,17.5,1,Mostly Clear,12.9,2021-12-16 16:00:00,16
239,567,806,50,16.5,1,Mostly Clear,13.5,2021-12-16 17:00:00,17
212,523,735,53,15.3,1,Mostly Clear,13.6,2021-12-16 18:00:00,18
137,329,466,56,14.9,1,Mostly Clear,16.7,2021-12-16 19:00:00,19
111,248,359,59,14.7,1,Mostly Clear,18.0,2021-12-16 20:00:00,20
103,168,271,62,14.8,1,Mostly Clear,19.1,2021-12-16 21:00:00,21
106,155,261,66,14.6,1,Mostly Clear,20.0,2021-12-16 22:00:00,22
72,117,189,69,14.6,1,Mostly Clear,19.2,2021-12-16 23:00:00,23
23,56,79,73,14.1,1,Mostly Clear,19.6,2021-12-17 00:00:00,0
19,33,52,78,13.5,1,Mostly Clear,18.1,2021-12-17 01:00:00,1
16,9,25,81,13.2,1,Mostly Clear,17.0,2021-12-17 02:00:00,2
6,7,13,74,13.9,1,Mostly Clear,15.4,2021-12-17 03:00:00,3
10,13,23,76,13.6,1,Mostly Clear,13.6,2021-12-17 04:00:00,4
15,27,42,79,13.1,1,Mostly Clear,12.0,2021-12-17 05:00:00,5
34,108,142,83,12.5,1,Mostly Clear,11.2,2021-12-17 06:00:00,6
75,248,323,87,11.9,1,Mostly Clear,9.8,2021-12-17 07:00:00,7
92,394,486,85,11.6,1,Mostly Clear,9.1,2021-12-17 08:00:00,8
92,314,406,75,11.3,1,Mostly Clear,10.2,2021-12-17 09:00:00,9
95,229,324,62,11.9,1,Mostly Clear,11.9,2021-12-17 10:00:00,10
149,301,450,50,12.7,1,Mostly Clear,13.2,2021-12-17 11:00:00,11
194,297,491,41,13.5,1,Mostly Clear,12.6,2021-12-17 12:00:00,12
183,344,527,37,14.2,1,Mostly Clear,12.3,2021-12-17 13:00:00,13
220,385,605,34,14.8,1,Mostly Clear,11.5,2021-12-17 14:00:00,14
214,385,599,41,16.0,1,Mostly Clear,10.1,2021-12-17 15:00:00,15
227,455,682,40,15.8,1,Mostly Clear,7.8,2021-12-17 16:00:00,16
195,463,658,42,14.8,1,Mostly Clear,7.0,2021-12-17 17:00:00,17
152,393,545,43,13.4,2,Partly Cloudy,7.1,2021-12-17 18:00:00,18
141,261,402,45,12.3,3,Cloudy,4.7,2021-12-17 19:00:00,19
114,174,288,47,11.9,3,Cloudy,5.0,2021-12-17 20:00:00,20
86,152,238,44,11.9,3,Cloudy,4.8,2021-12-17 21:00:00,21
68,127,195,40,11.7,3,Cloudy,4.5,2021-12-17 22:00:00,22
61,133,194,44,11.3,3,Cloudy,5.4,2021-12-17 23:00:00,23
53,50,103,46,11.1,3,Cloudy,5.1,2021-12-18 00:00:00,0
33,58,91,41,10.8,3,Cloudy,4.4,2021-12-18 01:00:00,1
26,45,71,56,9.0,61,Light Rain,5.0,2021-12-18 02:00:00,2
27,21,48,50,10.8,3,Cloudy,6.3,2021-12-18 03:00:00,3
13,15,28,50,10.6,3,Cloudy,7.3,2021-12-18 04:00:00,4
8,7,15,52,9.7,3,Cloudy,9.3,2021-12-18 05:00:00,5
14,34,48,59,8.7,3,Cloudy,11.6,2021-12-18 06:00:00,6
28,90,118,70,7.7,51,Light Drizzle,7.9,2021-12-18 07:00:00,7
60,149,209,78,7.2,53,Heavy Drizzle,8.9,2021-12-18 08:00:00,8
141,254,395,81,7.2,3,Cloudy,8.6,2021-12-18 09:00:00,9
201,293,494,79,7.5,3,Cloudy,10.1,2021-12-18 10:00:00,10
251,340,591,78,8.0,3,Cloudy,10.2,2021-12-18 11:00:00,11
261,356,617,77,8.7,3,Cloudy,9.1,2021-12-18 12:00:00,12
324,334,658,77,9.4,3,Cloudy,7.5,2021-12-18 13:00:00,13
253,326,579,78,10.3,3,Cloudy,7.1,2021-12-18 14:00:00,14
177,335,512,64,11.3,3,Cloudy,8.1,2021-12-18 15:00:00,15
149,248,397,70,11.3,55,Heavy Drizzle,8.7,2021-12-18 16:00:00,16
140,243,383,84,10.4,55,Heavy Drizzle,8.7,2021-12-18 17:00:00,17
124,201,325,93,9.8,53,Heavy Drizzle,5.0,2021-12-18 18:00:00,18
120,169,289,95,10.2,2,Partly Cloudy,6.1,2021-12-18 19:00:00,19
81,153,234,97,11.1,3,Cloudy,7.3,2021-12-18 20:00:00,20
90,103,193,98,12.9,3,Cloudy,7.7,2021-12-18 21:00:00,21
73,107,180,98,14.3,3,Cloudy,8.9,2021-12-18 22:00:00,22
70,99,169,98,15.1,3,Cloudy,12.3,2021-12-18 23:00:00,23
74,63,137,97,15.5,3,Cloudy,14.1,2021-12-19 00:00:00,0
33,42,75,97,15.7,3,Cloudy,15.5,2021-12-19 01:00:00,1
34,34,68,96,15.5,3,Cloudy,20.0,2021-12-19 02:00:00,2
22,25,47,90,12.2,3,Cloudy,23.5,2021-12-19 03:00:00,3
14,6,20,84,10.1,3,Cloudy,20.2,2021-12-19 04:00:00,4
10,13,23,78,9.2,3,Cloudy,21.5,2021-12-19 05:00:00,5
16,28,44,69,8.2,3,Cloudy,15.6,2021-12-19 06:00:00,6
14,34,48,64,7.4,3,Cloudy,18.1,2021-12-19 07:00:00,7
33,81,114,66,6.4,51,Light Drizzle,18.0,2021-12-19 08:00:00,8
47,129,176,69,5.5,51,Light Drizzle,17.6,2021-12-19 09:00:00,9
136,185,321,64,5.1,3,Cloudy,15.8,2021-12-19 10:00:00,10
122,253,375,56,5.2,3,Cloudy,17.6,2021-12-19 11:00:00,11
175,300,475,51,5.4,3,Cloudy,19.0,2021-12-19 12:00:00,12
182,279,461,48,5.6,3,Cloudy,19.2,2021-12-19 13:00:00,13
153,290,443,46,6.0,1,Mostly Clear,19.6,2021-12-19 14:00:00,14
164,272,436,44,6.9,1,Mostly Clear,19.1,2021-12-19 15:00:00,15
141,269,410,43,6.8,0,Clear,18.7,2021-12-19 16:00:00,16
122,201,323,42,6.3,0,Clear,17.3,2021-12-19 17:00:00,17
72,142,214,44,5.2,0,Clear,11.5,2021-12-19 18:00:00,18
65,109,174,46,4.4,0,Clear,10.9,2021-12-19 19:00:00,19
39,80,119,47,3.7,0,Clear,10.4,2021-12-19 20:00:00,20
37,71,108,48,3.1,0,Clear,11.0,2021-12-19 21:00:00,21
45,62,107,49,2.5,0,Clear,12.0,2021-12-19 22:00:00,22
19,33,52,51,1.9,0,Clear,12.3,2021-12-19 23:00:00,23
6,12,18,52,1.3,0,Clear,12.2,2021-12-20 00:00:00,0
6,8,14,54,0.6,0,Clear,10.7,2021-12-20 01:00:00,1
1,7,8,58,-0.2,0,Clear,9.1,2021-12-20 02:00:00,2
1,3,4,65,-0.9,0,Clear,8.4,2021-12-20 03:00:00,3
1,8,9,67,-1.6,0,Clear,8.0,2021-12-20 04:00:00,4
9,20,29,72,-2.3,0,Clear,5.9,2021-12-20 05:00:00,5
16,84,100,70,-2.2,0,Clear,6.5,2021-12-20 06:00:00,6
32,160,192,70,-2.4,0,Clear,6.3,2021-12-20 07:00:00,7
57,246,303,70,-2.5,0,Clear,7.6,2021-12-20 08:00:00,8
41,211,252,61,-0.9,0,Clear,7.3,2021-12-20 09:00:00,9
58,176,234,63,0.0,0,Clear,6.0,2021-12-20 10:00:00,10
112,176,288,50,1.7,0,Clear,4.4,2021-12-20 11:00:00,11
114,228,342,46,2.7,0,Clear,4.7,2021-12-20 12:00:00,12
124,197,321,43,3.7,0,Clear,4.0,2021-12-20 13:00:00,13
141,234,375,41,4.6,0,Clear,5.1,2021-12-20 14:00:00,14
139,271,410,41,4.7,0,Clear,5.0,2021-12-20 15:00:00,15
118,310,428,41,4.9,0,Clear,5.8,2021-12-20 16:00:00,16
104,315,419,41,4.5,0,Clear,7.2,2021-12-20 17:00:00,17
77,259,336,48,3.4,0,Clear,5.4,2021-12-20 18:00:00,18
81,166,247,57,2.2,0,Clear,8.0,2021-12-20 19:00:00,19
53,95,148,66,1.2,0,Clear,7.6,2021-12-20 20:00:00,20
28,70,98,74,0.4,0,Clear,6.8,2021-12-20 21:00:00,21
23,40,63,79,-0.1,0,Clear,8.0,2021-12-20 22:00:00,22
18,20,38,82,-0.3,0,Clear,8.7,2021-12-20 23:00:00,23
10,9,19,83,-0.5,1,Mostly Clear,8.5,2021-12-21 00:00:00,0
3,5,8,85,-0.8,1,Mostly Clear,5.4,2021-12-21 01:00:00,1
5,2,7,87,-1.4,0,Clear,6.2,2021-12-21 02:00:00,2
0,2,2,86,-1.8,1,Mostly Clear,8.1,2021-12-21 03:00:00,3
2,11,13,86,-2.0,1,Mostly Clear,8.5,2021-12-21 04:00:00,4
5,22,27,86,-2.2,1,Mostly Clear,7.6,2021-12-21 05:00:00,5
24,71,95,86,-2.1,1,Mostly Clear,6.2,2021-12-21 06:00:00,6
36,176,212,81,-1.3,1,Mostly Clear,4.8,2021-12-21 07:00:00,7
52,215,267,79,-0.8,1,Mostly Clear,5.9,2021-12-21 08:00:00,8
53,184,237,78,-0.3,1,Mostly Clear,4.4,2021-12-21 09:00:00,9
68,175,243,79,0.3,1,Mostly Clear,5.8,2021-12-21 10:00:00,10
106,198,304,64,2.0,1,Mostly Clear,4.7,2021-12-21 11:00:00,11
103,203,306,58,3.7,1,Mostly Clear,4.8,2021-12-21 12:00:00,12
98,179,277,53,4.9,1,Mostly Clear,6.6,2021-12-21 13:00:00,13
118,205,323,52,5.5,3,Cloudy,7.4,2021-12-21 14:00:00,14
140,236,376,54,5.1,3,Cloudy,7.0,2021-12-21 15:00:00,15
102,275,377,57,4.7,3,Cloudy,5.6,2021-12-21 16:00:00,16
100,309,409,61,4.2,3,Cloudy,5.8,2021-12-21 17:00:00,17
80,252,332,66,3.6,3,Cloudy,5.2,2021-12-21 18:00:00,18
37,138,175,68,3.6,3,Cloudy,6.3,2021-12-21 19:00:00,19
35,64,99,72,3.3,3,Cloudy,3.8,2021-12-21 20:00:00,20
11,61,72,76,3.1,3,Cloudy,5.6,2021-12-21 21:00:00,21
18,48,66,79,3.0,51,Light Drizzle,5.0,2021-12-21 22:00:00,22
4,21,25,82,2.8,51,Light Drizzle,5.5,2021-12-21 23:00:00,23
1,12,13,86,2.7,51,Light Drizzle,4.7,2021-12-22 00:00:00,0
3,2,5,88,2.6,3,Cloudy,3.9,2021-12-22 01:00:00,1
12,6,18,89,2.6,3,Cloudy,2.9,2021-12-22 02:00:00,2
4,1,5,94,2.7,3,Cloudy,5.7,2021-12-22 03:00:00,3
4,7,11,94,2.5,51,Light Drizzle,7.4,2021-12-22 04:00:00,4
6,15,21,93,2.4,2,Partly Cloudy,7.1,2021-12-22 05:00:00,5
19,61,80,92,1.9,1,Mostly Clear,4.8,2021-12-22 06:00:00,6
34,132,166,90,1.4,0,Clear,6.6,2021-12-22 07:00:00,7
42,161,203,86,0.8,0,Clear,8.9,2021-12-22 08:00:00,8
58,167,225,83,1.1,0,Clear,8.9,2021-12-22 09:00:00,9
84,175,259,81,3.3,0,Clear,12.0,2021-12-22 10:00:00,10
107,194,301,72,5.2,0,Clear,12.2,2021-12-22 11:00:00,11
99,206,305,59,6.2,0,Clear,19.8,2021-12-22 12:00:00,12
123,233,356,51,6.7,2,Partly Cloudy,24.2,2021-12-22 13:00:00,13
147,235,382,44,6.9,3,Cloudy,24.6,2021-12-22 14:00:00,14
150,253,403,42,8.2,1,Mostly Clear,23.5,2021-12-22 15:00:00,15
126,277,403,40,7.6,0,Clear,22.9,2021-12-22 16:00:00,16
88,239,327,40,6.5,0,Clear,21.0,2021-12-22 17:00:00,17
45,209,254,41,4.9,0,Clear,15.3,2021-12-22 18:00:00,18
32,144,176,42,3.7,0,Clear,14.3,2021-12-22 19:00:00,19
33,83,116,42,2.7,0,Clear,13.3,2021-12-22 20:00:00,20
36,64,100,42,2.0,0,Clear,12.6,2021-12-22 21:00:00,21
27,55,82,43,1.2,0,Clear,11.4,2021-12-22 22:00:00,22
13,27,40,43,0.6,0,Clear,10.5,2021-12-22 23:00:00,23
11,13,24,44,0.1,0,Clear,9.2,2021-12-23 00:00:00,0
8,7,15,45,-0.4,0,Clear,7.3,2021-12-23 01:00:00,1
4,11,15,47,-0.9,0,Clear,8.2,2021-12-23 02:00:00,2
3,2,5,53,-1.1,0,Clear,9.5,2021-12-23 03:00:00,3
5,9,14,55,-1.6,0,Clear,9.3,2021-12-23 04:00:00,4
4,12,16,57,-2.0,0,Clear,9.2,2021-12-23 05:00:00,5
14,48,62,61,-2.6,0,Clear,7.9,2021-12-23 06:00:00,6
22,92,114,65,-3.1,0,Clear,8.2,2021-12-23 07:00:00,7
33,89,122,66,-3.2,0,Clear,8.7,2021-12-23 08:00:00,8
55,131,186,67,-2.8,0,Clear,8.5,2021-12-23 09:00:00,9
72,137,209,52,0.2,0,Clear,9.9,2021-12-23 10:00:00,10
74,151,225,45,1.8,0,Clear,10.0,2021-12-23 11:00:00,11
104,179,283,42,2.9,0,Clear,8.7,2021-12-23 12:00:00,12
93,216,309,41,3.9,0,Clear,8.5,2021-12-23 13:00:00,13
137,228,365,39,4.8,0,Clear,6.9,2021-12-23 14:00:00,14
141,239,380,41,4.7,0,Clear,5.1,2021-12-23 15:00:00,15
120,238,358,40,4.9,0,Clear,4.2,2021-12-23 16:00:00,16
74,194,268,41,4.6,0,Clear,4.2,2021-12-23 17:00:00,17
49,160,209,48,3.3,0,Clear,5.3,2021-12-23 18:00:00,18
48,118,166,55,2.1,0,Clear,8.3,2021-12-23 19:00:00,19
41,67,108,61,1.2,1,Mostly Clear,9.8,2021-12-23 20:00:00,20
25,55,80,65,0.8,2,Partly Cloudy,11.6,2021-12-23 21:00:00,21
26,46,72,66,0.9,2,Partly Cloudy,12.7,2021-12-23 22:00:00,22
26,29,55,66,1.2,1,Mostly Clear,13.8,2021-12-23 23:00:00,23
14,16,30,64,1.6,2,Partly Cloudy,14.4,2021-12-24 00:00:00,0
6,11,17,62,2.1,3,Cloudy,16.3,2021-12-24 01:00:00,1
9,6,15,60,2.8,3,Cloudy,17.7,2021-12-24 02:00:00,2
1,1,2,53,3.6,3,Cloudy,18.3,2021-12-24 03:00:00,3
6,3,9,53,4.0,3,Cloudy,18.0,2021-12-24 04:00:00,4
2,12,14,53,4.4,3,Cloudy,16.7,2021-12-24 05:00:00,5
15,29,44,54,4.5,3,Cloudy,11.9,2021-12-24 06:00:00,6
9,41,50,55,4.4,1,Mostly Clear,11.4,2021-12-24 07:00:00,7
17,61,78,57,4.3,1,Mostly Clear,11.1,2021-12-24 08:00:00,8
32,106,138,60,4.2,1,Mostly Clear,10.3,2021-12-24 09:00:00,9
86,124,210,61,5.1,0,Clear,10.0,2021-12-24 10:00:00,10
95,181,276,53,7.6,0,Clear,8.1,2021-12-24 11:00:00,11
142,178,320,48,9.9,0,Clear,5.4,2021-12-24 12:00:00,12
137,204,341,45,11.9,1,Mostly Clear,3.4,2021-12-24 13:00:00,13
183,240,423,44,13.1,1,Mostly Clear,4.5,2021-12-24 14:00:00,14
181,188,369,42,13.7,1,Mostly Clear,5.2,2021-12-24 15:00:00,15
116,144,260,44,13.4,1,Mostly Clear,6.1,2021-12-24 16:00:00,16
77,125,202,51,12.0,2,Partly Cloudy,7.4,2021-12-24 17:00:00,17
60,107,167,58,10.0,3,Cloudy,8.8,2021-12-24 18:00:00,18
31,69,100,63,8.9,2,Partly Cloudy,9.7,2021-12-24 19:00:00,19
27,54,81,67,7.9,1,Mostly Clear,10.5,2021-12-24 20:00:00,20
23,53,76,71,7.4,1,Mostly Clear,11.1,2021-12-24 21:00:00,21
20,27,47,72,7.3,3,Cloudy,10.0,2021-12-24 22:00:00,22
21,26,47,69,7.8,2,Partly Cloudy,10.2,2021-12-24 23:00:00,23
13,18,31,66,8.4,3,Cloudy,10.4,2021-12-25 00:00:00,0
12,8,20,64,9.0,3,Cloudy,10.1,2021-12-25 01:00:00,1
6,9,15,65,9.0,3,Cloudy,10.4,2021-12-25 02:00:00,2
2,2,4,59,9.6,3,Cloudy,11.6,2021-12-25 03:00:00,3
3,5,8,60,9.8,3,Cloudy,13.2,2021-12-25 04:00:00,4
3,7,10,67,9.7,53,Heavy Drizzle,13.9,2021-12-25 05:00:00,5
3,15,18,77,9.1,3,Cloudy,12.4,2021-12-25 06:00:00,6
9,21,30,81,9.1,51,Light Drizzle,13.8,2021-12-25 07:00:00,7
18,34,52,86,9.0,55,Heavy Drizzle,15.9,2021-12-25 08:00:00,8
33,48,81,88,9.0,53,Heavy Drizzle,15.8,2021-12-25 09:00:00,9
64,66,130,89,9.5,51,Light Drizzle,17.5,2021-12-25 10:00:00,10
129,86,215,90,10.7,53,Heavy Drizzle,17.5,2021-12-25 11:00:00,11
187,107,294,88,11.9,53,Heavy Drizzle,17.5,2021-12-25 12:00:00,12
221,142,363,86,13.0,51,Light Drizzle,17.3,2021-12-25 13:00:00,13
294,186,480,75,15.4,0,Clear,17.3,2021-12-25 14:00:00,14
291,134,425,57,18.8,2,Partly Cloudy,15.5,2021-12-25 15:00:00,15
201,135,336,60,18.5,2,Partly Cloudy,13.2,2021-12-25 16:00:00,16
148,109,257,66,17.6,51,Light Drizzle,11.7,2021-12-25 17:00:00,17
82,51,133,73,16.7,51,Light Drizzle,11.2,2021-12-25 18:00:00,18
61,39,100,74,17.1,3,Cloudy,11.8,2021-12-25 19:00:00,19
33,19,52,75,17.0,2,Partly Cloudy,12.3,2021-12-25 20:00:00,20
21,25,46,79,16.2,51,Light Drizzle,10.2,2021-12-25 21:00:00,21
17,23,40,83,15.8,55,Heavy Drizzle,11.3,2021-12-25 22:00:00,22
25,19,44,92,15.0,61,Light Rain,11.4,2021-12-25 23:00:00,23
19,12,31,94,14.6,0,Clear,12.8,2021-12-26 00:00:00,0
6,5,11,94,13.9,0,Clear,16.7,2021-12-26 01:00:00,1
4,5,9,94,12.7,2,Partly Cloudy,16.3,2021-12-26 02:00:00,2
7,6,13,94,12.1,3,Cloudy,14.3,2021-12-26 03:00:00,3
1,4,5,92,11.5,3,Cloudy,14.3,2021-12-26 04:00:00,4
5,8,13,90,11.1,2,Partly Cloudy,14.0,2021-12-26 05:00:00,5
9,19,28,87,10.4,1,Mostly Clear,9.8,2021-12-26 06:00:00,6
19,20,39,86,9.5,1,Mostly Clear,8.5,2021-12-26 07:00:00,7
42,48,90,84,8.6,0,Clear,9.2,2021-12-26 08:00:00,8
95,106,201,81,8.0,0,Clear,9.7,2021-12-26 09:00:00,9
134,101,235,73,8.6,0,Clear,10.1,2021-12-26 10:00:00,10
198,155,353,62,9.4,0,Clear,12.0,2021-12-26 11:00:00,11
246,205,451,55,10.4,0,Clear,11.7,2021-12-26 12:00:00,12
296,194,490,49,11.5,0,Clear,11.3,2021-12-26 13:00:00,13
288,221,509,45,12.4,0,Clear,11.3,2021-12-26 14:00:00,14
295,212,507,45,15.2,0,Clear,11.9,2021-12-26 15:00:00,15
267,212,479,45,15.3,0,Clear,11.3,2021-12-26 16:00:00,16
163,158,321,48,14.5,0,Clear,8.2,2021-12-26 17:00:00,17
90,118,208,53,12.5,0,Clear,9.5,2021-12-26 18:00:00,18
71,102,173,55,11.0,0,Clear,11.8,2021-12-26 19:00:00,19
73,48,121,54,10.0,0,Clear,12.9,2021-12-26 20:00:00,20
37,48,85,53,9.0,0,Clear,13.3,2021-12-26 21:00:00,21
40,31,71,55,7.9,0,Clear,12.5,2021-12-26 22:00:00,22
31,32,63,59,6.9,0,Clear,11.7,2021-12-26 23:00:00,23
14,11,25,64,5.9,0,Clear,10.5,2021-12-27 00:00:00,0
6,6,12,71,4.6,1,Mostly Clear,10.1,2021-12-27 01:00:00,1
12,5,17,78,3.3,0,Clear,8.6,2021-12-27 02:00:00,2
3,2,5,75,3.0,1,Mostly Clear,7.2,2021-12-27 03:00:00,3
3,2,5,77,2.2,1,Mostly Clear,7.9,2021-12-27 04:00:00,4
6,17,23,78,1.8,3,Cloudy,7.4,2021-12-27 05:00:00,5
11,39,50,79,1.9,3,Cloudy,7.5,2021-12-27 06:00:00,6
24,76,100,72,3.2,3,Cloudy,4.0,2021-12-27 07:00:00,7
34,103,137,77,3.1,2,Partly Cloudy,5.7,2021-12-27 08:00:00,8
37,84,121,75,3.5,53,Heavy Drizzle,7.7,2021-12-27 09:00:00,9
74,98,172,75,3.8,51,Light Drizzle,6.3,2021-12-27 10:00:00,10
115,123,238,85,3.5,53,Heavy Drizzle,7.6,2021-12-27 11:00:00,11
91,128,219,89,3.5,53,Heavy Drizzle,7.9,2021-12-27 12:00:00,12
81,119,200,86,3.9,3,Cloudy,10.8,2021-12-27 13:00:00,13
113,163,276,78,5.2,3,Cloudy,12.0,2021-12-27 14:00:00,14
121,126,247,86,3.8,3,Cloudy,13.1,2021-12-27 15:00:00,15
99,177,276,86,4.0,3,Cloudy,12.6,2021-12-27 16:00:00,16
98,202,300,84,4.5,3,Cloudy,11.1,2021-12-27 17:00:00,17
79,144,223,84,4.7,3,Cloudy,7.5,2021-12-27 18:00:00,18
48,120,168,85,4.7,3,Cloudy,7.4,2021-12-27 19:00:00,19
51,59,110,88,4.6,1,Mostly Clear,5.9,2021-12-27 20:00:00,20
28,56,84,89,4.8,1,Mostly Clear,4.6,2021-12-27 21:00:00,21
27,40,67,91,5.0,1,Mostly Clear,6.6,2021-12-27 22:00:00,22
14,33,47,92,5.4,0,Clear,4.3,2021-12-27 23:00:00,23
7,7,14,94,5.5,0,Clear,5.4,2021-12-28 00:00:00,0
5,5,10,95,5.5,1,Mostly Clear,5.5,2021-12-28 01:00:00,1
1,2,3,93,6.1,51,Light Drizzle,5.8,2021-12-28 02:00:00,2
3,0,3,92,4.2,1,Mostly Clear,4.7,2021-12-28 03:00:00,3
2,6,8,93,3.7,1,Mostly Clear,5.7,2021-12-28 04:00:00,4
11,14,25,92,4.0,0,Clear,9.2,2021-12-28 05:00:00,5
15,60,75,91,4.1,2,Partly Cloudy,8.9,2021-12-28 06:00:00,6
11,89,100,91,4.5,1,Mostly Clear,10.6,2021-12-28 07:00:00,7
53,139,192,91,5.8,2,Partly Cloudy,13.7,2021-12-28 08:00:00,8
78,107,185,86,6.9,2,Partly Cloudy,14.3,2021-12-28 09:00:00,9
132,164,296,78,7.4,2,Partly Cloudy,11.7,2021-12-28 10:00:00,10
198,179,377,73,7.9,1,Mostly Clear,9.1,2021-12-28 11:00:00,11
204,184,388,65,8.9,1,Mostly Clear,7.1,2021-12-28 12:00:00,12
258,209,467,58,9.5,1,Mostly Clear,6.0,2021-12-28 13:00:00,13
243,218,461,56,9.8,1,Mostly Clear,4.0,2021-12-28 14:00:00,14
311,249,560,40,12.8,2,Partly Cloudy,1.8,2021-12-28 15:00:00,15
273,230,503,49,12.3,2,Partly Cloudy,1.6,2021-12-28 16:00:00,16
158,243,401,48,11.8,3,Cloudy,3.4,2021-12-28 17:00:00,17
135,174,309,52,10.7,3,Cloudy,5.8,2021-12-28 18:00:00,18
83,125,208,55,10.1,3,Cloudy,7.7,2021-12-28 19:00:00,19
70,79,149,55,9.9,3,Cloudy,8.7,2021-12-28 20:00:00,20
55,43,98,55,9.7,3,Cloudy,7.2,2021-12-28 21:00:00,21
44,46,90,57,9.4,3,Cloudy,9.1,2021-12-28 22:00:00,22
37,33,70,69,8.6,51,Light Drizzle,11.2,2021-12-28 23:00:00,23
8,12,20,79,8.3,51,Light Drizzle,11.3,2021-12-29 00:00:00,0
5,7,12,83,8.5,2,Partly Cloudy,8.5,2021-12-29 01:00:00,1
7,8,15,88,8.5,2,Partly Cloudy,9.2,2021-12-29 02:00:00,2
1,0,1,77,8.6,3,Cloudy,6.2,2021-12-29 03:00:00,3
4,12,16,85,8.3,3,Cloudy,5.2,2021-12-29 04:00:00,4
8,13,21,87,8.1,3,Cloudy,5.6,2021-12-29 05:00:00,5
16,54,70,83,8.5,3,Cloudy,8.7,2021-12-29 06:00:00,6
28,93,121,81,8.7,3,Cloudy,4.4,2021-12-29 07:00:00,7
56,119,175,84,8.7,3,Cloudy,0.5,2021-12-29 08:00:00,8
81,111,192,82,8.9,3,Cloudy,2.2,2021-12-29 09:00:00,9
152,136,288,82,9.4,3,Cloudy,2.5,2021-12-29 10:00:00,10
172,178,350,81,9.9,2,Partly Cloudy,0.5,2021-12-29 11:00:00,11
214,240,454,76,10.7,3,Cloudy,2.6,2021-12-29 12:00:00,12
204,201,405,72,12.0,3,Cloudy,4.3,2021-12-29 13:00:00,13
242,239,481,71,12.9,3,Cloudy,3.8,2021-12-29 14:00:00,14
259,259,518,69,12.5,1,Mostly Clear,4.1,2021-12-29 15:00:00,15
185,263,448,68,12.9,1,Mostly Clear,4.3,2021-12-29 16:00:00,16
141,200,341,71,12.2,2,Partly Cloudy,6.0,2021-12-29 17:00:00,17
60,132,192,77,10.7,3,Cloudy,6.2,2021-12-29 18:00:00,18
26,56,82,78,10.2,3,Cloudy,8.1,2021-12-29 19:00:00,19
22,46,68,78,9.9,3,Cloudy,7.6,2021-12-29 20:00:00,20
29,42,71,82,9.4,51,Light Drizzle,9.5,2021-12-29 21:00:00,21
28,40,68,89,8.6,61,Light Rain,8.3,2021-12-29 22:00:00,22
26,36,62,94,8.0,51,Light Drizzle,7.3,2021-12-29 23:00:00,23
6,5,11,95,7.9,51,Light Drizzle,7.0,2021-12-30 00:00:00,0
6,6,12,96,7.9,53,Heavy Drizzle,4.5,2021-12-30 01:00:00,1
7,5,12,97,7.9,53,Heavy Drizzle,4.3,2021-12-30 02:00:00,2
3,5,8,98,8.2,61,Light Rain,7.2,2021-12-30 03:00:00,3
6,7,13,98,8.1,55,Heavy Drizzle,8.3,2021-12-30 04:00:00,4
6,15,21,98,8.2,51,Light Drizzle,6.2,2021-12-30 05:00:00,5
9,46,55,98,8.2,3,Cloudy,0.7,2021-12-30 06:00:00,6
25,68,93,98,8.2,3,Cloudy,1.1,2021-12-30 07:00:00,7
25,79,104,98,8.2,3,Cloudy,1.8,2021-12-30 08:00:00,8
68,83,151,98,8.2,3,Cloudy,2.5,2021-12-30 09:00:00,9
115,136,251,98,8.5,3,Cloudy,3.2,2021-12-30 10:00:00,10
153,158,311,97,9.0,3,Cloudy,4.6,2021-12-30 11:00:00,11
172,199,371,95,9.6,3,Cloudy,3.9,2021-12-30 12:00:00,12
200,230,430,93,9.9,3,Cloudy,1.8,2021-12-30 13:00:00,13
251,232,483,91,10.5,3,Cloudy,4.6,2021-12-30 14:00:00,14
257,247,504,95,10.3,3,Cloudy,6.6,2021-12-30 15:00:00,15
201,295,496,95,10.4,3,Cloudy,7.4,2021-12-30 16:00:00,16
178,227,405,96,10.4,3,Cloudy,4.3,2021-12-30 17:00:00,17
104,198,302,97,10.2,3,Cloudy,3.2,2021-12-30 18:00:00,18
60,122,182,99,9.9,3,Cloudy,4.7,2021-12-30 19:00:00,19
63,101,164,99,9.9,3,Cloudy,5.1,2021-12-30 20:00:00,20
60,86,146,99,9.9,3,Cloudy,5.9,2021-12-30 21:00:00,21
55,58,113,100,9.9,3,Cloudy,5.4,2021-12-30 22:00:00,22
44,43,87,100,10.0,3,Cloudy,3.6,2021-12-30 23:00:00,23
19,29,48,100,10.0,3,Cloudy,3.7,2021-12-31 00:00:00,0
17,20,37,99,10.1,3,Cloudy,3.5,2021-12-31 01:00:00,1
17,7,24,100,10.0,3,Cloudy,3.5,2021-12-31 02:00:00,2
7,2,9,100,10.3,3,Cloudy,2.3,2021-12-31 03:00:00,3
12,9,21,100,10.1,3,Cloudy,2.8,2021-12-31 04:00:00,4
5,12,17,100,10.1,3,Cloudy,3.2,2021-12-31 05:00:00,5
15,34,49,100,10.2,3,Cloudy,2.9,2021-12-31 06:00:00,6
22,52,74,100,10.2,3,Cloudy,3.9,2021-12-31 07:00:00,7
31,69,100,100,10.3,3,Cloudy,5.7,2021-12-31 08:00:00,8
67,129,196,99,10.4,3,Cloudy,6.4,2021-12-31 09:00:00,9
127,175,302,97,11.0,3,Cloudy,7.6,2021-12-31 10:00:00,10
225,257,482,90,11.8,3,Cloudy,10.1,2021-12-31 11:00:00,11
243,295,538,89,12.4,3,Cloudy,11.5,2021-12-31 12:00:00,12
307,300,607,87,12.9,3,Cloudy,12.2,2021-12-31 13:00:00,13
315,317,632,82,13.7,3,Cloudy,13.0,2021-12-31 14:00:00,14
327,326,653,76,14.1,3,Cloudy,12.5,2021-12-31 15:00:00,15
291,246,537,75,14.4,3,Cloudy,9.4,2021-12-31 16:00:00,16
181,177,358,76,14.2,2,Partly Cloudy,8.9,2021-12-31 17:00:00,17
144,133,277,83,12.8,2,Partly Cloudy,8.7,2021-12-31 18:00:00,18
112,117,229,87,12.0,2,Partly Cloudy,9.4,2021-12-31 19:00:00,19
67,72,139,86,12.2,3,Cloudy,10.4,2021-12-31 20:00:00,20
49,65,114,86,12.4,3,Cloudy,10.3,2021-12-31 21:00:00,21
71,55,126,86,12.7,53,Heavy Drizzle,9.7,2021-12-31 22:00:00,22
72,46,118,90,12.6,53,Heavy Drizzle,9.0,2021-12-31 23:00:00,23
125,63,188,93,12.2,53,Heavy Drizzle,8.0,2022-01-01 00:00:00,0
122,79,201,95,11.8,51,Light Drizzle,6.9,2022-01-01 01:00:00,1
98,58,156,96,11.4,3,Cloudy,6.9,2022-01-01 02:00:00,2
28,22,50,98,12.0,3,Cloudy,6.6,2022-01-01 03:00:00,3
23,9,32,98,12.2,3,Cloudy,4.3,2022-01-01 04:00:00,4
14,16,30,98,12.3,3,Cloudy,1.6,2022-01-01 05:00:00,5
11,22,33,98,12.5,3,Cloudy,1.6,2022-01-01 06:00:00,6
6,11,17,97,12.7,3,Cloudy,2.4,2022-01-01 07:00:00,7
9,18,27,97,12.9,53,Heavy Drizzle,1.8,2022-01-01 08:00:00,8
5,25,30,97,12.8,61,Light Rain,1.8,2022-01-01 09:00:00,9
18,34,52,97,12.9,55,Heavy Drizzle,1.8,2022-01-01 10:00:00,10
23,37,60,97,13.7,51,Light Drizzle,2.6,2022-01-01 11:00:00,11
35,69,104,94,15.1,53,Heavy Drizzle,4.0,2022-01-01 12:00:00,12
82,98,180,98,15.3,55,Heavy Drizzle,5.1,2022-01-01 13:00:00,13
168,138,306,99,15.5,63,Rain,5.5,2022-01-01 14:00:00,14
244,196,440,98,14.2,51,Light Drizzle,6.2,2022-01-01 15:00:00,15
212,194,406,98,14.3,51,Light Drizzle,6.5,2022-01-01 16:00:00,16
143,148,291,99,14.3,51,Light Drizzle,5.4,2022-01-01 17:00:00,17
119,127,246,100,14.1,51,Light Drizzle,5.2,2022-01-01 18:00:00,18
114,104,218,100,14.2,3,Cloudy,6.8,2022-01-01 19:00:00,19
67,71,138,99,15.3,53,Heavy Drizzle,9.1,2022-01-01 20:00:00,20
45,55,100,93,17.7,61,Light Rain,10.2,2022-01-01 21:00:00,21
28,32,60,89,18.8,55,Heavy Drizzle,13.5,2022-01-01 22:00:00,22
49,38,87,89,19.2,51,Light Drizzle,13.7,2022-01-01 23:00:00,23
34,29,63,95,17.8,53,Heavy Drizzle,9.2,2022-01-02 00:00:00,0
9,13,22,97,15.7,51,Light Drizzle,3.7,2022-01-02 01:00:00,1
9,9,18,97,14.9,51,Light Drizzle,8.7,2022-01-02 02:00:00,2
2,7,9,96,14.4,51,Light Drizzle,8.6,2022-01-02 03:00:00,3
2,6,8,94,14.4,61,Light Rain,8.9,2022-01-02 04:00:00,4
6,8,14,93,14.4,61,Light Rain,12.9,2022-01-02 05:00:00,5
13,5,18,93,14.4,53,Heavy Drizzle,10.1,2022-01-02 06:00:00,6
16,34,50,92,14.4,53,Heavy Drizzle,8.0,2022-01-02 07:00:00,7
28,65,93,93,14.3,51,Light Drizzle,7.5,2022-01-02 08:00:00,8
62,139,201,94,13.9,3,Cloudy,8.9,2022-01-02 09:00:00,9
134,187,321,95,14.3,3,Cloudy,11.0,2022-01-02 10:00:00,10
184,275,459,93,15.0,1,Mostly Clear,9.4,2022-01-02 11:00:00,11
259,331,590,86,16.6,1,Mostly Clear,10.7,2022-01-02 12:00:00,12
253,315,568,82,17.1,1,Mostly Clear,10.7,2022-01-02 13:00:00,13
291,299,590,81,17.0,2,Partly Cloudy,13.0,2022-01-02 14:00:00,14
309,332,641,77,18.2,2,Partly Cloudy,10.3,2022-01-02 15:00:00,15
227,283,510,75,18.4,2,Partly Cloudy,12.6,2022-01-02 16:00:00,16
187,229,416,76,17.1,51,Light Drizzle,15.6,2022-01-02 17:00:00,17
129,171,300,76,15.3,3,Cloudy,11.8,2022-01-02 18:00:00,18
79,103,182,71,13.5,51,Light Drizzle,16.4,2022-01-02 19:00:00,19
51,66,117,66,11.8,3,Cloudy,19.0,2022-01-02 20:00:00,20
49,64,113,58,10.5,2,Partly Cloudy,20.0,2022-01-02 21:00:00,21
40,39,79,56,9.2,3,Cloudy,18.5,2022-01-02 22:00:00,22
16,21,37,55,8.4,3,Cloudy,18.1,2022-01-02 23:00:00,23
12,6,18,56,7.6,3,Cloudy,16.2,2022-01-03 00:00:00,0
2,8,10,55,7.0,3,Cloudy,16.0,2022-01-03 01:00:00,1
2,6,8,56,6.2,3,Cloudy,16.7,2022-01-03 02:00:00,2
2,2,4,61,5.6,51,Light Drizzle,16.5,2022-01-03 03:00:00,3
3,4,7,70,4.0,71,Light Snow,15.0,2022-01-03 04:00:00,4
5,11,16,75,3.1,73,Snow,14.9,2022-01-03 05:00:00,5
10,34,44,75,2.5,75,Heavy Snow,14.0,2022-01-03 06:00:00,6
4,26,30,81,1.5,75,Heavy Snow,15.7,2022-01-03 07:00:00,7
6,19,25,85,0.9,75,Heavy Snow,15.3,2022-01-03 08:00:00,8
4,18,22,88,0.3,75,Heavy Snow,17.0,2022-01-03 09:00:00,9
7,2,9,92,-0.4,75,Heavy Snow,17.4,2022-01-03 10:00:00,10
5,8,13,90,-0.7,75,Heavy Snow,19.2,2022-01-03 11:00:00,11
9,13,22,89,-0.9,75,Heavy Snow,18.0,2022-01-03 12:00:00,12
10,11,21,86,-1.0,75,Heavy Snow,21.3,2022-01-03 13:00:00,13
9,8,17,77,-0.8,73,Snow,22.3,2022-01-03 14:00:00,14
16,23,39,63,-0.2,71,Light Snow,21.5,2022-01-03 15:00:00,15
15,26,41,61,0.0,0,Clear,19.2,2022-01-03 16:00:00,16
9,25,34,57,0.0,0,Clear,15.5,2022-01-03 17:00:00,17
11,21,32,62,-1.1,0,Clear,12.3,2022-01-03 18:00:00,18
6,12,18,66,-2.3,0,Clear,13.0,2022-01-03 19:00:00,19
8,9,17,68,-3.2,0,Clear,12.2,2022-01-03 20:00:00,20
10,17,27,70,-4.2,0,Clear,11.9,2022-01-03 21:00:00,21
5,7,12,72,-5.1,0,Clear,10.5,2022-01-03 22:00:00,22
4,7,11,74,-6.0,0,Clear,10.0,2022-01-03 23:00:00,23
5,3,8,75,-6.9,0,Clear,10.2,2022-01-04 00:00:00,0
4,0,4,76,-7.8,0,Clear,10.8,2022-01-04 01:00:00,1
2,2,4,79,-9.1,0,Clear,10.5,2022-01-04 03:00:00,3
0,5,5,79,-9.0,0,Clear,12.0,2022-01-04 04:00:00,4
4,2,6,75,-7.2,0,Clear,9.2,2022-01-04 05:00:00,5
4,18,22,70,-4.9,0,Clear,5.4,2022-01-04 06:00:00,6
3,24,27,73,-5.0,0,Clear,2.4,2022-01-04 07:00:00,7
12,25,37,76,-4.9,0,Clear,2.4,2022-01-04 08:00:00,8
8,38,46,79,-5.0,2,Partly Cloudy,2.2,2022-01-04 09:00:00,9
13,20,33,84,-5.0,3,Cloudy,5.0,2022-01-04 10:00:00,10
19,39,58,60,-2.4,0,Clear,4.4,2022-01-04 11:00:00,11
19,60,79,46,-0.7,0,Clear,3.3,2022-01-04 12:00:00,12
33,69,102,47,0.1,0,Clear,3.3,2022-01-04 13:00:00,13
43,49,92,61,-0.0,0,Clear,6.2,2022-01-04 14:00:00,14
28,72,100,61,0.4,0,Clear,9.3,2022-01-04 15:00:00,15
35,83,118,63,0.5,0,Clear,10.5,2022-01-04 16:00:00,16
39,118,157,71,-0.1,0,Clear,7.6,2022-01-04 17:00:00,17
38,91,129,80,-1.3,0,Clear,6.6,2022-01-04 18:00:00,18
20,60,80,83,-2.1,0,Clear,8.7,2022-01-04 19:00:00,19
11,41,52,85,-2.6,0,Clear,10.0,2022-01-04 20:00:00,20
7,19,26,86,-2.9,0,Clear,10.9,2022-01-04 21:00:00,21
13,35,48,88,-3.4,0,Clear,11.2,2022-01-04 22:00:00,22
9,15,24,90,-3.9,0,Clear,10.5,2022-01-04 23:00:00,23
5,6,11,91,-4.4,0,Clear,11.2,2022-01-05 00:00:00,0
4,0,4,92,-4.8,1,Mostly Clear,11.0,2022-01-05 01:00:00,1
2,0,2,94,-5.2,1,Mostly Clear,11.1,2022-01-05 02:00:00,2
3,1,4,93,-5.5,1,Mostly Clear,10.5,2022-01-05 03:00:00,3
2,6,8,93,-5.5,1,Mostly Clear,11.2,2022-01-05 04:00:00,4
7,14,21,92,-5.2,2,Partly Cloudy,11.9,2022-01-05 05:00:00,5
8,30,38,90,-4.0,3,Cloudy,10.2,2022-01-05 06:00:00,6
13,50,63,87,-1.8,3,Cloudy,12.8,2022-01-05 07:00:00,7
17,80,97,83,0.4,3,Cloudy,15.0,2022-01-05 08:00:00,8
31,70,101,83,1.3,2,Partly Cloudy,15.8,2022-01-05 09:00:00,9
25,77,102,82,2.3,1,Mostly Clear,15.4,2022-01-05 10:00:00,10
23,71,94,82,3.2,1,Mostly Clear,14.3,2022-01-05 11:00:00,11
29,76,105,80,4.3,1,Mostly Clear,14.7,2022-01-05 12:00:00,12
37,97,134,80,5.1,1,Mostly Clear,15.1,2022-01-05 13:00:00,13
48,107,155,79,5.8,1,Mostly Clear,12.7,2022-01-05 14:00:00,14
56,124,180,79,5.4,1,Mostly Clear,12.4,2022-01-05 15:00:00,15
50,137,187,78,5.6,2,Partly Cloudy,13.5,2022-01-05 16:00:00,16
54,186,240,80,5.1,2,Partly Cloudy,12.9,2022-01-05 17:00:00,17
45,158,203,84,4.4,0,Clear,11.2,2022-01-05 18:00:00,18
38,146,184,86,3.8,0,Clear,10.6,2022-01-05 19:00:00,19
37,74,111,86,3.5,0,Clear,11.3,2022-01-05 20:00:00,20
31,65,96,86,3.2,1,Mostly Clear,11.7,2022-01-05 21:00:00,21
23,55,78,85,3.3,1,Mostly Clear,12.2,2022-01-05 22:00:00,22
22,25,47,85,3.2,1,Mostly Clear,12.7,2022-01-05 23:00:00,23
12,8,20,86,3.0,1,Mostly Clear,13.5,2022-01-06 00:00:00,0
2,8,10,86,2.9,1,Mostly Clear,13.2,2022-01-06 01:00:00,1
2,7,9,86,2.8,0,Clear,11.8,2022-01-06 02:00:00,2
0,5,5,82,2.6,0,Clear,11.9,2022-01-06 03:00:00,3
5,5,10,81,1.8,0,Clear,11.2,2022-01-06 04:00:00,4
2,19,21,78,1.2,0,Clear,12.0,2022-01-06 05:00:00,5
19,62,81,76,0.5,0,Clear,12.9,2022-01-06 06:00:00,6
27,126,153,74,-0.3,1,Mostly Clear,10.0,2022-01-06 07:00:00,7
50,160,210,72,-1.2,1,Mostly Clear,11.8,2022-01-06 08:00:00,8
36,142,178,70,-1.7,1,Mostly Clear,9.2,2022-01-06 09:00:00,9
34,94,128,69,-1.1,1,Mostly Clear,9.0,2022-01-06 10:00:00,10
65,139,204,65,0.5,1,Mostly Clear,9.0,2022-01-06 11:00:00,11
84,165,249,54,2.6,1,Mostly Clear,8.5,2022-01-06 12:00:00,12
83,156,239,52,3.1,0,Clear,9.2,2022-01-06 13:00:00,13
84,187,271,59,3.0,1,Mostly Clear,6.9,2022-01-06 14:00:00,14
96,202,298,59,3.9,3,Cloudy,7.4,2022-01-06 15:00:00,15
86,243,329,60,3.7,3,Cloudy,6.8,2022-01-06 16:00:00,16
120,278,398,60,3.3,3,Cloudy,3.6,2022-01-06 17:00:00,17
85,253,338,64,2.8,3,Cloudy,5.2,2022-01-06 18:00:00,18
44,161,205,67,1.6,3,Cloudy,6.4,2022-01-06 19:00:00,19
49,91,140,69,1.0,3,Cloudy,9.4,2022-01-06 20:00:00,20
27,71,98,69,1.0,3,Cloudy,10.2,2022-01-06 21:00:00,21
29,73,102,66,1.2,3,Cloudy,10.2,2022-01-06 22:00:00,22
14,37,51,64,1.4,3,Cloudy,11.5,2022-01-06 23:00:00,23
15,19,34,65,1.4,3,Cloudy,10.7,2022-01-07 00:00:00,0
7,6,13,67,1.1,71,Light Snow,11.0,2022-01-07 01:00:00,1
5,2,7,73,0.5,73,Snow,13.1,2022-01-07 02:00:00,2
6,5,11,82,-0.2,73,Snow,17.6,2022-01-07 03:00:00,3
1,3,4,87,-0.4,75,Heavy Snow,13.7,2022-01-07 04:00:00,4
5,11,16,89,-0.4,73,Snow,12.2,2022-01-07 05:00:00,5
10,26,36,86,-0.3,71,Light Snow,12.0,2022-01-07 06:00:00,6
10,40,50,80,-0.6,2,Partly Cloudy,16.4,2022-01-07 07:00:00,7
17,59,76,71,-1.4,3,Cloudy,17.7,2022-01-07 08:00:00,8
11,52,63,65,-2.2,3,Cloudy,20.4,2022-01-07 09:00:00,9
25,56,81,58,-2.3,3,Cloudy,21.6,2022-01-07 10:00:00,10
38,78,116,55,-2.2,3,Cloudy,21.9,2022-01-07 11:00:00,11
48,81,129,51,-1.8,3,Cloudy,22.4,2022-01-07 12:00:00,12
58,109,167,49,-1.4,3,Cloudy,22.2,2022-01-07 13:00:00,13
40,116,156,47,-1.1,2,Partly Cloudy,22.3,2022-01-07 14:00:00,14
52,135,187,49,-1.4,3,Cloudy,22.7,2022-01-07 15:00:00,15
54,167,221,49,-1.6,1,Mostly Clear,22.1,2022-01-07 16:00:00,16
61,167,228,52,-2.2,0,Clear,20.3,2022-01-07 17:00:00,17
57,149,206,56,-3.2,0,Clear,15.0,2022-01-07 18:00:00,18
44,109,153,57,-4.0,0,Clear,13.5,2022-01-07 19:00:00,19
27,48,75,58,-4.6,0,Clear,13.0,2022-01-07 20:00:00,20
28,46,74,60,-5.1,0,Clear,12.1,2022-01-07 21:00:00,21
17,65,82,60,-5.5,0,Clear,11.9,2022-01-07 22:00:00,22
15,35,50,62,-5.8,0,Clear,13.8,2022-01-07 23:00:00,23
16,36,52,63,-6.1,0,Clear,14.4,2022-01-08 00:00:00,0
12,8,20,65,-6.5,0,Clear,13.7,2022-01-08 01:00:00,1
12,11,23,67,-6.9,0,Clear,13.4,2022-01-08 02:00:00,2
12,21,33,69,-6.7,0,Clear,12.9,2022-01-08 03:00:00,3
4,5,9,70,-7.2,0,Clear,12.4,2022-01-08 04:00:00,4
2,7,9,70,-8.0,0,Clear,11.9,2022-01-08 05:00:00,5
8,20,28,70,-8.9,0,Clear,11.5,2022-01-08 06:00:00,6
8,30,38,68,-8.8,0,Clear,10.4,2022-01-08 07:00:00,7
13,48,61,65,-8.4,0,Clear,9.4,2022-01-08 08:00:00,8
33,116,149,64,-8.2,0,Clear,8.2,2022-01-08 09:00:00,9
52,158,210,59,-6.5,0,Clear,8.5,2022-01-08 10:00:00,10
70,193,263,50,-3.3,0,Clear,7.0,2022-01-08 11:00:00,11
83,182,265,64,-2.8,0,Clear,3.3,2022-01-08 12:00:00,12
85,208,293,48,-0.7,0,Clear,1.5,2022-01-08 13:00:00,13
113,226,339,50,0.1,0,Clear,3.9,2022-01-08 14:00:00,14
119,222,341,48,0.3,0,Clear,5.5,2022-01-08 15:00:00,15
111,183,294,53,0.2,0,Clear,6.9,2022-01-08 16:00:00,16
72,163,235,56,-0.5,0,Clear,8.5,2022-01-08 17:00:00,17
60,151,211,64,-2.0,0,Clear,7.5,2022-01-08 18:00:00,18
42,105,147,69,-3.2,0,Clear,8.3,2022-01-08 19:00:00,19
19,74,93,73,-4.2,0,Clear,7.9,2022-01-08 20:00:00,20
21,37,58,76,-5.1,0,Clear,9.2,2022-01-08 21:00:00,21
26,56,82,78,-5.7,0,Clear,11.8,2022-01-08 22:00:00,22
31,34,65,79,-5.9,0,Clear,12.8,2022-01-08 23:00:00,23
20,35,55,78,-5.6,0,Clear,14.5,2022-01-09 00:00:00,0
20,24,44,77,-5.1,0,Clear,14.8,2022-01-09 01:00:00,1
10,18,28,75,-4.2,0,Clear,14.8,2022-01-09 02:00:00,2
7,13,20,71,-3.5,0,Clear,13.7,2022-01-09 03:00:00,3
3,13,16,70,-3.1,1,Mostly Clear,13.3,2022-01-09 04:00:00,4
8,6,14,69,-2.4,1,Mostly Clear,14.4,2022-01-09 05:00:00,5
14,12,26,66,-1.7,2,Partly Cloudy,14.5,2022-01-09 06:00:00,6
9,37,46,64,-1.0,2,Partly Cloudy,15.5,2022-01-09 07:00:00,7
23,83,106,63,-0.4,3,Cloudy,16.0,2022-01-09 08:00:00,8
25,121,146,62,0.5,3,Cloudy,16.1,2022-01-09 09:00:00,9
67,197,264,64,1.9,2,Partly Cloudy,15.5,2022-01-09 10:00:00,10
41,125,166,69,3.4,51,Light Drizzle,13.6,2022-01-09 11:00:00,11
36,99,135,74,4.3,51,Light Drizzle,13.3,2022-01-09 12:00:00,12
22,67,89,82,4.7,61,Light Rain,14.4,2022-01-09 13:00:00,13
10,45,55,88,5.4,55,Heavy Drizzle,17.1,2022-01-09 14:00:00,14
12,48,60,91,5.2,61,Light Rain,16.5,2022-01-09 15:00:00,15
18,60,78,92,6.0,61,Light Rain,15.6,2022-01-09 16:00:00,16
10,47,57,93,6.4,53,Heavy Drizzle,15.0,2022-01-09 17:00:00,17
18,53,71,95,6.9,55,Heavy Drizzle,12.4,2022-01-09 18:00:00,18
14,43,57,95,7.0,61,Light Rain,12.7,2022-01-09 19:00:00,19
14,47,61,96,6.6,61,Light Rain,10.7,2022-01-09 20:00:00,20
27,44,71,96,6.0,55,Heavy Drizzle,11.9,2022-01-09 21:00:00,21
25,35,60,94,5.8,51,Light Drizzle,13.2,2022-01-09 22:00:00,22
9,30,39,91,5.8,51,Light Drizzle,16.2,2022-01-09 23:00:00,23
8,20,28,88,4.5,1,Mostly Clear,18.2,2022-01-10 00:00:00,0
3,3,6,84,3.1,1,Mostly Clear,19.4,2022-01-10 01:00:00,1
2,7,9,80,1.8,1,Mostly Clear,19.1,2022-01-10 02:00:00,2
3,1,4,82,2.0,1,Mostly Clear,19.1,2022-01-10 03:00:00,3
2,9,11,75,0.8,1,Mostly Clear,20.6,2022-01-10 04:00:00,4
7,21,28,67,-0.3,0,Clear,20.9,2022-01-10 05:00:00,5
18,65,83,59,-1.0,0,Clear,17.8,2022-01-10 06:00:00,6
38,152,190,57,-1.7,0,Clear,17.8,2022-01-10 07:00:00,7
55,207,262,53,-2.1,0,Clear,17.3,2022-01-10 08:00:00,8
49,137,186,51,-2.5,0,Clear,17.6,2022-01-10 09:00:00,9
40,110,150,47,-2.0,0,Clear,18.9,2022-01-10 10:00:00,10
49,148,197,44,-1.2,0,Clear,18.1,2022-01-10 11:00:00,11
63,184,247,42,-0.4,0,Clear,17.6,2022-01-10 12:00:00,12
59,153,212,42,0.4,0,Clear,16.9,2022-01-10 13:00:00,13
65,137,202,41,1.0,1,Mostly Clear,17.8,2022-01-10 14:00:00,14
113,214,327,41,1.6,1,Mostly Clear,21.3,2022-01-10 15:00:00,15
100,264,364,41,2.6,2,Partly Cloudy,22.4,2022-01-10 16:00:00,16
103,304,407,44,2.5,0,Clear,17.1,2022-01-10 17:00:00,17
61,249,310,48,1.1,1,Mostly Clear,10.5,2022-01-10 18:00:00,18
70,184,254,51,-0.2,0,Clear,13.5,2022-01-10 19:00:00,19
33,116,149,51,-1.2,0,Clear,15.8,2022-01-10 20:00:00,20
28,77,105,51,-1.6,0,Clear,17.1,2022-01-10 21:00:00,21
28,58,86,50,-2.0,0,Clear,18.2,2022-01-10 22:00:00,22
17,28,45,49,-2.4,0,Clear,18.1,2022-01-10 23:00:00,23
9,21,30,48,-2.9,0,Clear,17.0,2022-01-11 00:00:00,0
4,6,10,48,-3.2,0,Clear,17.0,2022-01-11 01:00:00,1
3,3,6,47,-3.5,1,Mostly Clear,17.8,2022-01-11 02:00:00,2
1,2,3,47,-3.8,3,Cloudy,19.4,2022-01-11 03:00:00,3
0,10,10,46,-4.1,3,Cloudy,19.9,2022-01-11 04:00:00,4
12,23,35,46,-4.4,3,Cloudy,20.5,2022-01-11 05:00:00,5
13,74,87,44,-4.7,0,Clear,15.2,2022-01-11 06:00:00,6
41,169,210,43,-5.2,0,Clear,15.6,2022-01-11 07:00:00,7
55,215,270,42,-5.6,1,Mostly Clear,17.2,2022-01-11 08:00:00,8
30,148,178,42,-6.0,0,Clear,15.7,2022-01-11 09:00:00,9
34,102,136,42,-5.7,0,Clear,15.5,2022-01-11 10:00:00,10
36,113,149,43,-5.0,0,Clear,13.1,2022-01-11 11:00:00,11
47,128,175,42,-4.0,0,Clear,10.7,2022-01-11 12:00:00,12
49,139,188,41,-3.1,0,Clear,9.2,2022-01-11 13:00:00,13
54,147,201,40,-2.5,0,Clear,9.4,2022-01-11 14:00:00,14
65,146,211,42,-2.4,0,Clear,9.4,2022-01-11 15:00:00,15
63,196,259,43,-2.2,0,Clear,7.7,2022-01-11 16:00:00,16
86,277,363,51,-2.9,0,Clear,6.9,2022-01-11 17:00:00,17
58,222,280,31,-2.2,0,Clear,4.4,2022-01-11 18:00:00,18
44,165,209,33,-2.3,0,Clear,1.9,2022-01-11 19:00:00,19
35,92,127,35,-2.4,0,Clear,1.6,2022-01-11 20:00:00,20
22,77,99,37,-2.9,0,Clear,5.3,2022-01-11 21:00:00,21
17,53,70,45,-5.5,0,Clear,8.1,2022-01-11 22:00:00,22
6,25,31,51,-6.7,0,Clear,8.8,2022-01-11 23:00:00,23
4,7,11,58,-7.8,0,Clear,9.8,2022-01-12 00:00:00,0
5,11,16,64,-8.7,0,Clear,11.7,2022-01-12 01:00:00,1
0,2,2,66,-8.2,0,Clear,12.6,2022-01-12 02:00:00,2
2,0,2,70,-8.0,0,Clear,13.3,2022-01-12 03:00:00,3
3,4,7,68,-6.7,0,Clear,15.9,2022-01-12 04:00:00,4
10,32,42,67,-5.5,0,Clear,15.7,2022-01-12 05:00:00,5
16,83,99,65,-4.7,0,Clear,15.3,2022-01-12 06:00:00,6
35,194,229,63,-4.1,0,Clear,16.3,2022-01-12 07:00:00,7
60,241,301,61,-3.6,0,Clear,16.1,2022-01-12 08:00:00,8
47,141,188,61,-3.3,0,Clear,15.6,2022-01-12 09:00:00,9
37,115,152,60,-2.0,0,Clear,14.2,2022-01-12 10:00:00,10
60,115,175,53,0.1,0,Clear,16.4,2022-01-12 11:00:00,11
77,174,251,50,2.0,0,Clear,16.3,2022-01-12 12:00:00,12
88,161,249,48,3.7,0,Clear,15.3,2022-01-12 13:00:00,13
84,199,283,48,4.8,0,Clear,14.0,2022-01-12 14:00:00,14
87,251,338,47,5.6,1,Mostly Clear,12.9,2022-01-12 15:00:00,15
94,271,365,52,5.2,1,Mostly Clear,10.8,2022-01-12 16:00:00,16
104,358,462,59,4.1,1,Mostly Clear,8.1,2022-01-12 17:00:00,17
114,323,437,60,2.8,1,Mostly Clear,9.0,2022-01-12 18:00:00,18
82,228,310,64,1.4,1,Mostly Clear,10.1,2022-01-12 19:00:00,19
61,167,228,67,0.6,1,Mostly Clear,10.4,2022-01-12 20:00:00,20
49,89,138,71,-0.2,1,Mostly Clear,10.3,2022-01-12 21:00:00,21
39,75,114,75,-1.0,1,Mostly Clear,9.7,2022-01-12 22:00:00,22
17,35,52,79,-2.0,1,Mostly Clear,9.0,2022-01-12 23:00:00,23
9,11,20,81,-2.7,1,Mostly Clear,8.0,2022-01-13 00:00:00,0
4,8,12,80,-2.4,1,Mostly Clear,6.9,2022-01-13 01:00:00,1
2,5,7,79,-1.6,2,Partly Cloudy,6.9,2022-01-13 02:00:00,2
0,2,2,70,0.4,2,Partly Cloudy,6.6,2022-01-13 03:00:00,3
2,10,12,72,0.3,2,Partly Cloudy,4.3,2022-01-13 04:00:00,4
13,23,36,74,0.2,1,Mostly Clear,1.6,2022-01-13 05:00:00,5
23,83,106,76,0.1,1,Mostly Clear,1.6,2022-01-13 06:00:00,6
49,166,215,78,0.1,1,Mostly Clear,2.4,2022-01-13 07:00:00,7
66,290,356,80,-0.0,1,Mostly Clear,1.8,2022-01-13 08:00:00,8
63,180,243,82,-0.1,1,Mostly Clear,1.8,2022-01-13 09:00:00,9
57,143,200,76,1.2,1,Mostly Clear,1.8,2022-01-13 10:00:00,10
60,152,212,65,3.5,1,Mostly Clear,2.6,2022-01-13 11:00:00,11
104,236,340,59,5.8,1,Mostly Clear,4.0,2022-01-13 12:00:00,12
98,205,303,54,7.5,3,Cloudy,5.1,2022-01-13 13:00:00,13
120,219,339,59,7.3,3,Cloudy,5.5,2022-01-13 14:00:00,14
125,276,401,57,7.9,3,Cloudy,6.2,2022-01-13 15:00:00,15
111,292,403,59,7.5,3,Cloudy,6.5,2022-01-13 16:00:00,16
135,353,488,66,6.5,3,Cloudy,5.4,2022-01-13 17:00:00,17
111,336,447,71,5.2,3,Cloudy,5.2,2022-01-13 18:00:00,18
78,225,303,76,4.0,3,Cloudy,6.8,2022-01-13 19:00:00,19
50,123,173,78,3.4,3,Cloudy,7.6,2022-01-13 20:00:00,20
55,118,173,79,3.0,3,Cloudy,4.0,2022-01-13 21:00:00,21
52,77,129,79,2.6,3,Cloudy,9.8,2022-01-13 22:00:00,22
37,45,82,80,2.3,3,Cloudy,12.2,2022-01-13 23:00:00,23
14,31,45,81,2.0,3,Cloudy,5.4,2022-01-14 00:00:00,0
11,18,29,83,1.5,2,Partly Cloudy,6.2,2022-01-14 01:00:00,1
7,4,11,85,0.7,0,Clear,8.7,2022-01-14 02:00:00,2
5,5,10,82,0.4,0,Clear,9.9,2022-01-14 03:00:00,3
2,12,14,82,-0.0,1,Mostly Clear,9.0,2022-01-14 04:00:00,4
11,14,25,79,0.7,1,Mostly Clear,9.6,2022-01-14 05:00:00,5
21,92,113,80,0.7,2,Partly Cloudy,9.3,2022-01-14 06:00:00,6
46,178,224,83,0.7,2,Partly Cloudy,9.6,2022-01-14 07:00:00,7
62,236,298,86,1.0,2,Partly Cloudy,10.2,2022-01-14 08:00:00,8
66,172,238,87,1.9,1,Mostly Clear,10.8,2022-01-14 09:00:00,9
59,135,194,82,3.6,0,Clear,11.1,2022-01-14 10:00:00,10
78,162,240,74,5.6,0,Clear,13.0,2022-01-14 11:00:00,11
112,233,345,68,6.7,1,Mostly Clear,18.4,2022-01-14 12:00:00,12
115,210,325,62,7.8,1,Mostly Clear,16.4,2022-01-14 13:00:00,13
119,227,346,58,8.3,0,Clear,14.5,2022-01-14 14:00:00,14
137,270,407,60,8.1,1,Mostly Clear,15.5,2022-01-14 15:00:00,15
132,309,441,58,7.4,0,Clear,16.3,2022-01-14 16:00:00,16
140,367,507,56,6.4,0,Clear,15.6,2022-01-14 17:00:00,17
95,294,389,58,5.2,0,Clear,9.9,2022-01-14 18:00:00,18
93,201,294,59,4.2,1,Mostly Clear,10.3,2022-01-14 19:00:00,19
51,113,164,58,3.5,1,Mostly Clear,17.1,2022-01-14 20:00:00,20
44,79,123,57,2.7,2,Partly Cloudy,17.1,2022-01-14 21:00:00,21
49,80,129,56,2.0,2,Partly Cloudy,17.1,2022-01-14 22:00:00,22
36,62,98,55,1.2,1,Mostly Clear,17.5,2022-01-14 23:00:00,23
18,39,57,52,0.5,0,Clear,17.4,2022-01-15 00:00:00,0
20,33,53,50,-0.4,0,Clear,16.2,2022-01-15 01:00:00,1
13,22,35,46,-1.1,0,Clear,15.6,2022-01-15 02:00:00,2
2,12,14,42,-1.5,0,Clear,14.9,2022-01-15 03:00:00,3
4,8,12,39,-2.0,0,Clear,14.8,2022-01-15 04:00:00,4
8,5,13,36,-2.4,0,Clear,14.2,2022-01-15 05:00:00,5
9,22,31,34,-2.8,0,Clear,14.4,2022-01-15 06:00:00,6
15,49,64,33,-3.1,0,Clear,15.5,2022-01-15 07:00:00,7
15,90,105,33,-3.4,0,Clear,15.9,2022-01-15 08:00:00,8
42,116,158,33,-3.6,1,Mostly Clear,15.8,2022-01-15 09:00:00,9
76,164,240,31,-3.0,1,Mostly Clear,15.5,2022-01-15 10:00:00,10
94,206,300,31,-2.3,1,Mostly Clear,14.4,2022-01-15 11:00:00,11
104,218,322,30,-1.7,1,Mostly Clear,13.0,2022-01-15 12:00:00,12
101,213,314,29,-1.0,2,Partly Cloudy,12.3,2022-01-15 13:00:00,13
88,190,278,28,-0.6,2,Partly Cloudy,11.6,2022-01-15 14:00:00,14
111,231,342,27,-1.6,3,Cloudy,10.8,2022-01-15 15:00:00,15
115,183,298,26,-1.7,3,Cloudy,10.1,2022-01-15 16:00:00,16
70,158,228,24,-2.0,3,Cloudy,9.1,2022-01-15 17:00:00,17
43,127,170,23,-2.4,3,Cloudy,9.2,2022-01-15 18:00:00,18
51,102,153,24,-2.8,3,Cloudy,9.2,2022-01-15 19:00:00,19
30,71,101,24,-3.1,2,Partly Cloudy,9.0,2022-01-15 20:00:00,20
15,41,56,25,-3.5,0,Clear,10.0,2022-01-15 21:00:00,21
37,43,80,27,-4.1,0,Clear,9.5,2022-01-15 22:00:00,22
21,55,76,27,-4.6,0,Clear,8.7,2022-01-15 23:00:00,23
16,32,48,29,-5.1,0,Clear,8.7,2022-01-16 00:00:00,0
12,27,39,27,-5.4,0,Clear,7.9,2022-01-16 01:00:00,1
10,11,21,28,-5.6,0,Clear,8.7,2022-01-16 02:00:00,2
4,9,13,30,-6.4,0,Clear,9.4,2022-01-16 03:00:00,3
4,5,9,32,-6.7,0,Clear,8.6,2022-01-16 04:00:00,4
3,7,10,35,-7.0,0,Clear,8.2,2022-01-16 05:00:00,5
6,7,13,38,-7.2,0,Clear,7.1,2022-01-16 06:00:00,6
6,29,35,39,-7.4,0,Clear,8.7,2022-01-16 07:00:00,7
13,59,72,41,-7.4,1,Mostly Clear,5.1,2022-01-16 08:00:00,8
26,111,137,42,-6.9,1,Mostly Clear,8.9,2022-01-16 09:00:00,9
36,130,166,41,-5.7,1,Mostly Clear,10.1,2022-01-16 10:00:00,10
57,167,224,42,-4.3,1,Mostly Clear,8.1,2022-01-16 11:00:00,11
67,195,262,46,-3.0,3,Cloudy,9.3,2022-01-16 12:00:00,12
55,186,241,51,-1.9,3,Cloudy,10.8,2022-01-16 13:00:00,13
36,71,107,55,-1.2,3,Cloudy,13.5,2022-01-16 14:00:00,14
10,51,61,65,-2.9,71,Light Snow,13.4,2022-01-16 15:00:00,15
12,28,40,73,-2.8,73,Snow,14.7,2022-01-16 16:00:00,16
11,22,33,81,-2.7,75,Heavy Snow,15.0,2022-01-16 17:00:00,17
4,14,18,89,-2.4,75,Heavy Snow,17.1,2022-01-16 18:00:00,18
5,12,17,92,-0.9,75,Heavy Snow,23.5,2022-01-16 19:00:00,19
6,9,15,94,1.0,73,Snow,25.5,2022-01-16 20:00:00,20
3,8,11,94,3.1,71,Light Snow,28.8,2022-01-16 21:00:00,21
3,5,8,94,5.3,63,Rain,30.3,2022-01-16 22:00:00,22
7,6,13,94,7.2,63,Rain,30.1,2022-01-16 23:00:00,23
4,7,11,93,8.3,63,Rain,26.1,2022-01-17 00:00:00,0
3,5,8,94,8.8,63,Rain,21.9,2022-01-17 01:00:00,1
1,3,4,98,8.3,61,Light Rain,16.3,2022-01-17 02:00:00,2
2,1,3,96,5.5,51,Light Drizzle,23.6,2022-01-17 03:00:00,3
0,2,2,96,3.2,3,Cloudy,22.1,2022-01-17 04:00:00,4
2,5,7,97,1.6,51,Light Drizzle,20.1,2022-01-17 05:00:00,5
3,15,18,96,0.7,73,Snow,13.0,2022-01-17 06:00:00,6
6,29,35,94,0.4,73,Snow,16.9,2022-01-17 07:00:00,7
9,48,57,91,0.9,73,Snow,20.3,2022-01-17 08:00:00,8
26,78,104,86,1.2,1,Mostly Clear,17.4,2022-01-17 09:00:00,9
26,79,105,78,1.5,2,Partly Cloudy,17.4,2022-01-17 10:00:00,10
67,126,193,65,2.5,3,Cloudy,19.8,2022-01-17 11:00:00,11
65,175,240,60,2.7,3,Cloudy,26.8,2022-01-17 12:00:00,12
60,159,219,55,3.4,3,Cloudy,28.4,2022-01-17 13:00:00,13
65,171,236,50,3.9,3,Cloudy,29.7,2022-01-17 14:00:00,14
63,171,234,52,2.7,3,Cloudy,27.8,2022-01-17 15:00:00,15
60,200,260,52,2.3,3,Cloudy,27.8,2022-01-17 16:00:00,16
39,197,236,54,1.4,2,Partly Cloudy,24.1,2022-01-17 17:00:00,17
44,164,208,55,0.4,3,Cloudy,20.9,2022-01-17 18:00:00,18
26,121,147,55,-0.2,2,Partly Cloudy,20.3,2022-01-17 19:00:00,19
27,73,100,54,-0.4,2,Partly Cloudy,20.9,2022-01-17 20:00:00,20
17,50,67,54,-0.6,2,Partly Cloudy,21.9,2022-01-17 21:00:00,21
15,42,57,55,-0.8,1,Mostly Clear,22.8,2022-01-17 22:00:00,22
13,19,32,57,-1.1,0,Clear,23.5,2022-01-17 23:00:00,23
4,9,13,59,-1.3,0,Clear,23.6,2022-01-18 00:00:00,0
2,11,13,60,-1.4,0,Clear,22.9,2022-01-18 01:00:00,1
2,1,3,62,-1.4,0,Clear,21.9,2022-01-18 02:00:00,2
1,2,3,61,-0.9,0,Clear,21.4,2022-01-18 03:00:00,3
1,8,9,61,-0.9,0,Clear,20.3,2022-01-18 04:00:00,4
9,30,39,62,-1.0,0,Clear,18.5,2022-01-18 05:00:00,5
18,95,113,63,-1.1,2,Partly Cloudy,15.6,2022-01-18 06:00:00,6
43,175,218,64,-1.3,3,Cloudy,10.9,2022-01-18 07:00:00,7
63,294,357,66,-1.3,3,Cloudy,9.3,2022-01-18 08:00:00,8
43,177,220,67,-1.1,1,Mostly Clear,11.3,2022-01-18 09:00:00,9
40,130,170,66,-0.3,0,Clear,12.4,2022-01-18 10:00:00,10
48,136,184,58,0.9,1,Mostly Clear,21.3,2022-01-18 11:00:00,11
50,149,199,55,1.7,2,Partly Cloudy,21.3,2022-01-18 12:00:00,12
32,148,180,54,2.1,3,Cloudy,20.3,2022-01-18 13:00:00,13
64,170,234,52,2.7,3,Cloudy,19.5,2022-01-18 14:00:00,14
76,219,295,52,3.0,3,Cloudy,18.4,2022-01-18 15:00:00,15
79,255,334,51,3.1,3,Cloudy,16.9,2022-01-18 16:00:00,16
89,338,427,51,2.9,2,Partly Cloudy,15.5,2022-01-18 17:00:00,17
83,335,418,59,1.5,1,Mostly Clear,7.4,2022-01-18 18:00:00,18
62,207,269,65,-0.3,0,Clear,8.6,2022-01-18 19:00:00,19
31,125,156,70,-1.8,0,Clear,9.4,2022-01-18 20:00:00,20
34,109,143,65,-0.9,0,Clear,7.2,2022-01-18 21:00:00,21
32,52,84,61,-0.1,0,Clear,5.7,2022-01-18 22:00:00,22
16,31,47,67,-1.3,0,Clear,6.2,2022-01-18 23:00:00,23
9,17,26,73,-2.3,0,Clear,6.8,2022-01-19 00:00:00,0
4,15,19,77,-3.6,0,Clear,6.5,2022-01-19 01:00:00,1
5,4,9,78,-4.0,0,Clear,7.9,2022-01-19 02:00:00,2
4,4,8,78,-3.9,0,Clear,9.4,2022-01-19 03:00:00,3
3,3,6,78,-4.2,0,Clear,10.8,2022-01-19 04:00:00,4
11,28,39,77,-4.2,0,Clear,13.0,2022-01-19 05:00:00,5
25,103,128,73,-3.2,0,Clear,13.7,2022-01-19 06:00:00,6
44,205,249,70,-2.1,1,Mostly Clear,14.6,2022-01-19 07:00:00,7
74,318,392,67,-1.1,1,Mostly Clear,15.3,2022-01-19 08:00:00,8
46,177,223,65,-0.2,1,Mostly Clear,16.5,2022-01-19 09:00:00,9
32,149,181,63,1.4,1,Mostly Clear,15.5,2022-01-19 10:00:00,10
50,140,190,58,3.6,0,Clear,17.2,2022-01-19 11:00:00,11
67,230,297,54,5.8,0,Clear,18.3,2022-01-19 12:00:00,12
74,180,254,52,7.4,1,Mostly Clear,18.2,2022-01-19 13:00:00,13
83,203,286,51,8.7,0,Clear,17.4,2022-01-19 14:00:00,14
105,306,411,47,10.2,0,Clear,16.5,2022-01-19 15:00:00,15
111,285,396,49,10.5,1,Mostly Clear,13.7,2022-01-19 16:00:00,16
131,437,568,51,10.1,1,Mostly Clear,14.6,2022-01-19 17:00:00,17
118,420,538,54,8.7,1,Mostly Clear,12.7,2022-01-19 18:00:00,18
84,255,339,58,7.5,3,Cloudy,12.2,2022-01-19 19:00:00,19
70,167,237,59,7.2,2,Partly Cloudy,13.8,2022-01-19 20:00:00,20
72,138,210,60,7.1,1,Mostly Clear,13.6,2022-01-19 21:00:00,21
41,75,116,64,6.8,1,Mostly Clear,14.2,2022-01-19 22:00:00,22
8,43,51,71,6.4,3,Cloudy,14.3,2022-01-19 23:00:00,23
5,6,11,75,6.2,3,Cloudy,12.4,2022-01-20 00:00:00,0
4,11,15,80,5.8,51,Light Drizzle,10.5,2022-01-20 01:00:00,1
0,12,12,88,5.3,53,Heavy Drizzle,8.7,2022-01-20 02:00:00,2
1,3,4,92,5.1,53,Heavy Drizzle,5.9,2022-01-20 03:00:00,3
4,7,11,94,4.9,51,Light Drizzle,5.0,2022-01-20 04:00:00,4
3,11,14,95,4.5,51,Light Drizzle,4.9,2022-01-20 05:00:00,5
5,49,54,96,4.5,53,Heavy Drizzle,2.6,2022-01-20 06:00:00,6
9,40,49,95,4.6,53,Heavy Drizzle,5.7,2022-01-20 07:00:00,7
20,94,114,97,3.5,71,Light Snow,11.6,2022-01-20 08:00:00,8
22,87,109,100,2.0,73,Snow,13.1,2022-01-20 09:00:00,9
17,80,97,99,1.6,73,Snow,11.7,2022-01-20 10:00:00,10
33,96,129,97,1.5,73,Snow,13.3,2022-01-20 11:00:00,11
58,125,183,85,1.3,73,Snow,15.5,2022-01-20 12:00:00,12
50,114,164,74,1.4,71,Light Snow,14.1,2022-01-20 13:00:00,13
50,145,195,62,1.5,3,Cloudy,14.9,2022-01-20 14:00:00,14
73,176,249,71,2.1,71,Light Snow,14.8,2022-01-20 15:00:00,15
85,221,306,62,1.9,2,Partly Cloudy,15.7,2022-01-20 16:00:00,16
96,307,403,51,1.7,2,Partly Cloudy,15.7,2022-01-20 17:00:00,17
88,314,402,49,0.9,1,Mostly Clear,11.6,2022-01-20 18:00:00,18
78,211,289,49,-0.3,1,Mostly Clear,11.7,2022-01-20 19:00:00,19
46,113,159,50,-1.4,1,Mostly Clear,12.0,2022-01-20 20:00:00,20
42,115,157,49,-2.2,1,Mostly Clear,10.9,2022-01-20 21:00:00,21
39,58,97,48,-2.7,1,Mostly Clear,10.5,2022-01-20 22:00:00,22
17,49,66,46,-3.1,0,Clear,12.6,2022-01-20 23:00:00,23
7,22,29,46,-3.7,0,Clear,14.8,2022-01-21 00:00:00,0
5,18,23,46,-4.2,0,Clear,15.9,2022-01-21 01:00:00,1
2,8,10,46,-4.7,0,Clear,16.3,2022-01-21 02:00:00,2
2,1,3,46,-4.3,0,Clear,16.6,2022-01-21 03:00:00,3
4,7,11,45,-4.8,1,Mostly Clear,16.2,2022-01-21 04:00:00,4
14,25,39,44,-5.1,2,Partly Cloudy,15.9,2022-01-21 05:00:00,5
20,100,120,42,-5.3,1,Mostly Clear,16.2,2022-01-21 06:00:00,6
39,145,184,41,-5.4,1,Mostly Clear,15.2,2022-01-21 07:00:00,7
31,225,256,40,-5.6,1,Mostly Clear,14.2,2022-01-21 08:00:00,8
35,133,168,39,-5.4,2,Partly Cloudy,14.0,2022-01-21 09:00:00,9
29,114,143,38,-4.8,0,Clear,13.7,2022-01-21 10:00:00,10
36,107,143,36,-3.9,2,Partly Cloudy,12.6,2022-01-21 11:00:00,11
61,138,199,34,-2.9,2,Partly Cloudy,12.1,2022-01-21 12:00:00,12
56,161,217,35,-2.0,2,Partly Cloudy,11.7,2022-01-21 13:00:00,13
53,179,232,37,-1.5,3,Cloudy,11.5,2022-01-21 14:00:00,14
85,218,303,36,-2.3,3,Cloudy,10.6,2022-01-21 15:00:00,15
68,227,295,36,-2.4,3,Cloudy,10.4,2022-01-21 16:00:00,16
72,273,345,35,-2.5,3,Cloudy,10.4,2022-01-21 17:00:00,17
82,210,292,34,-2.8,3,Cloudy,8.8,2022-01-21 18:00:00,18
57,182,239,35,-3.1,2,Partly Cloudy,9.8,2022-01-21 19:00:00,19
38,104,142,34,-3.2,2,Partly Cloudy,11.0,2022-01-21 20:00:00,20
29,53,82,34,-3.4,2,Partly Cloudy,11.5,2022-01-21 21:00:00,21
27,73,100,34,-3.6,2,Partly Cloudy,11.8,2022-01-21 22:00:00,22
29,55,84,34,-3.7,2,Partly Cloudy,10.5,2022-01-21 23:00:00,23
19,28,47,34,-3.9,3,Cloudy,10.2,2022-01-22 00:00:00,0
4,29,33,35,-4.1,3,Cloudy,10.5,2022-01-22 01:00:00,1
13,24,37,36,-4.5,2,Partly Cloudy,10.9,2022-01-22 02:00:00,2
6,15,21,37,-4.8,1,Mostly Clear,10.8,2022-01-22 03:00:00,3
4,5,9,38,-5.2,0,Clear,10.9,2022-01-22 04:00:00,4
6,10,16,39,-5.8,0,Clear,11.3,2022-01-22 05:00:00,5
12,19,31,39,-6.2,0,Clear,12.6,2022-01-22 06:00:00,6
4,34,38,39,-6.5,0,Clear,11.2,2022-01-22 07:00:00,7
23,88,111,40,-6.9,0,Clear,10.1,2022-01-22 08:00:00,8
44,120,164,40,-7.0,0,Clear,9.4,2022-01-22 09:00:00,9
77,165,242,38,-6.0,0,Clear,8.8,2022-01-22 10:00:00,10
93,226,319,35,-4.7,0,Clear,8.0,2022-01-22 11:00:00,11
137,238,375,34,-3.0,0,Clear,5.1,2022-01-22 12:00:00,12
125,233,358,34,-1.4,0,Clear,4.1,2022-01-22 13:00:00,13
133,259,392,33,-0.2,0,Clear,4.1,2022-01-22 14:00:00,14
134,285,419,26,0.2,0,Clear,4.6,2022-01-22 15:00:00,15
135,272,407,25,0.3,0,Clear,4.4,2022-01-22 16:00:00,16
128,193,321,25,-0.1,0,Clear,4.3,2022-01-22 17:00:00,17
68,164,232,30,-1.0,0,Clear,5.2,2022-01-22 18:00:00,18
39,128,167,36,-2.6,0,Clear,5.4,2022-01-22 19:00:00,19
44,87,131,44,-4.3,1,Mostly Clear,5.7,2022-01-22 20:00:00,20
38,67,105,45,-4.8,2,Partly Cloudy,5.5,2022-01-22 21:00:00,21
28,47,75,47,-5.1,2,Partly Cloudy,6.1,2022-01-22 22:00:00,22
31,68,99,46,-4.6,1,Mostly Clear,8.3,2022-01-22 23:00:00,23
21,49,70,49,-4.3,0,Clear,9.6,2022-01-23 00:00:00,0
28,32,60,51,-4.3,0,Clear,8.7,2022-01-23 01:00:00,1
9,34,43,53,-4.5,1,Mostly Clear,8.4,2022-01-23 02:00:00,2
9,7,16,49,-4.9,1,Mostly Clear,7.9,2022-01-23 03:00:00,3
4,6,10,48,-5.1,0,Clear,6.6,2022-01-23 04:00:00,4
3,7,10,46,-5.1,1,Mostly Clear,6.5,2022-01-23 05:00:00,5
9,16,25,45,-5.0,1,Mostly Clear,7.2,2022-01-23 06:00:00,6
14,26,40,45,-5.1,1,Mostly Clear,7.9,2022-01-23 07:00:00,7
26,80,106,46,-4.7,0,Clear,6.7,2022-01-23 08:00:00,8
46,120,166,46,-3.9,1,Mostly Clear,4.0,2022-01-23 09:00:00,9
104,182,286,44,-2.0,1,Mostly Clear,3.2,2022-01-23 10:00:00,10
107,235,342,40,0.3,0,Clear,4.5,2022-01-23 11:00:00,11
138,229,367,38,2.1,0,Clear,6.6,2022-01-23 12:00:00,12
118,246,364,36,3.3,1,Mostly Clear,8.5,2022-01-23 13:00:00,13
154,254,408,34,4.2,2,Partly Cloudy,9.2,2022-01-23 14:00:00,14
111,260,371,34,4.8,2,Partly Cloudy,9.4,2022-01-23 15:00:00,15
94,188,282,33,4.9,2,Partly Cloudy,10.3,2022-01-23 16:00:00,16
78,199,277,39,4.0,2,Partly Cloudy,8.3,2022-01-23 17:00:00,17
60,164,224,46,2.1,2,Partly Cloudy,6.8,2022-01-23 18:00:00,18
43,122,165,50,0.9,1,Mostly Clear,6.8,2022-01-23 19:00:00,19
42,72,114,54,0.2,0,Clear,6.4,2022-01-23 20:00:00,20
33,58,91,58,-0.5,2,Partly Cloudy,8.3,2022-01-23 21:00:00,21
29,61,90,59,-0.8,1,Mostly Clear,5.9,2022-01-23 22:00:00,22
14,27,41,60,-0.9,0,Clear,6.1,2022-01-23 23:00:00,23
7,13,20,62,-1.4,0,Clear,9.0,2022-01-24 00:00:00,0
2,6,8,68,-1.5,0,Clear,10.2,2022-01-24 01:00:00,1
4,4,8,78,-1.8,1,Mostly Clear,9.2,2022-01-24 02:00:00,2
2,1,3,77,-1.5,2,Partly Cloudy,9.7,2022-01-24 03:00:00,3
3,8,11,81,-1.9,1,Mostly Clear,10.5,2022-01-24 04:00:00,4
12,26,38,82,-2.1,1,Mostly Clear,11.0,2022-01-24 05:00:00,5
18,93,111,79,-2.0,2,Partly Cloudy,5.7,2022-01-24 06:00:00,6
49,204,253,76,-2.1,2,Partly Cloudy,7.3,2022-01-24 07:00:00,7
57,306,363,72,-2.5,0,Clear,7.6,2022-01-24 08:00:00,8
42,199,241,68,-2.7,0,Clear,8.0,2022-01-24 09:00:00,9
35,94,129,56,-1.2,0,Clear,8.6,2022-01-24 10:00:00,10
64,138,202,48,0.1,0,Clear,5.4,2022-01-24 11:00:00,11
67,175,242,43,1.3,0,Clear,0.7,2022-01-24 12:00:00,12
76,173,249,40,2.5,0,Clear,4.5,2022-01-24 13:00:00,13
77,191,268,44,3.4,2,Partly Cloudy,9.1,2022-01-24 14:00:00,14
61,198,259,51,4.7,3,Cloudy,13.6,2022-01-24 15:00:00,15
86,291,377,51,4.9,3,Cloudy,15.6,2022-01-24 16:00:00,16
111,394,505,51,4.8,3,Cloudy,14.1,2022-01-24 17:00:00,17
111,339,450,56,3.9,3,Cloudy,7.6,2022-01-24 18:00:00,18
71,200,271,62,2.6,1,Mostly Clear,10.7,2022-01-24 19:00:00,19
39,132,171,69,1.4,0,Clear,11.9,2022-01-24 20:00:00,20
29,101,130,73,0.7,0,Clear,12.4,2022-01-24 21:00:00,21
25,67,92,74,0.4,1,Mostly Clear,11.7,2022-01-24 22:00:00,22
13,24,37,72,0.4,1,Mostly Clear,11.9,2022-01-24 23:00:00,23
10,9,19,72,0.7,2,Partly Cloudy,11.7,2022-01-25 00:00:00,0
8,5,13,75,0.9,2,Partly Cloudy,11.3,2022-01-25 01:00:00,1
3,2,5,80,0.8,3,Cloudy,11.5,2022-01-25 02:00:00,2
0,1,1,68,2.1,1,Mostly Clear,11.7,2022-01-25 03:00:00,3
3,11,14,71,1.5,0,Clear,10.5,2022-01-25 04:00:00,4
9,47,56,77,0.4,0,Clear,8.2,2022-01-25 05:00:00,5
28,108,136,83,-0.8,0,Clear,5.7,2022-01-25 06:00:00,6
48,226,274,84,-1.4,0,Clear,6.5,2022-01-25 07:00:00,7
77,359,436,84,-1.5,1,Mostly Clear,6.8,2022-01-25 08:00:00,8
52,185,237,84,-0.9,2,Partly Cloudy,5.4,2022-01-25 09:00:00,9
47,159,206,77,2.2,3,Cloudy,5.3,2022-01-25 10:00:00,10
55,150,205,69,4.8,3,Cloudy,5.1,2022-01-25 11:00:00,11
63,195,258,64,7.2,3,Cloudy,7.1,2022-01-25 12:00:00,12
76,173,249,59,8.0,2,Partly Cloudy,10.5,2022-01-25 13:00:00,13
91,205,296,59,8.0,2,Partly Cloudy,13.6,2022-01-25 14:00:00,14
88,247,335,57,7.8,2,Partly Cloudy,15.0,2022-01-25 15:00:00,15
119,316,435,55,6.9,3,Cloudy,15.1,2022-01-25 16:00:00,16
123,416,539,54,5.5,2,Partly Cloudy,14.7,2022-01-25 17:00:00,17
93,360,453,53,4.1,2,Partly Cloudy,14.1,2022-01-25 18:00:00,18
81,224,305,52,2.9,1,Mostly Clear,14.4,2022-01-25 19:00:00,19
42,162,204,51,1.8,1,Mostly Clear,13.8,2022-01-25 20:00:00,20
46,96,142,49,0.9,2,Partly Cloudy,13.7,2022-01-25 21:00:00,21
33,78,111,49,-0.1,3,Cloudy,13.0,2022-01-25 22:00:00,22
13,34,47,49,-1.0,3,Cloudy,13.7,2022-01-25 23:00:00,23
8,13,21,48,-1.6,1,Mostly Clear,13.3,2022-01-26 00:00:00,0
6,3,9,46,-2.2,0,Clear,13.2,2022-01-26 01:00:00,1
1,2,3,44,-2.6,0,Clear,12.1,2022-01-26 02:00:00,2
2,4,6,43,-2.7,0,Clear,11.2,2022-01-26 03:00:00,3
2,7,9,42,-2.9,0,Clear,10.7,2022-01-26 04:00:00,4
11,33,44,41,-3.2,0,Clear,10.5,2022-01-26 05:00:00,5
26,85,111,41,-3.4,0,Clear,11.9,2022-01-26 06:00:00,6
41,183,224,41,-3.7,0,Clear,10.9,2022-01-26 07:00:00,7
67,315,382,42,-4.1,1,Mostly Clear,10.7,2022-01-26 08:00:00,8
58,178,236,42,-3.8,0,Clear,11.8,2022-01-26 09:00:00,9
46,122,168,39,-2.5,0,Clear,13.4,2022-01-26 10:00:00,10
55,123,178,34,-1.3,0,Clear,11.4,2022-01-26 11:00:00,11
64,183,247,36,-0.6,0,Clear,11.9,2022-01-26 12:00:00,12
59,147,206,36,0.2,1,Mostly Clear,12.7,2022-01-26 13:00:00,13
57,141,198,36,0.5,0,Clear,13.0,2022-01-26 14:00:00,14
75,219,294,33,0.9,0,Clear,12.7,2022-01-26 15:00:00,15
81,220,301,35,0.7,0,Clear,12.5,2022-01-26 16:00:00,16
89,358,447,35,0.2,0,Clear,12.5,2022-01-26 17:00:00,17
100,324,424,35,-0.7,0,Clear,8.6,2022-01-26 18:00:00,18
72,194,266,38,-1.8,0,Clear,6.2,2022-01-26 19:00:00,19
49,122,171,40,-2.6,0,Clear,6.5,2022-01-26 20:00:00,20
51,130,181,42,-3.2,0,Clear,6.6,2022-01-26 21:00:00,21
25,80,105,43,-3.9,0,Clear,5.9,2022-01-26 22:00:00,22
9,37,46,45,-4.7,0,Clear,4.7,2022-01-26 23:00:00,23
13,18,31,46,-5.1,0,Clear,4.8,2022-01-27 00:00:00,0
2,8,10,43,-4.8,0,Clear,3.9,2022-01-27 01:00:00,1
2,5,7,40,-4.0,0,Clear,3.1,2022-01-27 02:00:00,2
2,4,6,43,-3.6,0,Clear,3.0,2022-01-27 03:00:00,3
4,11,15,46,-3.7,0,Clear,3.1,2022-01-27 04:00:00,4
8,25,33,49,-4.0,0,Clear,3.6,2022-01-27 05:00:00,5
19,96,115,52,-4.3,0,Clear,4.0,2022-01-27 06:00:00,6
50,176,226,56,-5.0,0,Clear,3.8,2022-01-27 07:00:00,7
64,318,382,61,-5.7,0,Clear,3.6,2022-01-27 08:00:00,8
53,185,238,64,-5.6,0,Clear,5.2,2022-01-27 09:00:00,9
32,145,177,50,-2.8,0,Clear,7.9,2022-01-27 10:00:00,10
55,169,224,43,-1.4,0,Clear,9.0,2022-01-27 11:00:00,11
67,186,253,39,-0.1,0,Clear,9.4,2022-01-27 12:00:00,12
57,178,235,37,1.1,0,Clear,9.5,2022-01-27 13:00:00,13
49,175,224,35,2.1,0,Clear,9.6,2022-01-27 14:00:00,14
67,213,280,35,2.1,0,Clear,9.8,2022-01-27 15:00:00,15
98,274,372,36,2.3,0,Clear,10.2,2022-01-27 16:00:00,16
114,367,481,40,2.0,0,Clear,9.7,2022-01-27 17:00:00,17
97,350,447,46,0.4,0,Clear,7.3,2022-01-27 18:00:00,18
62,222,284,51,-1.3,2,Partly Cloudy,7.1,2022-01-27 19:00:00,19
65,151,216,53,-1.7,3,Cloudy,7.8,2022-01-27 20:00:00,20
37,129,166,54,-1.6,3,Cloudy,8.6,2022-01-27 21:00:00,21
27,75,102,54,-1.4,3,Cloudy,9.5,2022-01-27 22:00:00,22
23,54,77,55,-1.4,2,Partly Cloudy,10.1,2022-01-27 23:00:00,23
18,20,38,56,-1.6,2,Partly Cloudy,9.5,2022-01-28 00:00:00,0
5,12,17,56,-1.6,2,Partly Cloudy,8.9,2022-01-28 01:00:00,1
7,4,11,56,-1.8,3,Cloudy,8.4,2022-01-28 02:00:00,2
3,6,9,56,-1.5,3,Cloudy,6.9,2022-01-28 03:00:00,3
4,9,13,57,-1.6,3,Cloudy,5.6,2022-01-28 04:00:00,4
8,32,40,57,-1.6,2,Partly Cloudy,4.3,2022-01-28 05:00:00,5
22,94,116,56,-1.1,3,Cloudy,0.8,2022-01-28 06:00:00,6
36,209,245,58,-1.2,3,Cloudy,1.8,2022-01-28 07:00:00,7
46,279,325,61,-1.5,3,Cloudy,3.3,2022-01-28 08:00:00,8
52,189,241,60,-1.2,3,Cloudy,4.2,2022-01-28 09:00:00,9
41,166,207,57,-0.2,3,Cloudy,4.5,2022-01-28 10:00:00,10
64,178,242,53,0.9,71,Light Snow,5.5,2022-01-28 11:00:00,11
67,221,288,50,2.2,3,Cloudy,5.9,2022-01-28 12:00:00,12
77,252,329,54,3.5,3,Cloudy,5.9,2022-01-28 13:00:00,13
71,186,257,57,3.7,71,Light Snow,7.1,2022-01-28 14:00:00,14
50,183,233,68,3.2,71,Light Snow,7.9,2022-01-28 15:00:00,15
38,155,193,72,2.7,71,Light Snow,8.4,2022-01-28 16:00:00,16
38,187,225,80,1.8,73,Snow,6.9,2022-01-28 17:00:00,17
20,134,154,87,0.8,73,Snow,6.5,2022-01-28 18:00:00,18
33,110,143,92,0.1,73,Snow,7.9,2022-01-28 19:00:00,19
15,54,69,93,-0.1,73,Snow,8.3,2022-01-28 20:00:00,20
20,48,68,93,-0.1,73,Snow,8.9,2022-01-28 21:00:00,21
25,41,66,93,-0.2,73,Snow,11.7,2022-01-28 22:00:00,22
16,37,53,90,-0.2,73,Snow,13.8,2022-01-28 23:00:00,23
17,26,43,87,-0.4,71,Light Snow,14.1,2022-01-29 00:00:00,0
9,24,33,83,-0.6,71,Light Snow,16.2,2022-01-29 01:00:00,1
18,20,38,79,-0.9,71,Light Snow,18.4,2022-01-29 02:00:00,2
5,9,14,77,-1.1,71,Light Snow,20.9,2022-01-29 03:00:00,3
2,7,9,69,-2.1,71,Light Snow,20.9,2022-01-29 04:00:00,4
6,5,11,65,-3.4,71,Light Snow,21.8,2022-01-29 05:00:00,5
6,10,16,61,-4.3,2,Partly Cloudy,20.3,2022-01-29 06:00:00,6
8,19,27,56,-5.0,3,Cloudy,20.1,2022-01-29 07:00:00,7
9,59,68,52,-5.6,3,Cloudy,20.5,2022-01-29 08:00:00,8
25,89,114,47,-5.9,3,Cloudy,22.7,2022-01-29 09:00:00,9
53,122,175,44,-6.0,3,Cloudy,23.8,2022-01-29 10:00:00,10
52,154,206,40,-5.8,3,Cloudy,24.6,2022-01-29 11:00:00,11
53,173,226,37,-5.2,3,Cloudy,24.6,2022-01-29 12:00:00,12
74,149,223,34,-4.5,3,Cloudy,24.2,2022-01-29 13:00:00,13
72,155,227,27,-3.4,1,Mostly Clear,24.5,2022-01-29 14:00:00,14
68,171,239,26,-2.8,0,Clear,25.0,2022-01-29 15:00:00,15
62,200,262,26,-2.8,0,Clear,25.8,2022-01-29 16:00:00,16
49,165,214,27,-3.3,0,Clear,26.0,2022-01-29 17:00:00,17
41,118,159,29,-4.1,0,Clear,21.4,2022-01-29 18:00:00,18
41,117,158,32,-4.9,0,Clear,20.6,2022-01-29 19:00:00,19
20,57,77,35,-5.3,0,Clear,20.3,2022-01-29 20:00:00,20
12,46,58,38,-5.5,0,Clear,20.7,2022-01-29 21:00:00,21
19,40,59,40,-5.8,0,Clear,21.8,2022-01-29 22:00:00,22
22,43,65,41,-6.1,0,Clear,21.2,2022-01-29 23:00:00,23
24,44,68,43,-6.4,0,Clear,19.6,2022-01-30 00:00:00,0
11,28,39,44,-6.8,0,Clear,19.1,2022-01-30 01:00:00,1
10,21,31,45,-7.1,0,Clear,17.1,2022-01-30 02:00:00,2
9,11,20,47,-6.9,0,Clear,15.9,2022-01-30 03:00:00,3
5,5,10,47,-7.0,0,Clear,14.2,2022-01-30 04:00:00,4
3,8,11,48,-7.2,0,Clear,13.2,2022-01-30 05:00:00,5
3,15,18,49,-7.3,0,Clear,13.5,2022-01-30 06:00:00,6
5,23,28,50,-7.4,0,Clear,12.0,2022-01-30 07:00:00,7
15,52,67,50,-7.5,0,Clear,9.3,2022-01-30 08:00:00,8
35,77,112,49,-7.3,0,Clear,8.4,2022-01-30 09:00:00,9
45,159,204,46,-6.1,0,Clear,8.0,2022-01-30 10:00:00,10
48,160,208,42,-4.3,2,Partly Cloudy,7.2,2022-01-30 11:00:00,11
66,214,280,38,-2.9,2,Partly Cloudy,7.5,2022-01-30 12:00:00,12
88,200,288,36,-1.6,2,Partly Cloudy,9.0,2022-01-30 13:00:00,13
79,226,305,35,-0.6,1,Mostly Clear,9.6,2022-01-30 14:00:00,14
109,219,328,36,0.0,1,Mostly Clear,8.4,2022-01-30 15:00:00,15
81,159,240,38,0.4,0,Clear,7.2,2022-01-30 16:00:00,16
61,140,201,39,0.3,0,Clear,6.9,2022-01-30 17:00:00,17
58,159,217,46,-0.6,1,Mostly Clear,5.1,2022-01-30 18:00:00,18
30,87,117,51,-1.6,1,Mostly Clear,6.9,2022-01-30 19:00:00,19
21,77,98,54,-2.0,2,Partly Cloudy,7.6,2022-01-30 20:00:00,20
26,68,94,57,-2.2,2,Partly Cloudy,5.1,2022-01-30 21:00:00,21
16,58,74,59,-2.6,2,Partly Cloudy,5.9,2022-01-30 22:00:00,22
11,10,21,62,-3.2,2,Partly Cloudy,5.7,2022-01-30 23:00:00,23
8,10,18,65,-3.4,0,Clear,7.3,2022-01-31 00:00:00,0
1,10,11,68,-3.6,0,Clear,8.3,2022-01-31 01:00:00,1
2,3,5,73,-4.0,0,Clear,8.3,2022-01-31 02:00:00,2
6,2,8,68,-4.5,0,Clear,8.2,2022-01-31 03:00:00,3
3,7,10,70,-4.6,0,Clear,8.2,2022-01-31 04:00:00,4
10,32,42,72,-4.8,1,Mostly Clear,7.9,2022-01-31 05:00:00,5
15,88,103,73,-5.1,1,Mostly Clear,7.4,2022-01-31 06:00:00,6
33,186,219,71,-4.7,1,Mostly Clear,8.2,2022-01-31 07:00:00,7
58,303,361,68,-4.3,2,Partly Cloudy,9.0,2022-01-31 08:00:00,8
32,209,241,66,-3.6,3,Cloudy,10.9,2022-01-31 09:00:00,9
45,128,173,62,-2.2,3,Cloudy,11.1,2022-01-31 10:00:00,10
43,142,185,59,-0.8,3,Cloudy,10.7,2022-01-31 11:00:00,11
58,163,221,56,0.5,3,Cloudy,10.6,2022-01-31 12:00:00,12
39,177,216,54,1.6,3,Cloudy,9.8,2022-01-31 13:00:00,13
58,189,247,52,2.4,3,Cloudy,8.7,2022-01-31 14:00:00,14
78,225,303,50,2.4,2,Partly Cloudy,8.4,2022-01-31 15:00:00,15
75,236,311,51,2.3,3,Cloudy,9.5,2022-01-31 16:00:00,16
93,394,487,52,1.9,3,Cloudy,10.5,2022-01-31 17:00:00,17
62,320,382,58,0.8,2,Partly Cloudy,8.6,2022-01-31 18:00:00,18
51,217,268,63,-0.5,1,Mostly Clear,7.6,2022-01-31 19:00:00,19
23,151,174,63,-0.8,1,Mostly Clear,6.4,2022-01-31 20:00:00,20
37,119,156,65,-1.2,2,Partly Cloudy,7.0,2022-01-31 21:00:00,21
25,65,90,68,-1.8,0,Clear,7.6,2022-01-31 22:00:00,22
16,21,37,72,-2.5,0,Clear,7.0,2022-01-31 23:00:00,23
5,12,17,77,-3.3,0,Clear,8.0,2022-02-01 00:00:00,0
8,4,12,81,-4.0,0,Clear,8.3,2022-02-01 01:00:00,1
1,2,3,82,-4.2,0,Clear,7.6,2022-02-01 02:00:00,2
1,2,3,77,-4.0,0,Clear,7.0,2022-02-01 03:00:00,3
3,9,12,77,-4.1,0,Clear,7.1,2022-02-01 04:00:00,4
10,42,52,77,-4.3,0,Clear,7.3,2022-02-01 05:00:00,5
23,115,138,77,-4.2,0,Clear,4.9,2022-02-01 06:00:00,6
42,232,274,76,-4.4,0,Clear,4.3,2022-02-01 07:00:00,7
67,360,427,76,-4.5,0,Clear,4.7,2022-02-01 08:00:00,8
49,208,257,74,-4.1,0,Clear,6.6,2022-02-01 09:00:00,9
37,157,194,64,-1.3,0,Clear,7.6,2022-02-01 10:00:00,10
54,159,213,61,0.9,0,Clear,6.9,2022-02-01 11:00:00,11
81,207,288,57,2.8,0,Clear,7.2,2022-02-01 12:00:00,12
66,216,282,54,4.1,0,Clear,8.8,2022-02-01 13:00:00,13
63,182,245,51,4.9,0,Clear,9.0,2022-02-01 14:00:00,14
77,266,343,49,5.3,0,Clear,9.6,2022-02-01 15:00:00,15
103,293,396,52,5.4,0,Clear,10.7,2022-02-01 16:00:00,16
146,489,635,56,4.7,0,Clear,10.9,2022-02-01 17:00:00,17
105,382,487,64,3.2,0,Clear,5.0,2022-02-01 18:00:00,18
76,279,355,72,1.5,0,Clear,6.0,2022-02-01 19:00:00,19
40,162,202,79,0.0,0,Clear,3.3,2022-02-01 20:00:00,20
43,125,168,84,-1.1,0,Clear,5.8,2022-02-01 21:00:00,21
30,84,114,86,-1.7,1,Mostly Clear,7.6,2022-02-01 22:00:00,22
16,41,57,89,-2.2,0,Clear,8.3,2022-02-01 23:00:00,23
6,11,17,91,-2.6,0,Clear,6.5,2022-02-02 00:00:00,0
4,2,6,93,-2.8,0,Clear,6.8,2022-02-02 01:00:00,1
1,6,7,94,-2.8,0,Clear,7.9,2022-02-02 02:00:00,2
1,3,4,92,-2.6,0,Clear,4.3,2022-02-02 03:00:00,3
4,5,9,94,-2.6,0,Clear,4.3,2022-02-02 04:00:00,4
15,42,57,93,-2.0,0,Clear,4.3,2022-02-02 05:00:00,5
25,102,127,92,-0.7,0,Clear,4.3,2022-02-02 06:00:00,6
46,215,261,93,-0.8,0,Clear,4.3,2022-02-02 07:00:00,7
78,392,470,93,-0.8,1,Mostly Clear,4.3,2022-02-02 08:00:00,8
54,264,318,93,-0.7,1,Mostly Clear,4.3,2022-02-02 09:00:00,9
55,143,198,84,1.4,1,Mostly Clear,4.3,2022-02-02 10:00:00,10
59,170,229,73,4.1,1,Mostly Clear,4.3,2022-02-02 11:00:00,11
94,206,300,66,6.4,1,Mostly Clear,4.3,2022-02-02 12:00:00,12
75,213,288,66,8.1,1,Mostly Clear,4.3,2022-02-02 13:00:00,13
86,194,280,63,9.0,0,Clear,4.3,2022-02-02 14:00:00,14
129,252,381,59,9.0,0,Clear,4.3,2022-02-02 15:00:00,15
139,342,481,59,9.1,0,Clear,4.3,2022-02-02 16:00:00,16
148,514,662,64,8.3,1,Mostly Clear,4.3,2022-02-02 17:00:00,17
125,436,561,74,6.3,1,Mostly Clear,4.3,2022-02-02 18:00:00,18
96,296,392,84,4.5,1,Mostly Clear,4.3,2022-02-02 19:00:00,19
60,219,279,89,3.7,1,Mostly Clear,11.7,2022-02-02 20:00:00,20
60,173,233,93,3.4,2,Partly Cloudy,10.5,2022-02-02 21:00:00,21
60,112,172,94,3.1,3,Cloudy,11.6,2022-02-02 22:00:00,22
19,56,75,95,3.0,3,Cloudy,10.7,2022-02-02 23:00:00,23
9,23,32,96,3.2,3,Cloudy,10.1,2022-02-03 00:00:00,0
4,3,7,97,3.4,3,Cloudy,9.0,2022-02-03 01:00:00,1
2,10,12,96,3.7,51,Light Drizzle,8.6,2022-02-03 02:00:00,2
0,6,6,97,3.9,53,Heavy Drizzle,9.2,2022-02-03 03:00:00,3
2,6,8,97,4.1,53,Heavy Drizzle,8.9,2022-02-03 04:00:00,4
8,23,31,97,4.3,53,Heavy Drizzle,8.7,2022-02-03 05:00:00,5
12,55,67,97,4.6,53,Heavy Drizzle,4.8,2022-02-03 06:00:00,6
22,88,110,97,4.8,53,Heavy Drizzle,5.0,2022-02-03 07:00:00,7
35,160,195,97,5.0,55,Heavy Drizzle,4.1,2022-02-03 08:00:00,8
23,113,136,97,5.3,53,Heavy Drizzle,6.2,2022-02-03 09:00:00,9
18,100,118,97,6.0,53,Heavy Drizzle,8.9,2022-02-03 10:00:00,10
16,67,83,96,6.7,55,Heavy Drizzle,10.9,2022-02-03 11:00:00,11
17,55,72,96,7.4,53,Heavy Drizzle,11.2,2022-02-03 12:00:00,12
25,64,89,96,8.6,53,Heavy Drizzle,10.5,2022-02-03 13:00:00,13
33,90,123,97,9.6,51,Light Drizzle,11.5,2022-02-03 14:00:00,14
58,158,216,98,8.8,53,Heavy Drizzle,12.0,2022-02-03 15:00:00,15
63,174,237,99,9.3,53,Heavy Drizzle,11.4,2022-02-03 16:00:00,16
88,342,430,99,9.9,53,Heavy Drizzle,11.4,2022-02-03 17:00:00,17
81,301,382,99,11.0,53,Heavy Drizzle,7.9,2022-02-03 18:00:00,18
45,163,208,99,12.2,53,Heavy Drizzle,11.2,2022-02-03 19:00:00,19
44,139,183,97,13.2,61,Light Rain,15.6,2022-02-03 20:00:00,20
44,107,151,96,13.5,63,Rain,19.2,2022-02-03 21:00:00,21
53,90,143,95,13.5,53,Heavy Drizzle,21.0,2022-02-03 22:00:00,22
66,112,178,95,13.5,53,Heavy Drizzle,21.6,2022-02-03 23:00:00,23
23,29,52,95,13.5,55,Heavy Drizzle,22.5,2022-02-04 00:00:00,0
12,15,27,95,13.7,51,Light Drizzle,23.4,2022-02-04 01:00:00,1
5,12,17,95,13.8,53,Heavy Drizzle,24.9,2022-02-04 02:00:00,2
7,9,16,96,14.6,51,Light Drizzle,25.4,2022-02-04 03:00:00,3
8,14,22,94,14.9,53,Heavy Drizzle,25.4,2022-02-04 04:00:00,4
11,22,33,94,15.0,51,Light Drizzle,24.1,2022-02-04 05:00:00,5
12,52,64,95,15.0,51,Light Drizzle,27.5,2022-02-04 06:00:00,6
8,76,84,95,15.4,53,Heavy Drizzle,23.6,2022-02-04 07:00:00,7
16,101,117,96,15.5,61,Light Rain,17.6,2022-02-04 08:00:00,8
24,72,96,100,12.3,63,Rain,13.7,2022-02-04 09:00:00,9
25,98,123,96,6.5,61,Light Rain,14.6,2022-02-04 10:00:00,10
22,77,99,96,3.3,61,Light Rain,15.8,2022-02-04 11:00:00,11
13,42,55,97,2.9,61,Light Rain,12.4,2022-02-04 12:00:00,12
24,51,75,95,2.9,61,Light Rain,14.1,2022-02-04 13:00:00,13
18,81,99,95,2.7,55,Heavy Drizzle,16.0,2022-02-04 14:00:00,14
34,97,131,94,4.3,61,Light Rain,17.2,2022-02-04 15:00:00,15
34,124,158,94,3.9,61,Light Rain,16.9,2022-02-04 16:00:00,16
35,118,153,92,3.2,51,Light Drizzle,15.0,2022-02-04 17:00:00,17
74,250,324,88,2.7,3,Cloudy,11.8,2022-02-04 18:00:00,18
56,182,238,84,2.3,3,Cloudy,11.9,2022-02-04 19:00:00,19
52,132,184,77,1.8,3,Cloudy,13.2,2022-02-04 20:00:00,20
33,94,127,69,1.2,3,Cloudy,14.0,2022-02-04 21:00:00,21
44,77,121,63,0.7,2,Partly Cloudy,14.5,2022-02-04 22:00:00,22
47,79,126,60,0.2,2,Partly Cloudy,15.9,2022-02-04 23:00:00,23
44,76,120,58,-0.1,2,Partly Cloudy,15.4,2022-02-05 00:00:00,0
20,54,74,58,-0.5,2,Partly Cloudy,16.5,2022-02-05 01:00:00,1
22,26,48,59,-0.9,2,Partly Cloudy,17.4,2022-02-05 02:00:00,2
13,17,30,63,-0.0,2,Partly Cloudy,18.5,2022-02-05 03:00:00,3
6,8,14,62,-0.3,2,Partly Cloudy,18.4,2022-02-05 04:00:00,4
3,14,17,61,-0.6,2,Partly Cloudy,17.7,2022-02-05 05:00:00,5
9,22,31,60,-0.8,1,Mostly Clear,14.1,2022-02-05 06:00:00,6
12,40,52,56,-1.3,2,Partly Cloudy,17.2,2022-02-05 07:00:00,7
21,101,122,53,-2.0,3,Cloudy,18.4,2022-02-05 08:00:00,8
54,149,203,49,-2.7,3,Cloudy,22.7,2022-02-05 09:00:00,9
93,191,284,46,-2.5,3,Cloudy,23.9,2022-02-05 10:00:00,10
101,248,349,43,-2.0,3,Cloudy,24.0,2022-02-05 11:00:00,11
107,258,365,40,-1.1,2,Partly Cloudy,23.2,2022-02-05 12:00:00,12
114,259,373,40,-0.5,0,Clear,22.5,2022-02-05 13:00:00,13
108,264,372,38,0.1,0,Clear,21.9,2022-02-05 14:00:00,14
118,239,357,36,0.7,0,Clear,20.8,2022-02-05 15:00:00,15
104,270,374,35,0.7,0,Clear,19.8,2022-02-05 16:00:00,16
83,252,335,35,0.4,0,Clear,18.4,2022-02-05 17:00:00,17
71,143,214,34,-0.4,0,Clear,12.9,2022-02-05 18:00:00,18
51,154,205,36,-1.3,0,Clear,9.0,2022-02-05 19:00:00,19
46,102,148,38,-1.9,0,Clear,8.1,2022-02-05 20:00:00,20
40,93,133,39,-2.4,0,Clear,7.4,2022-02-05 21:00:00,21
31,71,102,41,-2.8,0,Clear,6.5,2022-02-05 22:00:00,22
44,75,119,50,-3.5,0,Clear,5.0,2022-02-05 23:00:00,23
41,64,105,55,-4.2,0,Clear,5.2,2022-02-06 00:00:00,0
21,64,85,50,-4.3,0,Clear,4.5,2022-02-06 01:00:00,1
19,46,65,50,-4.5,0,Clear,4.6,2022-02-06 02:00:00,2
10,13,23,54,-4.0,0,Clear,4.7,2022-02-06 03:00:00,3
2,11,13,51,-3.8,0,Clear,5.1,2022-02-06 04:00:00,4
4,5,9,52,-3.8,0,Clear,5.1,2022-02-06 05:00:00,5
7,18,25,56,-4.5,0,Clear,7.7,2022-02-06 06:00:00,6
20,37,57,57,-4.8,0,Clear,8.0,2022-02-06 07:00:00,7
14,65,79,58,-4.8,0,Clear,8.1,2022-02-06 08:00:00,8
39,107,146,53,-4.1,0,Clear,9.0,2022-02-06 09:00:00,9
74,189,263,44,-2.0,0,Clear,9.0,2022-02-06 10:00:00,10
91,224,315,40,-0.8,0,Clear,8.5,2022-02-06 11:00:00,11
109,254,363,39,0.5,0,Clear,7.4,2022-02-06 12:00:00,12
129,280,409,40,1.5,0,Clear,6.5,2022-02-06 13:00:00,13
144,280,424,39,2.2,0,Clear,6.5,2022-02-06 14:00:00,14
144,287,431,38,2.1,0,Clear,7.5,2022-02-06 15:00:00,15
111,273,384,38,2.2,0,Clear,9.3,2022-02-06 16:00:00,16
77,225,302,39,1.7,0,Clear,10.2,2022-02-06 17:00:00,17
49,183,232,45,0.3,0,Clear,5.7,2022-02-06 18:00:00,18
42,125,167,51,-1.1,0,Clear,8.0,2022-02-06 19:00:00,19
29,85,114,57,-1.8,1,Mostly Clear,7.0,2022-02-06 20:00:00,20
25,57,82,63,-2.0,2,Partly Cloudy,6.8,2022-02-06 21:00:00,21
22,46,68,67,-1.7,2,Partly Cloudy,6.0,2022-02-06 22:00:00,22
13,32,45,71,-1.4,3,Cloudy,5.8,2022-02-06 23:00:00,23
4,20,24,74,-1.2,2,Partly Cloudy,5.3,2022-02-07 00:00:00,0
2,8,10,72,-0.9,2,Partly Cloudy,5.0,2022-02-07 01:00:00,1
2,4,6,76,-0.9,3,Cloudy,6.0,2022-02-07 02:00:00,2
1,3,4,75,-0.6,3,Cloudy,4.1,2022-02-07 03:00:00,3
2,8,10,77,-0.6,3,Cloudy,3.1,2022-02-07 04:00:00,4
12,31,43,81,-0.7,3,Cloudy,2.6,2022-02-07 05:00:00,5
16,116,132,83,-0.9,2,Partly Cloudy,4.2,2022-02-07 06:00:00,6
41,207,248,84,-1.1,2,Partly Cloudy,3.3,2022-02-07 07:00:00,7
66,352,418,87,-1.2,2,Partly Cloudy,5.0,2022-02-07 08:00:00,8
53,229,282,85,-0.6,2,Partly Cloudy,6.1,2022-02-07 09:00:00,9
41,144,185,76,1.3,2,Partly Cloudy,4.6,2022-02-07 10:00:00,10
33,185,218,72,3.0,2,Partly Cloudy,3.6,2022-02-07 11:00:00,11
59,209,268,70,4.5,2,Partly Cloudy,2.3,2022-02-07 12:00:00,12
42,226,268,65,5.8,3,Cloudy,1.3,2022-02-07 13:00:00,13
43,161,204,60,6.4,3,Cloudy,1.9,2022-02-07 14:00:00,14
71,173,244,70,5.4,3,Cloudy,3.4,2022-02-07 15:00:00,15
55,236,291,77,4.7,51,Light Drizzle,4.3,2022-02-07 16:00:00,16
60,278,338,84,3.9,51,Light Drizzle,5.6,2022-02-07 17:00:00,17
48,205,253,90,3.2,55,Heavy Drizzle,5.1,2022-02-07 18:00:00,18
36,157,193,94,2.4,53,Heavy Drizzle,6.8,2022-02-07 19:00:00,19
21,106,127,95,1.9,53,Heavy Drizzle,6.2,2022-02-07 20:00:00,20
28,96,124,96,1.7,51,Light Drizzle,5.6,2022-02-07 21:00:00,21
22,47,69,98,1.5,51,Light Drizzle,5.4,2022-02-07 22:00:00,22
10,37,47,98,1.5,2,Partly Cloudy,7.4,2022-02-07 23:00:00,23
11,17,28,97,1.3,1,Mostly Clear,9.2,2022-02-08 00:00:00,0
2,11,13,96,0.8,0,Clear,10.5,2022-02-08 01:00:00,1
2,5,7,96,0.0,0,Clear,9.4,2022-02-08 02:00:00,2
1,2,3,95,-0.3,0,Clear,9.4,2022-02-08 03:00:00,3
1,8,9,94,-1.1,0,Clear,9.4,2022-02-08 04:00:00,4
16,40,56,93,-1.5,0,Clear,10.2,2022-02-08 05:00:00,5
20,107,127,91,-1.6,0,Clear,10.5,2022-02-08 06:00:00,6
44,257,301,89,-1.4,0,Clear,9.4,2022-02-08 07:00:00,7
77,401,478,89,-1.3,0,Clear,8.4,2022-02-08 08:00:00,8
56,257,313,89,-0.6,0,Clear,10.0,2022-02-08 09:00:00,9
58,160,218,84,1.3,1,Mostly Clear,8.5,2022-02-08 10:00:00,10
58,171,229,73,3.0,0,Clear,10.2,2022-02-08 11:00:00,11
74,223,297,59,4.3,0,Clear,15.4,2022-02-08 12:00:00,12
70,216,286,52,5.1,0,Clear,16.2,2022-02-08 13:00:00,13
83,175,258,48,5.7,0,Clear,15.8,2022-02-08 14:00:00,14
92,250,342,41,7.8,0,Clear,16.7,2022-02-08 15:00:00,15
91,337,428,39,7.8,0,Clear,15.5,2022-02-08 16:00:00,16
118,484,602,38,7.4,0,Clear,13.4,2022-02-08 17:00:00,17
124,392,516,42,6.2,0,Clear,7.7,2022-02-08 18:00:00,18
77,300,377,47,4.2,0,Clear,7.9,2022-02-08 19:00:00,19
37,173,210,52,2.5,0,Clear,8.1,2022-02-08 20:00:00,20
54,148,202,59,1.1,0,Clear,7.2,2022-02-08 21:00:00,21
36,114,150,68,-0.5,0,Clear,7.6,2022-02-08 22:00:00,22
18,33,51,68,-0.9,0,Clear,6.8,2022-02-08 23:00:00,23
11,16,27,61,0.1,0,Clear,5.6,2022-02-09 00:00:00,0
10,9,19,67,-0.8,0,Clear,4.0,2022-02-09 01:00:00,1
1,5,6,74,-1.8,0,Clear,4.2,2022-02-09 02:00:00,2
2,2,4,76,-2.0,0,Clear,6.4,2022-02-09 03:00:00,3
3,7,10,77,-2.2,0,Clear,6.9,2022-02-09 04:00:00,4
15,35,50,79,-2.3,0,Clear,7.4,2022-02-09 05:00:00,5
20,92,112,80,-2.2,0,Clear,6.0,2022-02-09 06:00:00,6
48,266,314,83,-2.4,0,Clear,6.6,2022-02-09 07:00:00,7
90,409,499,85,-2.4,0,Clear,7.4,2022-02-09 08:00:00,8
68,235,303,86,-1.2,0,Clear,8.2,2022-02-09 09:00:00,9
60,186,246,73,3.1,0,Clear,6.9,2022-02-09 10:00:00,10
54,189,243,61,5.9,0,Clear,7.9,2022-02-09 11:00:00,11
86,238,324,53,8.3,0,Clear,8.8,2022-02-09 12:00:00,12
101,245,346,48,10.0,0,Clear,9.8,2022-02-09 13:00:00,13
88,252,340,45,11.3,0,Clear,10.9,2022-02-09 14:00:00,14
117,273,390,45,11.7,0,Clear,12.1,2022-02-09 15:00:00,15
137,405,542,44,12.0,0,Clear,13.4,2022-02-09 16:00:00,16
190,583,773,46,11.5,0,Clear,13.1,2022-02-09 17:00:00,17
141,491,632,54,9.8,0,Clear,9.6,2022-02-09 18:00:00,18
109,324,433,63,7.3,0,Clear,11.7,2022-02-09 19:00:00,19
79,206,285,68,6.0,0,Clear,12.9,2022-02-09 20:00:00,20
61,137,198,69,5.4,0,Clear,13.7,2022-02-09 21:00:00,21
51,133,184,69,5.0,0,Clear,14.6,2022-02-09 22:00:00,22
23,67,90,69,4.6,0,Clear,14.1,2022-02-09 23:00:00,23
20,27,47,67,4.7,1,Mostly Clear,14.1,2022-02-10 00:00:00,0
2,21,23,66,4.6,2,Partly Cloudy,13.9,2022-02-10 01:00:00,1
3,17,20,68,4.7,53,Heavy Drizzle,13.2,2022-02-10 02:00:00,2
0,10,10,58,5.0,51,Light Drizzle,11.0,2022-02-10 03:00:00,3
7,13,20,63,4.2,0,Clear,10.0,2022-02-10 04:00:00,4
12,30,42,69,3.1,0,Clear,10.6,2022-02-10 05:00:00,5
23,101,124,73,2.2,0,Clear,9.7,2022-02-10 06:00:00,6
62,229,291,78,1.2,0,Clear,8.3,2022-02-10 07:00:00,7
100,406,506,81,0.2,0,Clear,7.4,2022-02-10 08:00:00,8
84,289,373,82,0.9,0,Clear,9.7,2022-02-10 09:00:00,9
77,167,244,67,5.7,0,Clear,11.6,2022-02-10 10:00:00,10
95,212,307,56,9.1,0,Clear,11.7,2022-02-10 11:00:00,11
116,250,366,49,11.4,0,Clear,14.7,2022-02-10 12:00:00,12
94,265,359,40,12.7,0,Clear,20.6,2022-02-10 13:00:00,13
109,218,327,37,13.0,2,Partly Cloudy,25.1,2022-02-10 14:00:00,14
136,248,384,34,14.2,1,Mostly Clear,19.1,2022-02-10 15:00:00,15
206,369,575,35,14.2,1,Mostly Clear,13.4,2022-02-10 16:00:00,16
252,570,822,36,14.3,1,Mostly Clear,6.5,2022-02-10 17:00:00,17
172,461,633,42,12.7,0,Clear,7.0,2022-02-10 18:00:00,18
100,332,432,47,10.1,0,Clear,7.9,2022-02-10 19:00:00,19
81,196,277,51,7.9,0,Clear,7.7,2022-02-10 20:00:00,20
77,157,234,53,6.3,0,Clear,7.3,2022-02-10 21:00:00,21
55,134,189,60,4.6,0,Clear,7.6,2022-02-10 22:00:00,22
53,78,131,65,3.4,0,Clear,6.8,2022-02-10 23:00:00,23
17,32,49,51,5.3,0,Clear,7.6,2022-02-11 00:00:00,0
15,26,41,52,5.0,0,Clear,5.4,2022-02-11 01:00:00,1
10,7,17,65,2.2,0,Clear,4.7,2022-02-11 02:00:00,2
6,8,14,64,2.4,0,Clear,5.5,2022-02-11 03:00:00,3
7,7,14,61,3.1,0,Clear,4.8,2022-02-11 04:00:00,4
14,30,44,59,3.4,0,Clear,4.5,2022-02-11 05:00:00,5
17,100,117,60,3.3,0,Clear,6.7,2022-02-11 06:00:00,6
47,232,279,74,0.1,0,Clear,8.1,2022-02-11 07:00:00,7
91,348,439,81,-1.1,0,Clear,7.2,2022-02-11 08:00:00,8
68,195,263,83,0.0,0,Clear,9.1,2022-02-11 09:00:00,9
77,180,257,69,5.4,0,Clear,10.1,2022-02-11 10:00:00,10
110,200,310,57,8.9,0,Clear,10.5,2022-02-11 11:00:00,11
135,283,418,49,11.8,0,Clear,12.2,2022-02-11 12:00:00,12
189,318,507,43,13.9,0,Clear,15.2,2022-02-11 13:00:00,13
200,341,541,40,15.4,0,Clear,18.7,2022-02-11 14:00:00,14
276,410,686,37,16.7,0,Clear,20.3,2022-02-11 15:00:00,15
283,484,767,37,17.1,0,Clear,20.4,2022-02-11 16:00:00,16
329,591,920,38,16.8,0,Clear,20.0,2022-02-11 17:00:00,17
236,465,701,40,15.6,0,Clear,15.3,2022-02-11 18:00:00,18
178,323,501,43,13.9,0,Clear,13.8,2022-02-11 19:00:00,19
125,185,310,44,13.1,0,Clear,16.6,2022-02-11 20:00:00,20
107,136,243,46,12.7,0,Clear,19.0,2022-02-11 21:00:00,21
94,147,241,47,12.4,0,Clear,20.7,2022-02-11 22:00:00,22
75,120,195,49,12.0,0,Clear,21.4,2022-02-11 23:00:00,23
62,117,179,51,11.7,0,Clear,21.1,2022-02-12 00:00:00,0
66,86,152,52,11.4,0,Clear,20.7,2022-02-12 01:00:00,1
39,31,70,52,11.2,0,Clear,20.6,2022-02-12 02:00:00,2
21,25,46,48,11.3,0,Clear,20.0,2022-02-12 03:00:00,3
3,7,10,49,10.9,0,Clear,18.2,2022-02-12 04:00:00,4
6,14,20,52,10.3,1,Mostly Clear,15.1,2022-02-12 05:00:00,5
18,26,44,56,9.5,0,Clear,12.7,2022-02-12 06:00:00,6
29,64,93,61,8.3,1,Mostly Clear,11.2,2022-02-12 07:00:00,7
68,136,204,71,6.9,1,Mostly Clear,9.0,2022-02-12 08:00:00,8
152,267,419,79,6.3,1,Mostly Clear,8.3,2022-02-12 09:00:00,9
244,357,601,63,9.5,2,Partly Cloudy,9.5,2022-02-12 10:00:00,10
351,395,746,58,11.4,2,Partly Cloudy,12.7,2022-02-12 11:00:00,11
351,453,804,56,12.6,2,Partly Cloudy,14.3,2022-02-12 12:00:00,12
372,381,753,53,13.5,2,Partly Cloudy,14.2,2022-02-12 13:00:00,13
401,417,818,50,14.0,3,Cloudy,14.6,2022-02-12 14:00:00,14
435,408,843,49,15.2,3,Cloudy,15.7,2022-02-12 15:00:00,15
394,392,786,47,15.2,3,Cloudy,15.7,2022-02-12 16:00:00,16
278,358,636,46,14.7,2,Partly Cloudy,14.3,2022-02-12 17:00:00,17
157,243,400,50,13.0,1,Mostly Clear,9.1,2022-02-12 18:00:00,18
121,200,321,53,10.7,2,Partly Cloudy,10.1,2022-02-12 19:00:00,19
114,138,252,53,9.3,2,Partly Cloudy,10.3,2022-02-12 20:00:00,20
68,116,184,52,8.4,3,Cloudy,9.0,2022-02-12 21:00:00,21
60,92,152,51,7.7,2,Partly Cloudy,8.4,2022-02-12 22:00:00,22
59,68,127,53,7.1,2,Partly Cloudy,8.0,2022-02-12 23:00:00,23
40,61,101,56,6.3,51,Light Drizzle,10.1,2022-02-13 00:00:00,0
28,37,65,61,5.5,51,Light Drizzle,12.6,2022-02-13 01:00:00,1
13,21,34,69,4.4,51,Light Drizzle,14.0,2022-02-13 02:00:00,2
6,18,24,72,3.8,71,Light Snow,13.4,2022-02-13 03:00:00,3
4,5,9,88,2.4,73,Snow,12.3,2022-02-13 04:00:00,4
4,9,13,95,1.5,73,Snow,12.6,2022-02-13 05:00:00,5
3,16,19,93,1.3,73,Snow,9.4,2022-02-13 06:00:00,6
3,14,17,89,1.1,73,Snow,9.8,2022-02-13 07:00:00,7
18,41,59,87,0.9,73,Snow,9.1,2022-02-13 08:00:00,8
29,57,86,84,0.8,73,Snow,10.2,2022-02-13 09:00:00,9
42,100,142,79,0.8,71,Light Snow,11.8,2022-02-13 10:00:00,10
58,123,181,75,0.9,71,Light Snow,11.9,2022-02-13 11:00:00,11
51,111,162,71,1.1,71,Light Snow,11.3,2022-02-13 12:00:00,12
40,145,185,68,1.3,71,Light Snow,11.1,2022-02-13 13:00:00,13
55,118,173,66,1.4,71,Light Snow,10.8,2022-02-13 14:00:00,14
63,161,224,65,1.4,71,Light Snow,11.4,2022-02-13 15:00:00,15
64,178,242,61,1.4,71,Light Snow,10.7,2022-02-13 16:00:00,16
102,201,303,58,1.3,2,Partly Cloudy,10.5,2022-02-13 17:00:00,17
61,194,255,53,1.1,1,Mostly Clear,11.1,2022-02-13 18:00:00,18
40,98,138,53,0.5,0,Clear,8.1,2022-02-13 19:00:00,19
17,70,87,56,-0.1,0,Clear,5.9,2022-02-13 20:00:00,20
19,42,61,69,-1.6,0,Clear,7.4,2022-02-13 21:00:00,21
90,173,263,67,-2.5,0,Clear,8.2,2022-02-13 22:00:00,22
21,47,68,65,-3.2,0,Clear,8.2,2022-02-13 23:00:00,23
5,18,23,60,-3.7,0,Clear,8.8,2022-02-14 00:00:00,0
2,12,14,58,-4.1,0,Clear,8.6,2022-02-14 01:00:00,1
0,5,5,54,-4.3,0,Clear,9.1,2022-02-14 02:00:00,2
2,6,8,54,-3.2,0,Clear,8.7,2022-02-14 03:00:00,3
3,6,9,50,-2.6,0,Clear,7.5,2022-02-14 04:00:00,4
8,30,38,53,-3.5,1,Mostly Clear,8.8,2022-02-14 05:00:00,5
18,90,108,55,-4.1,1,Mostly Clear,8.0,2022-02-14 06:00:00,6
34,186,220,54,-4.2,3,Cloudy,13.0,2022-02-14 07:00:00,7
66,313,379,52,-3.6,2,Partly Cloudy,16.1,2022-02-14 08:00:00,8
40,175,215,46,-2.7,3,Cloudy,15.9,2022-02-14 09:00:00,9
39,120,159,39,-1.9,2,Partly Cloudy,15.8,2022-02-14 10:00:00,10
41,123,164,34,-1.2,2,Partly Cloudy,15.3,2022-02-14 11:00:00,11
48,148,196,33,-0.7,2,Partly Cloudy,14.5,2022-02-14 12:00:00,12
33,198,231,33,-0.1,3,Cloudy,14.2,2022-02-14 13:00:00,13
56,143,199,31,0.5,2,Partly Cloudy,14.7,2022-02-14 14:00:00,14
70,203,273,31,-0.0,2,Partly Cloudy,15.2,2022-02-14 15:00:00,15
59,256,315,30,0.2,2,Partly Cloudy,15.8,2022-02-14 16:00:00,16
88,370,458,28,0.1,1,Mostly Clear,16.3,2022-02-14 17:00:00,17
70,309,379,28,-0.3,1,Mostly Clear,12.2,2022-02-14 18:00:00,18
62,175,237,31,-1.4,0,Clear,5.8,2022-02-14 19:00:00,19
32,151,183,41,-2.7,0,Clear,6.4,2022-02-14 20:00:00,20
33,91,124,46,-3.9,0,Clear,8.2,2022-02-14 21:00:00,21
31,54,85,45,-4.4,0,Clear,9.4,2022-02-14 22:00:00,22
20,41,61,41,-4.7,0,Clear,9.9,2022-02-14 23:00:00,23
17,23,40,39,-5.0,0,Clear,8.2,2022-02-15 00:00:00,0
2,12,14,36,-4.2,0,Clear,6.4,2022-02-15 01:00:00,1
1,6,7,34,-2.9,0,Clear,5.8,2022-02-15 02:00:00,2
1,2,3,42,-4.5,0,Clear,4.7,2022-02-15 03:00:00,3
1,10,11,43,-4.4,0,Clear,4.3,2022-02-15 04:00:00,4
8,38,46,42,-3.6,0,Clear,3.2,2022-02-15 05:00:00,5
18,103,121,43,-3.6,0,Clear,5.5,2022-02-15 06:00:00,6
41,214,255,47,-4.3,0,Clear,4.0,2022-02-15 07:00:00,7
86,367,453,48,-4.0,0,Clear,4.0,2022-02-15 08:00:00,8
58,220,278,46,-3.6,0,Clear,3.3,2022-02-15 09:00:00,9
57,137,194,35,-1.9,0,Clear,2.5,2022-02-15 10:00:00,10
41,147,188,32,-0.3,0,Clear,1.8,2022-02-15 11:00:00,11
92,179,271,31,1.1,0,Clear,3.6,2022-02-15 12:00:00,12
75,154,229,31,2.4,0,Clear,5.4,2022-02-15 13:00:00,13
93,180,273,36,3.3,0,Clear,5.6,2022-02-15 14:00:00,14
93,237,330,39,3.3,0,Clear,5.6,2022-02-15 15:00:00,15
95,281,376,39,3.6,0,Clear,5.1,2022-02-15 16:00:00,16
132,442,574,39,3.5,0,Clear,5.2,2022-02-15 17:00:00,17
97,364,461,43,2.6,0,Clear,5.5,2022-02-15 18:00:00,18
83,245,328,52,0.3,0,Clear,7.4,2022-02-15 19:00:00,19
56,164,220,59,-1.1,0,Clear,9.9,2022-02-15 20:00:00,20
54,127,181,66,-1.8,0,Clear,11.3,2022-02-15 21:00:00,21
26,96,122,72,-2.0,0,Clear,12.0,2022-02-15 22:00:00,22
15,40,55,76,-2.2,0,Clear,11.5,2022-02-15 23:00:00,23
6,12,18,79,-2.2,1,Mostly Clear,11.2,2022-02-16 00:00:00,0
5,3,8,81,-2.1,1,Mostly Clear,11.3,2022-02-16 01:00:00,1
1,6,7,82,-2.0,1,Mostly Clear,12.1,2022-02-16 02:00:00,2
2,3,5,83,-1.9,0,Clear,11.8,2022-02-16 03:00:00,3
4,6,10,84,-2.0,0,Clear,11.3,2022-02-16 04:00:00,4
9,36,45,86,-2.1,0,Clear,11.4,2022-02-16 05:00:00,5
19,97,116,88,-2.1,0,Clear,10.6,2022-02-16 06:00:00,6
46,251,297,89,-2.2,0,Clear,9.5,2022-02-16 07:00:00,7
95,424,519,90,-2.2,0,Clear,9.3,2022-02-16 08:00:00,8
59,250,309,87,-1.1,0,Clear,11.4,2022-02-16 09:00:00,9
66,159,225,73,1.8,0,Clear,12.0,2022-02-16 10:00:00,10
44,173,217,64,4.3,0,Clear,13.7,2022-02-16 11:00:00,11
85,251,336,57,6.5,1,Mostly Clear,14.8,2022-02-16 12:00:00,12
92,198,290,53,8.3,1,Mostly Clear,15.5,2022-02-16 13:00:00,13
89,225,314,50,9.7,1,Mostly Clear,16.2,2022-02-16 14:00:00,14
130,291,421,48,10.3,1,Mostly Clear,15.8,2022-02-16 15:00:00,15
114,352,466,50,10.4,1,Mostly Clear,14.9,2022-02-16 16:00:00,16
184,530,714,56,9.9,1,Mostly Clear,13.2,2022-02-16 17:00:00,17
158,448,606,64,8.2,1,Mostly Clear,9.7,2022-02-16 18:00:00,18
119,317,436,78,5.7,1,Mostly Clear,11.9,2022-02-16 19:00:00,19
85,220,305,83,5.0,2,Partly Cloudy,12.9,2022-02-16 20:00:00,20
72,171,243,83,5.4,3,Cloudy,13.4,2022-02-16 21:00:00,21
56,130,186,82,5.7,2,Partly Cloudy,14.2,2022-02-16 22:00:00,22
29,61,90,82,5.8,1,Mostly Clear,14.4,2022-02-16 23:00:00,23
15,15,30,82,6.2,1,Mostly Clear,15.6,2022-02-17 00:00:00,0
8,11,19,83,6.8,1,Mostly Clear,16.7,2022-02-17 01:00:00,1
2,9,11,82,7.4,3,Cloudy,17.1,2022-02-17 02:00:00,2
0,8,8,79,8.1,3,Cloudy,17.8,2022-02-17 03:00:00,3
5,3,8,77,8.8,3,Cloudy,18.1,2022-02-17 04:00:00,4
12,45,57,78,9.2,3,Cloudy,18.9,2022-02-17 05:00:00,5
34,110,144,79,9.5,2,Partly Cloudy,22.1,2022-02-17 06:00:00,6
70,273,343,79,9.6,1,Mostly Clear,20.9,2022-02-17 07:00:00,7
95,446,541,79,9.8,1,Mostly Clear,20.2,2022-02-17 08:00:00,8
79,252,331,78,10.4,1,Mostly Clear,20.8,2022-02-17 09:00:00,9
75,233,308,73,11.7,1,Mostly Clear,22.1,2022-02-17 10:00:00,10
76,198,274,70,13.2,1,Mostly Clear,18.1,2022-02-17 11:00:00,11
99,266,365,66,14.5,1,Mostly Clear,21.6,2022-02-17 12:00:00,12
120,243,363,63,15.9,2,Partly Cloudy,21.4,2022-02-17 13:00:00,13
119,209,328,60,17.3,1,Mostly Clear,22.3,2022-02-17 14:00:00,14
124,315,439,58,18.9,1,Mostly Clear,20.9,2022-02-17 15:00:00,15
171,407,578,59,18.9,3,Cloudy,19.4,2022-02-17 16:00:00,16
268,649,917,59,18.6,3,Cloudy,20.9,2022-02-17 17:00:00,17
191,496,687,58,18.4,3,Cloudy,20.3,2022-02-17 18:00:00,18
127,383,510,58,17.8,3,Cloudy,18.1,2022-02-17 19:00:00,19
100,303,403,57,17.6,3,Cloudy,19.9,2022-02-17 20:00:00,20
101,221,322,58,17.3,3,Cloudy,23.9,2022-02-17 21:00:00,21
67,134,201,59,17.1,51,Light Drizzle,23.3,2022-02-17 22:00:00,22
40,72,112,76,15.2,55,Heavy Drizzle,23.1,2022-02-17 23:00:00,23
27,41,68,78,15.2,61,Light Rain,26.7,2022-02-18 00:00:00,0
22,30,52,81,15.8,61,Light Rain,29.1,2022-02-18 01:00:00,1
11,12,23,87,16.1,61,Light Rain,28.0,2022-02-18 02:00:00,2
5,7,12,94,16.6,61,Light Rain,25.6,2022-02-18 03:00:00,3
7,7,14,94,17.0,55,Heavy Drizzle,29.8,2022-02-18 04:00:00,4
13,24,37,94,17.3,51,Light Drizzle,30.0,2022-02-18 05:00:00,5
22,72,94,94,17.1,51,Light Drizzle,23.9,2022-02-18 06:00:00,6
35,202,237,84,14.2,53,Heavy Drizzle,27.4,2022-02-18 07:00:00,7
63,285,348,64,9.3,2,Partly Cloudy,32.4,2022-02-18 08:00:00,8
83,225,308,56,6.1,1,Mostly Clear,30.2,2022-02-18 09:00:00,9
59,165,224,54,5.1,0,Clear,29.4,2022-02-18 10:00:00,10
73,174,247,52,5.3,0,Clear,29.2,2022-02-18 11:00:00,11
105,204,309,49,5.7,0,Clear,28.0,2022-02-18 12:00:00,12
104,239,343,45,6.2,1,Mostly Clear,27.0,2022-02-18 13:00:00,13
98,238,336,41,6.7,1,Mostly Clear,25.7,2022-02-18 14:00:00,14
177,297,474,40,6.5,0,Clear,25.0,2022-02-18 15:00:00,15
145,302,447,37,6.4,0,Clear,22.9,2022-02-18 16:00:00,16
155,363,518,36,5.9,0,Clear,21.7,2022-02-18 17:00:00,17
93,331,424,35,5.0,0,Clear,17.5,2022-02-18 18:00:00,18
105,218,323,36,3.9,0,Clear,14.3,2022-02-18 19:00:00,19
59,164,223,38,2.9,0,Clear,12.6,2022-02-18 20:00:00,20
46,85,131,40,2.0,0,Clear,11.0,2022-02-18 21:00:00,21
34,105,139,46,1.0,0,Clear,9.6,2022-02-18 22:00:00,22
39,90,129,61,-0.4,0,Clear,7.4,2022-02-18 23:00:00,23
42,77,119,61,-1.1,0,Clear,6.4,2022-02-19 00:00:00,0
39,48,87,61,-1.4,0,Clear,6.1,2022-02-19 01:00:00,1
23,40,63,59,-1.2,0,Clear,6.2,2022-02-19 02:00:00,2
11,13,24,56,-0.5,0,Clear,4.8,2022-02-19 03:00:00,3
5,12,17,67,-2.2,0,Clear,4.9,2022-02-19 04:00:00,4
6,10,16,73,-3.3,0,Clear,6.0,2022-02-19 05:00:00,5
9,26,35,76,-3.7,0,Clear,8.5,2022-02-19 06:00:00,6
14,58,72,76,-3.2,0,Clear,11.9,2022-02-19 07:00:00,7
31,96,127,75,-2.4,0,Clear,13.2,2022-02-19 08:00:00,8
70,181,251,71,-0.7,0,Clear,14.4,2022-02-19 09:00:00,9
121,212,333,58,2.0,0,Clear,17.4,2022-02-19 10:00:00,10
189,272,461,48,4.3,0,Clear,17.8,2022-02-19 11:00:00,11
212,305,517,41,6.4,3,Cloudy,16.3,2022-02-19 12:00:00,12
215,289,504,36,7.7,0,Clear,17.0,2022-02-19 13:00:00,13
203,219,422,34,8.5,1,Mostly Clear,30.0,2022-02-19 14:00:00,14
158,269,427,35,7.9,1,Mostly Clear,30.3,2022-02-19 15:00:00,15
155,239,394,35,7.0,1,Mostly Clear,31.9,2022-02-19 16:00:00,16
108,188,296,32,4.9,0,Clear,31.6,2022-02-19 17:00:00,17
84,161,245,28,2.4,0,Clear,25.9,2022-02-19 18:00:00,18
63,141,204,28,0.6,0,Clear,23.2,2022-02-19 19:00:00,19
31,94,125,29,-0.7,0,Clear,21.1,2022-02-19 20:00:00,20
32,82,114,29,-1.6,0,Clear,19.9,2022-02-19 21:00:00,21
22,62,84,28,-2.1,0,Clear,19.1,2022-02-19 22:00:00,22
43,76,119,28,-2.4,0,Clear,18.1,2022-02-19 23:00:00,23
33,64,97,29,-2.8,0,Clear,15.8,2022-02-20 00:00:00,0
22,26,48,30,-3.0,0,Clear,13.3,2022-02-20 01:00:00,1
18,38,56,32,-3.3,0,Clear,11.5,2022-02-20 02:00:00,2
12,11,23,36,-3.9,0,Clear,9.3,2022-02-20 03:00:00,3
0,9,9,47,-4.6,0,Clear,7.4,2022-02-20 04:00:00,4
3,9,12,41,-4.2,0,Clear,4.1,2022-02-20 05:00:00,5
9,18,27,31,-3.3,0,Clear,3.7,2022-02-20 06:00:00,6
13,40,53,31,-3.2,0,Clear,2.2,2022-02-20 07:00:00,7
34,75,109,31,-3.1,0,Clear,1.5,2022-02-20 08:00:00,8
52,119,171,43,-3.4,0,Clear,4.6,2022-02-20 09:00:00,9
110,146,256,36,-1.3,0,Clear,5.8,2022-02-20 10:00:00,10
137,198,335,35,0.2,0,Clear,7.6,2022-02-20 11:00:00,11
168,253,421,35,1.7,0,Clear,8.7,2022-02-20 12:00:00,12
206,253,459,35,3.2,0,Clear,10.0,2022-02-20 13:00:00,13
222,262,484,35,4.4,0,Clear,11.6,2022-02-20 14:00:00,14
234,222,456,35,5.0,0,Clear,12.6,2022-02-20 15:00:00,15
219,244,463,35,5.5,0,Clear,14.5,2022-02-20 16:00:00,16
148,261,409,34,5.5,0,Clear,14.2,2022-02-20 17:00:00,17
93,207,300,39,4.4,0,Clear,7.1,2022-02-20 18:00:00,18
71,138,209,48,2.0,0,Clear,10.3,2022-02-20 19:00:00,19
47,101,148,56,1.0,0,Clear,12.2,2022-02-20 20:00:00,20
40,78,118,61,0.7,0,Clear,13.6,2022-02-20 21:00:00,21
42,76,118,62,0.7,0,Clear,13.8,2022-02-20 22:00:00,22
35,39,74,60,0.8,0,Clear,14.1,2022-02-20 23:00:00,23
23,33,56,56,1.0,0,Clear,14.5,2022-02-21 00:00:00,0
12,14,26,54,1.1,0,Clear,14.7,2022-02-21 01:00:00,1
8,7,15,54,1.1,0,Clear,14.7,2022-02-21 02:00:00,2
5,12,17,53,1.1,0,Clear,14.1,2022-02-21 03:00:00,3
3,9,12,54,0.9,0,Clear,12.8,2022-02-21 04:00:00,4
5,16,21,57,0.5,0,Clear,12.5,2022-02-21 05:00:00,5
16,36,52,58,0.3,0,Clear,11.2,2022-02-21 06:00:00,6
22,82,104,61,0.1,0,Clear,10.2,2022-02-21 07:00:00,7
47,103,150,67,-0.4,0,Clear,8.9,2022-02-21 08:00:00,8
81,175,256,71,0.8,0,Clear,10.0,2022-02-21 09:00:00,9
165,180,345,56,4.4,0,Clear,8.8,2022-02-21 10:00:00,10
265,247,512,50,7.1,0,Clear,8.2,2022-02-21 11:00:00,11
328,317,645,47,9.7,0,Clear,7.3,2022-02-21 12:00:00,12
389,385,774,44,12.0,0,Clear,6.3,2022-02-21 13:00:00,13
455,471,926,43,13.9,0,Clear,7.3,2022-02-21 14:00:00,14
448,487,935,38,15.8,0,Clear,8.6,2022-02-21 15:00:00,15
406,490,896,37,16.1,0,Clear,10.5,2022-02-21 16:00:00,16
358,474,832,39,15.7,0,Clear,10.9,2022-02-21 17:00:00,17
175,323,498,46,13.9,0,Clear,8.3,2022-02-21 18:00:00,18
104,198,302,55,11.0,1,Mostly Clear,10.7,2022-02-21 19:00:00,19
72,154,226,61,9.4,1,Mostly Clear,10.2,2022-02-21 20:00:00,20
52,108,160,65,8.4,1,Mostly Clear,9.8,2022-02-21 21:00:00,21
44,92,136,70,7.7,1,Mostly Clear,9.5,2022-02-21 22:00:00,22
26,44,70,74,7.3,1,Mostly Clear,8.9,2022-02-21 23:00:00,23
14,12,26,81,7.0,1,Mostly Clear,9.6,2022-02-22 00:00:00,0
9,6,15,87,6.7,0,Clear,10.5,2022-02-22 01:00:00,1
2,2,4,91,6.6,1,Mostly Clear,10.4,2022-02-22 02:00:00,2
3,2,5,94,7.3,2,Partly Cloudy,10.5,2022-02-22 03:00:00,3
3,8,11,96,7.7,3,Cloudy,10.6,2022-02-22 04:00:00,4
5,40,45,97,8.5,2,Partly Cloudy,10.5,2022-02-22 05:00:00,5
32,111,143,98,8.6,1,Mostly Clear,9.7,2022-02-22 06:00:00,6
58,252,310,99,9.0,2,Partly Cloudy,11.3,2022-02-22 07:00:00,7
114,425,539,99,9.8,3,Cloudy,12.3,2022-02-22 08:00:00,8
89,256,345,98,11.2,3,Cloudy,13.7,2022-02-22 09:00:00,9
37,113,150,93,13.0,3,Cloudy,15.8,2022-02-22 10:00:00,10
55,114,169,88,14.3,3,Cloudy,18.5,2022-02-22 11:00:00,11
85,173,258,83,15.4,3,Cloudy,17.4,2022-02-22 12:00:00,12
71,155,226,76,17.1,3,Cloudy,19.4,2022-02-22 13:00:00,13
53,103,156,76,17.4,51,Light Drizzle,19.8,2022-02-22 14:00:00,14
96,171,267,82,17.2,51,Light Drizzle,22.0,2022-02-22 15:00:00,15
82,229,311,84,16.9,61,Light Rain,24.0,2022-02-22 16:00:00,16
126,428,554,90,16.4,55,Heavy Drizzle,25.5,2022-02-22 17:00:00,17
115,399,514,89,16.5,51,Light Drizzle,26.1,2022-02-22 18:00:00,18
87,261,348,89,16.2,61,Light Rain,27.4,2022-02-22 19:00:00,19
70,204,274,90,16.3,53,Heavy Drizzle,27.9,2022-02-22 20:00:00,20
69,148,217,87,16.7,3,Cloudy,27.5,2022-02-22 21:00:00,21
52,98,150,83,17.2,3,Cloudy,27.4,2022-02-22 22:00:00,22
39,63,102,82,17.2,3,Cloudy,26.1,2022-02-22 23:00:00,23
14,18,32,82,17.1,3,Cloudy,23.6,2022-02-23 00:00:00,0
9,13,22,84,16.6,2,Partly Cloudy,22.0,2022-02-23 01:00:00,1
4,11,15,85,16.3,3,Cloudy,21.1,2022-02-23 02:00:00,2
2,4,6,78,16.8,3,Cloudy,20.1,2022-02-23 03:00:00,3
4,13,17,79,16.6,3,Cloudy,17.6,2022-02-23 04:00:00,4
6,42,48,81,16.3,3,Cloudy,16.2,2022-02-23 05:00:00,5
35,111,146,82,15.9,3,Cloudy,13.0,2022-02-23 06:00:00,6
62,253,315,82,15.6,3,Cloudy,15.4,2022-02-23 07:00:00,7
105,455,560,80,15.5,3,Cloudy,15.8,2022-02-23 08:00:00,8
97,263,360,79,15.4,51,Light Drizzle,15.6,2022-02-23 09:00:00,9
85,185,270,78,15.7,1,Mostly Clear,16.1,2022-02-23 10:00:00,10
128,227,355,74,16.5,1,Mostly Clear,15.0,2022-02-23 11:00:00,11
156,299,455,68,17.6,1,Mostly Clear,17.4,2022-02-23 12:00:00,12
148,263,411,62,19.0,2,Partly Cloudy,18.0,2022-02-23 13:00:00,13
170,276,446,58,19.7,2,Partly Cloudy,20.4,2022-02-23 14:00:00,14
201,371,572,52,22.0,1,Mostly Clear,17.9,2022-02-23 15:00:00,15
272,475,747,52,21.5,0,Clear,19.3,2022-02-23 16:00:00,16
401,689,1090,51,19.9,0,Clear,20.7,2022-02-23 17:00:00,17
288,596,884,51,17.0,1,Mostly Clear,14.3,2022-02-23 18:00:00,18
145,340,485,49,14.3,0,Clear,18.2,2022-02-23 19:00:00,19
96,240,336,49,12.1,0,Clear,21.7,2022-02-23 20:00:00,20
77,163,240,49,10.1,0,Clear,22.0,2022-02-23 21:00:00,21
51,102,153,48,8.3,1,Mostly Clear,20.1,2022-02-23 22:00:00,22
35,68,103,48,6.9,0,Clear,17.4,2022-02-23 23:00:00,23
14,22,36,47,5.9,2,Partly Cloudy,15.7,2022-02-24 00:00:00,0
6,15,21,46,5.1,3,Cloudy,13.3,2022-02-24 01:00:00,1
5,4,9,45,4.5,2,Partly Cloudy,13.2,2022-02-24 02:00:00,2
4,5,9,46,4.0,3,Cloudy,11.5,2022-02-24 03:00:00,3
4,11,15,46,3.6,3,Cloudy,12.3,2022-02-24 04:00:00,4
10,29,39,45,3.3,2,Partly Cloudy,12.5,2022-02-24 05:00:00,5
42,96,138,44,3.0,2,Partly Cloudy,12.6,2022-02-24 06:00:00,6
47,210,257,44,2.7,3,Cloudy,11.3,2022-02-24 07:00:00,7
83,364,447,45,2.6,3,Cloudy,10.1,2022-02-24 08:00:00,8
61,195,256,48,2.4,2,Partly Cloudy,11.2,2022-02-24 09:00:00,9
21,100,121,50,2.6,51,Light Drizzle,10.3,2022-02-24 10:00:00,10
16,76,92,56,2.5,51,Light Drizzle,9.0,2022-02-24 11:00:00,11
23,107,130,64,2.3,51,Light Drizzle,8.3,2022-02-24 12:00:00,12
27,79,106,64,2.4,51,Light Drizzle,8.4,2022-02-24 13:00:00,13
29,101,130,63,2.5,51,Light Drizzle,9.2,2022-02-24 14:00:00,14
51,173,224,83,1.6,51,Light Drizzle,9.3,2022-02-24 15:00:00,15
63,192,255,84,1.5,51,Light Drizzle,9.5,2022-02-24 16:00:00,16
53,234,287,82,1.6,3,Cloudy,11.2,2022-02-24 17:00:00,17
61,226,287,80,1.6,3,Cloudy,8.3,2022-02-24 18:00:00,18
51,168,219,79,1.7,3,Cloudy,8.8,2022-02-24 19:00:00,19
37,86,123,80,1.8,3,Cloudy,8.7,2022-02-24 20:00:00,20
27,91,118,81,2.0,3,Cloudy,8.0,2022-02-24 21:00:00,21
18,67,85,82,1.9,51,Light Drizzle,8.7,2022-02-24 22:00:00,22
8,18,26,87,1.7,51,Light Drizzle,9.1,2022-02-24 23:00:00,23
3,6,9,94,1.4,55,Heavy Drizzle,8.0,2022-02-25 00:00:00,0
4,9,13,96,1.3,61,Light Rain,11.7,2022-02-25 01:00:00,1
3,9,12,94,1.3,53,Heavy Drizzle,14.5,2022-02-25 02:00:00,2
2,5,7,96,0.8,53,Heavy Drizzle,10.4,2022-02-25 03:00:00,3
5,4,9,94,1.0,51,Light Drizzle,9.5,2022-02-25 04:00:00,4
7,23,30,94,1.2,51,Light Drizzle,11.4,2022-02-25 05:00:00,5
17,67,84,98,1.6,3,Cloudy,7.1,2022-02-25 06:00:00,6
34,117,151,99,2.1,53,Heavy Drizzle,9.2,2022-02-25 07:00:00,7
43,193,236,99,2.6,53,Heavy Drizzle,10.8,2022-02-25 08:00:00,8
56,181,237,100,3.4,61,Light Rain,5.9,2022-02-25 09:00:00,9
36,110,146,99,3.9,61,Light Rain,7.4,2022-02-25 10:00:00,10
64,150,214,98,4.7,3,Cloudy,10.8,2022-02-25 11:00:00,11
75,217,292,95,6.2,3,Cloudy,12.4,2022-02-25 12:00:00,12
146,229,375,91,8.2,2,Partly Cloudy,12.2,2022-02-25 13:00:00,13
183,277,460,67,11.6,1,Mostly Clear,21.1,2022-02-25 14:00:00,14
184,342,526,52,12.6,2,Partly Cloudy,26.9,2022-02-25 15:00:00,15
176,411,587,49,11.7,1,Mostly Clear,25.8,2022-02-25 16:00:00,16
171,463,634,49,10.6,2,Partly Cloudy,24.1,2022-02-25 17:00:00,17
133,359,492,50,9.2,1,Mostly Clear,18.4,2022-02-25 18:00:00,18
120,283,403,52,7.2,1,Mostly Clear,18.7,2022-02-25 19:00:00,19
73,182,255,52,5.6,0,Clear,19.1,2022-02-25 20:00:00,20
59,109,168,52,4.5,0,Clear,18.8,2022-02-25 21:00:00,21
56,126,182,52,3.5,0,Clear,18.7,2022-02-25 22:00:00,22
47,84,131,52,2.6,0,Clear,17.6,2022-02-25 23:00:00,23
42,58,100,53,1.8,0,Clear,15.3,2022-02-26 00:00:00,0
35,50,85,54,1.1,1,Mostly Clear,13.6,2022-02-26 01:00:00,1
20,32,52,54,0.6,1,Mostly Clear,12.5,2022-02-26 02:00:00,2
13,16,29,55,0.6,1,Mostly Clear,11.4,2022-02-26 03:00:00,3
2,7,9,54,0.3,1,Mostly Clear,10.5,2022-02-26 04:00:00,4
7,10,17,53,0.2,1,Mostly Clear,10.0,2022-02-26 05:00:00,5
12,34,46,54,-0.2,1,Mostly Clear,8.7,2022-02-26 06:00:00,6
10,43,53,55,-0.3,3,Cloudy,7.7,2022-02-26 07:00:00,7
36,126,162,59,-0.3,3,Cloudy,7.1,2022-02-26 08:00:00,8
88,175,263,53,0.3,2,Partly Cloudy,10.0,2022-02-26 09:00:00,9
145,248,393,48,1.0,3,Cloudy,11.4,2022-02-26 10:00:00,10
154,268,422,47,1.7,3,Cloudy,9.4,2022-02-26 11:00:00,11
201,286,487,45,3.1,2,Partly Cloudy,9.3,2022-02-26 12:00:00,12
255,317,572,44,4.5,1,Mostly Clear,9.3,2022-02-26 13:00:00,13
283,329,612,42,5.6,1,Mostly Clear,8.7,2022-02-26 14:00:00,14
259,289,548,42,6.0,1,Mostly Clear,8.6,2022-02-26 15:00:00,15
295,348,643,40,6.5,0,Clear,8.5,2022-02-26 16:00:00,16
238,263,501,39,6.8,0,Clear,9.1,2022-02-26 17:00:00,17
125,226,351,39,6.6,1,Mostly Clear,7.4,2022-02-26 18:00:00,18
95,214,309,45,5.8,1,Mostly Clear,3.4,2022-02-26 19:00:00,19
75,116,191,52,4.5,1,Mostly Clear,5.4,2022-02-26 20:00:00,20
59,90,149,58,3.6,1,Mostly Clear,4.5,2022-02-26 21:00:00,21
63,89,152,64,2.9,1,Mostly Clear,5.5,2022-02-26 22:00:00,22
50,110,160,69,2.2,1,Mostly Clear,6.6,2022-02-26 23:00:00,23
43,81,124,76,1.6,1,Mostly Clear,7.3,2022-02-27 00:00:00,0
34,64,98,81,0.9,1,Mostly Clear,7.3,2022-02-27 01:00:00,1
24,34,58,81,0.5,1,Mostly Clear,6.5,2022-02-27 02:00:00,2
14,23,37,83,-0.1,1,Mostly Clear,6.3,2022-02-27 03:00:00,3
8,6,14,81,-0.3,1,Mostly Clear,6.0,2022-02-27 04:00:00,4
5,9,14,78,-0.3,1,Mostly Clear,7.1,2022-02-27 05:00:00,5
8,19,27,77,-0.5,1,Mostly Clear,6.6,2022-02-27 06:00:00,6
19,31,50,74,-0.5,1,Mostly Clear,5.4,2022-02-27 07:00:00,7
26,96,122,75,-0.5,1,Mostly Clear,6.2,2022-02-27 08:00:00,8
101,164,265,72,0.9,1,Mostly Clear,6.3,2022-02-27 09:00:00,9
189,209,398,51,4.3,0,Clear,7.3,2022-02-27 10:00:00,10
209,297,506,40,6.1,0,Clear,12.6,2022-02-27 11:00:00,11
253,344,597,36,7.4,0,Clear,16.6,2022-02-27 12:00:00,12
283,337,620,34,8.8,0,Clear,17.7,2022-02-27 13:00:00,13
326,380,706,32,9.9,0,Clear,18.7,2022-02-27 14:00:00,14
310,408,718,30,11.1,0,Clear,19.4,2022-02-27 15:00:00,15
299,382,681,29,11.5,0,Clear,19.8,2022-02-27 16:00:00,16
226,321,547,28,11.6,0,Clear,19.1,2022-02-27 17:00:00,17
108,239,347,31,10.8,0,Clear,13.8,2022-02-27 18:00:00,18
61,131,192,33,8.7,0,Clear,11.5,2022-02-27 19:00:00,19
48,88,136,35,7.4,0,Clear,11.6,2022-02-27 20:00:00,20
43,70,113,35,6.7,0,Clear,10.9,2022-02-27 21:00:00,21
45,86,131,36,6.0,0,Clear,10.9,2022-02-27 22:00:00,22
22,42,64,39,5.2,0,Clear,11.6,2022-02-27 23:00:00,23
13,23,36,41,4.4,0,Clear,12.2,2022-02-28 00:00:00,0
5,11,16,45,3.4,0,Clear,11.0,2022-02-28 01:00:00,1
0,5,5,51,2.3,0,Clear,9.7,2022-02-28 02:00:00,2
2,5,7,57,1.9,0,Clear,9.1,2022-02-28 03:00:00,3
2,4,6,64,0.8,1,Mostly Clear,8.4,2022-02-28 04:00:00,4
9,37,46,68,0.1,0,Clear,8.7,2022-02-28 05:00:00,5
17,108,125,71,-0.5,1,Mostly Clear,6.8,2022-02-28 06:00:00,6
62,263,325,75,-1.0,1,Mostly Clear,7.2,2022-02-28 07:00:00,7
81,399,480,77,-1.1,0,Clear,9.2,2022-02-28 08:00:00,8
64,210,274,74,1.3,0,Clear,10.7,2022-02-28 09:00:00,9
74,147,221,52,3.7,0,Clear,12.2,2022-02-28 10:00:00,10
79,146,225,46,4.5,0,Clear,12.1,2022-02-28 11:00:00,11
98,209,307,43,5.4,0,Clear,10.9,2022-02-28 12:00:00,12
104,202,306,40,6.1,0,Clear,9.2,2022-02-28 13:00:00,13
99,191,290,39,7.0,0,Clear,7.0,2022-02-28 14:00:00,14
128,275,403,36,8.6,1,Mostly Clear,5.9,2022-02-28 15:00:00,15
151,356,507,37,8.7,0,Clear,4.7,2022-02-28 16:00:00,16
149,534,683,37,8.6,1,Mostly Clear,1.8,2022-02-28 17:00:00,17
112,429,541,38,8.1,0,Clear,5.4,2022-02-28 18:00:00,18
67,269,336,43,6.7,1,Mostly Clear,9.1,2022-02-28 19:00:00,19
51,207,258,50,4.9,0,Clear,12.8,2022-02-28 20:00:00,20
35,147,182,55,3.6,0,Clear,11.9,2022-02-28 21:00:00,21
47,77,124,59,2.8,1,Mostly Clear,10.7,2022-02-28 22:00:00,22
31,46,77,64,2.3,0,Clear,10.7,2022-02-28 23:00:00,23
4,10,14,70,1.9,0,Clear,10.5,2022-03-01 00:00:00,0
6,6,12,77,1.6,0,Clear,10.9,2022-03-01 01:00:00,1
3,7,10,81,1.3,0,Clear,10.8,2022-03-01 02:00:00,2
2,1,3,82,1.1,0,Clear,11.1,2022-03-01 03:00:00,3
3,4,7,85,0.8,0,Clear,11.2,2022-03-01 04:00:00,4
5,41,46,87,0.7,0,Clear,10.9,2022-03-01 05:00:00,5
25,115,140,90,0.4,0,Clear,7.0,2022-03-01 06:00:00,6
65,288,353,92,-0.0,0,Clear,6.5,2022-03-01 07:00:00,7
121,486,607,94,-0.4,1,Mostly Clear,7.0,2022-03-01 08:00:00,8
80,306,386,89,1.9,2,Partly Cloudy,8.8,2022-03-01 09:00:00,9
85,189,274,78,4.2,3,Cloudy,10.8,2022-03-01 10:00:00,10
78,169,247,70,5.8,3,Cloudy,12.8,2022-03-01 11:00:00,11
74,208,282,62,8.0,1,Mostly Clear,13.7,2022-03-01 12:00:00,12
86,219,305,56,10.1,2,Partly Cloudy,13.5,2022-03-01 13:00:00,13
107,213,320,51,11.8,2,Partly Cloudy,13.4,2022-03-01 14:00:00,14
137,318,455,49,12.0,0,Clear,13.4,2022-03-01 15:00:00,15
171,351,522,45,12.8,0,Clear,14.0,2022-03-01 16:00:00,16
215,601,816,44,13.2,1,Mostly Clear,14.7,2022-03-01 17:00:00,17
181,516,697,47,12.4,1,Mostly Clear,8.8,2022-03-01 18:00:00,18
159,368,527,52,10.5,1,Mostly Clear,9.0,2022-03-01 19:00:00,19
90,242,332,54,9.6,0,Clear,10.2,2022-03-01 20:00:00,20
64,194,258,55,9.3,1,Mostly Clear,12.0,2022-03-01 21:00:00,21
79,117,196,56,9.0,2,Partly Cloudy,12.9,2022-03-01 22:00:00,22
42,77,119,58,8.6,2,Partly Cloudy,13.1,2022-03-01 23:00:00,23
22,33,55,61,7.9,0,Clear,11.5,2022-03-02 00:00:00,0
7,16,23,66,6.7,0,Clear,8.8,2022-03-02 01:00:00,1
1,7,8,74,5.4,0,Clear,8.4,2022-03-02 02:00:00,2
2,2,4,76,4.9,0,Clear,9.0,2022-03-02 03:00:00,3
4,3,7,82,3.8,0,Clear,9.4,2022-03-02 04:00:00,4
11,39,50,86,3.2,0,Clear,9.6,2022-03-02 05:00:00,5
21,124,145,88,3.1,0,Clear,7.3,2022-03-02 06:00:00,6
72,302,374,91,2.9,0,Clear,7.0,2022-03-02 07:00:00,7
162,513,675,92,2.7,0,Clear,6.6,2022-03-02 08:00:00,8
101,268,369,88,5.1,0,Clear,6.2,2022-03-02 09:00:00,9
109,188,297,72,8.3,0,Clear,4.3,2022-03-02 10:00:00,10
100,230,330,64,9.8,0,Clear,6.7,2022-03-02 11:00:00,11
128,285,413,58,11.3,0,Clear,8.1,2022-03-02 12:00:00,12
148,259,407,54,12.5,0,Clear,8.2,2022-03-02 13:00:00,13
166,226,392,51,13.7,1,Mostly Clear,9.2,2022-03-02 14:00:00,14
179,339,518,43,16.2,2,Partly Cloudy,16.2,2022-03-02 15:00:00,15
216,389,605,42,16.1,2,Partly Cloudy,12.8,2022-03-02 16:00:00,16
327,658,985,46,15.8,1,Mostly Clear,5.4,2022-03-02 17:00:00,17
263,545,808,48,15.2,2,Partly Cloudy,4.1,2022-03-02 18:00:00,18
138,350,488,56,13.0,1,Mostly Clear,6.9,2022-03-02 19:00:00,19
99,234,333,64,11.1,0,Clear,8.2,2022-03-02 20:00:00,20
84,154,238,72,9.7,1,Mostly Clear,9.2,2022-03-02 21:00:00,21
80,124,204,77,8.6,1,Mostly Clear,10.2,2022-03-02 22:00:00,22
66,94,160,82,7.6,0,Clear,11.5,2022-03-02 23:00:00,23
25,43,68,85,6.9,0,Clear,12.1,2022-03-03 00:00:00,0
16,16,32,86,6.6,0,Clear,12.0,2022-03-03 01:00:00,1
2,7,9,83,6.7,0,Clear,11.6,2022-03-03 02:00:00,2
2,7,9,76,7.1,0,Clear,12.5,2022-03-03 03:00:00,3
7,8,15,68,8.5,0,Clear,13.7,2022-03-03 04:00:00,4
11,39,50,63,9.2,1,Mostly Clear,14.0,2022-03-03 05:00:00,5
34,127,161,64,8.7,3,Cloudy,12.0,2022-03-03 06:00:00,6
77,278,355,67,8.5,3,Cloudy,14.4,2022-03-03 07:00:00,7
128,483,611,73,7.5,2,Partly Cloudy,13.6,2022-03-03 08:00:00,8
74,311,385,71,7.3,1,Mostly Clear,13.0,2022-03-03 09:00:00,9
81,161,242,65,7.3,1,Mostly Clear,15.5,2022-03-03 10:00:00,10
87,206,293,57,8.2,0,Clear,15.0,2022-03-03 11:00:00,11
131,265,396,50,8.9,0,Clear,14.6,2022-03-03 12:00:00,12
124,249,373,44,9.6,0,Clear,15.3,2022-03-03 13:00:00,13
151,225,376,40,10.2,0,Clear,16.3,2022-03-03 14:00:00,14
153,280,433,35,11.9,0,Clear,17.1,2022-03-03 15:00:00,15
182,353,535,33,11.6,0,Clear,18.2,2022-03-03 16:00:00,16
245,583,828,31,10.8,0,Clear,19.1,2022-03-03 17:00:00,17
201,483,684,30,9.6,0,Clear,16.1,2022-03-03 18:00:00,18
110,289,399,29,8.1,2,Partly Cloudy,15.3,2022-03-03 19:00:00,19
61,232,293,29,6.8,1,Mostly Clear,16.5,2022-03-03 20:00:00,20
64,160,224,28,5.6,0,Clear,18.3,2022-03-03 21:00:00,21
65,110,175,29,4.4,0,Clear,18.4,2022-03-03 22:00:00,22
44,65,109,30,3.1,0,Clear,17.1,2022-03-03 23:00:00,23
19,25,44,31,2.1,0,Clear,15.5,2022-03-04 00:00:00,0
11,18,29,32,1.1,0,Clear,14.0,2022-03-04 01:00:00,1
5,4,9,33,0.3,0,Clear,13.4,2022-03-04 02:00:00,2
0,3,3,37,-0.3,0,Clear,12.1,2022-03-04 03:00:00,3
9,3,12,38,-0.9,0,Clear,10.6,2022-03-04 04:00:00,4
7,22,29,40,-1.5,0,Clear,9.0,2022-03-04 05:00:00,5
25,112,137,50,-2.4,0,Clear,7.9,2022-03-04 06:00:00,6
54,222,276,55,-2.8,0,Clear,6.8,2022-03-04 07:00:00,7
95,376,471,46,-1.8,0,Clear,7.4,2022-03-04 08:00:00,8
85,225,310,48,-1.0,0,Clear,5.5,2022-03-04 09:00:00,9
85,166,251,43,0.5,0,Clear,5.0,2022-03-04 10:00:00,10
134,211,345,42,1.7,0,Clear,4.4,2022-03-04 11:00:00,11
130,236,366,41,3.1,0,Clear,5.1,2022-03-04 12:00:00,12
137,227,364,40,4.5,0,Clear,5.6,2022-03-04 13:00:00,13
171,253,424,39,5.8,0,Clear,6.4,2022-03-04 14:00:00,14
178,313,491,39,6.3,0,Clear,6.6,2022-03-04 15:00:00,15
210,376,586,37,7.1,0,Clear,6.9,2022-03-04 16:00:00,16
234,507,741,37,7.4,0,Clear,6.1,2022-03-04 17:00:00,17
193,423,616,36,7.2,0,Clear,2.8,2022-03-04 18:00:00,18
118,296,414,41,6.2,0,Clear,4.3,2022-03-04 19:00:00,19
89,141,230,49,4.4,1,Mostly Clear,5.8,2022-03-04 20:00:00,20
87,146,233,57,3.1,1,Mostly Clear,8.9,2022-03-04 21:00:00,21
61,107,168,63,2.3,1,Mostly Clear,9.2,2022-03-04 22:00:00,22
57,111,168,69,1.6,1,Mostly Clear,7.9,2022-03-04 23:00:00,23
39,78,117,74,1.2,1,Mostly Clear,7.1,2022-03-05 00:00:00,0
54,58,112,79,0.8,1,Mostly Clear,7.4,2022-03-05 01:00:00,1
12,35,47,82,0.8,1,Mostly Clear,7.3,2022-03-05 02:00:00,2
11,19,30,82,0.9,2,Partly Cloudy,7.2,2022-03-05 03:00:00,3
1,4,5,83,0.9,2,Partly Cloudy,7.1,2022-03-05 04:00:00,4
6,10,16,86,0.8,2,Partly Cloudy,6.6,2022-03-05 05:00:00,5
13,37,50,88,0.8,2,Partly Cloudy,6.1,2022-03-05 06:00:00,6
16,64,80,89,1.1,2,Partly Cloudy,6.2,2022-03-05 07:00:00,7
49,154,203,91,1.1,1,Mostly Clear,6.8,2022-03-05 08:00:00,8
110,238,348,85,3.3,1,Mostly Clear,7.7,2022-03-05 09:00:00,9
208,353,561,72,6.0,1,Mostly Clear,9.1,2022-03-05 10:00:00,10
343,334,677,62,8.3,1,Mostly Clear,10.8,2022-03-05 11:00:00,11
412,419,831,57,10.4,0,Clear,12.4,2022-03-05 12:00:00,12
559,442,1001,54,12.4,1,Mostly Clear,14.0,2022-03-05 13:00:00,13
548,479,1027,54,13.8,2,Partly Cloudy,15.3,2022-03-05 14:00:00,14
611,460,1071,50,14.2,1,Mostly Clear,15.5,2022-03-05 15:00:00,15
457,430,887,51,14.7,0,Clear,15.5,2022-03-05 16:00:00,16
408,417,825,54,14.7,0,Clear,15.9,2022-03-05 17:00:00,17
210,298,508,60,13.7,0,Clear,12.7,2022-03-05 18:00:00,18
147,210,357,69,11.6,0,Clear,13.7,2022-03-05 19:00:00,19
113,147,260,79,9.9,0,Clear,13.5,2022-03-05 20:00:00,20
86,158,244,87,9.3,1,Mostly Clear,13.0,2022-03-05 21:00:00,21
103,131,234,93,9.2,1,Mostly Clear,12.3,2022-03-05 22:00:00,22
103,98,201,96,9.8,1,Mostly Clear,11.6,2022-03-05 23:00:00,23
65,100,165,96,10.8,1,Mostly Clear,11.9,2022-03-06 00:00:00,0
55,62,117,96,11.5,2,Partly Cloudy,14.4,2022-03-06 01:00:00,1
52,38,90,95,12.1,2,Partly Cloudy,18.2,2022-03-06 02:00:00,2
32,16,48,93,12.4,2,Partly Cloudy,20.9,2022-03-06 03:00:00,3
12,7,19,91,13.3,1,Mostly Clear,22.2,2022-03-06 04:00:00,4
5,8,13,89,13.8,1,Mostly Clear,22.6,2022-03-06 05:00:00,5
16,24,40,89,14.0,1,Mostly Clear,20.1,2022-03-06 06:00:00,6
23,47,70,89,14.1,1,Mostly Clear,22.2,2022-03-06 07:00:00,7
44,117,161,89,14.4,51,Light Drizzle,22.4,2022-03-06 08:00:00,8
96,180,276,89,14.8,51,Light Drizzle,21.8,2022-03-06 09:00:00,9
184,209,393,89,15.1,51,Light Drizzle,23.5,2022-03-06 10:00:00,10
277,310,587,88,15.6,51,Light Drizzle,22.0,2022-03-06 11:00:00,11
433,383,816,87,16.3,51,Light Drizzle,20.1,2022-03-06 12:00:00,12
537,461,998,86,17.3,55,Heavy Drizzle,19.4,2022-03-06 13:00:00,13
588,460,1048,88,17.4,55,Heavy Drizzle,20.1,2022-03-06 14:00:00,14
577,540,1117,67,21.9,2,Partly Cloudy,18.3,2022-03-06 15:00:00,15
451,473,924,61,23.0,2,Partly Cloudy,17.6,2022-03-06 16:00:00,16
395,385,780,62,22.3,1,Mostly Clear,18.6,2022-03-06 17:00:00,17
260,295,555,62,21.8,2,Partly Cloudy,12.9,2022-03-06 18:00:00,18
140,205,345,70,20.2,53,Heavy Drizzle,11.6,2022-03-06 19:00:00,19
143,145,288,72,19.4,2,Partly Cloudy,12.2,2022-03-06 20:00:00,20
114,140,254,77,18.6,2,Partly Cloudy,11.1,2022-03-06 21:00:00,21
65,79,144,78,18.2,3,Cloudy,14.5,2022-03-06 22:00:00,22
42,50,92,78,18.0,51,Light Drizzle,18.4,2022-03-06 23:00:00,23
22,27,49,80,17.6,2,Partly Cloudy,18.6,2022-03-07 00:00:00,0
14,15,29,82,16.9,1,Mostly Clear,15.4,2022-03-07 01:00:00,1
8,10,18,83,16.4,1,Mostly Clear,13.3,2022-03-07 02:00:00,2
6,4,10,88,15.9,1,Mostly Clear,12.8,2022-03-07 03:00:00,3
6,8,14,87,15.6,0,Clear,14.0,2022-03-07 04:00:00,4
11,40,51,86,15.3,0,Clear,15.3,2022-03-07 05:00:00,5
33,135,168,85,15.4,0,Clear,15.8,2022-03-07 06:00:00,6
70,308,378,83,15.6,0,Clear,18.0,2022-03-07 07:00:00,7
138,502,640,81,16.0,0,Clear,19.7,2022-03-07 08:00:00,8
122,293,415,77,17.2,1,Mostly Clear,22.1,2022-03-07 09:00:00,9
138,180,318,72,18.7,2,Partly Cloudy,20.3,2022-03-07 10:00:00,10
148,217,365,70,19.9,1,Mostly Clear,26.4,2022-03-07 11:00:00,11
207,246,453,66,21.2,1,Mostly Clear,28.9,2022-03-07 12:00:00,12
196,268,464,55,23.4,1,Mostly Clear,30.0,2022-03-07 13:00:00,13
205,219,424,52,24.1,1,Mostly Clear,26.0,2022-03-07 14:00:00,14
229,311,540,55,24.2,1,Mostly Clear,22.7,2022-03-07 15:00:00,15
111,219,330,53,24.3,2,Partly Cloudy,24.2,2022-03-07 16:00:00,16
153,403,556,54,23.7,51,Light Drizzle,24.2,2022-03-07 17:00:00,17
160,384,544,56,23.1,51,Light Drizzle,21.0,2022-03-07 18:00:00,18
50,169,219,62,21.8,51,Light Drizzle,23.0,2022-03-07 19:00:00,19
59,130,189,65,21.2,51,Light Drizzle,26.0,2022-03-07 20:00:00,20
65,145,210,76,19.6,53,Heavy Drizzle,23.3,2022-03-07 21:00:00,21
62,115,177,89,16.5,55,Heavy Drizzle,23.5,2022-03-07 22:00:00,22
38,51,89,76,13.2,51,Light Drizzle,26.0,2022-03-07 23:00:00,23
18,12,30,60,12.5,1,Mostly Clear,26.2,2022-03-08 00:00:00,0
4,11,15,54,11.0,2,Partly Cloudy,26.4,2022-03-08 01:00:00,1
3,2,5,53,9.5,3,Cloudy,24.8,2022-03-08 02:00:00,2
1,3,4,51,9.2,3,Cloudy,22.5,2022-03-08 03:00:00,3
5,4,9,50,8.3,3,Cloudy,21.5,2022-03-08 04:00:00,4
7,45,52,50,7.5,1,Mostly Clear,20.6,2022-03-08 05:00:00,5
28,145,173,50,6.8,1,Mostly Clear,16.9,2022-03-08 06:00:00,6
76,297,373,50,6.0,1,Mostly Clear,18.4,2022-03-08 07:00:00,7
135,474,609,52,5.5,0,Clear,16.8,2022-03-08 08:00:00,8
99,278,377,51,5.7,0,Clear,19.2,2022-03-08 09:00:00,9
78,176,254,46,6.7,0,Clear,19.6,2022-03-08 10:00:00,10
138,199,337,46,7.5,1,Mostly Clear,18.2,2022-03-08 11:00:00,11
145,232,377,44,8.5,1,Mostly Clear,16.1,2022-03-08 12:00:00,12
154,241,395,42,9.5,1,Mostly Clear,13.9,2022-03-08 13:00:00,13
210,217,427,40,10.4,0,Clear,12.5,2022-03-08 14:00:00,14
202,289,491,40,10.9,1,Mostly Clear,10.5,2022-03-08 15:00:00,15
232,382,614,39,11.1,1,Mostly Clear,8.0,2022-03-08 16:00:00,16
287,628,915,39,11.0,1,Mostly Clear,6.0,2022-03-08 17:00:00,17
216,567,783,38,10.7,1,Mostly Clear,3.2,2022-03-08 18:00:00,18
114,366,480,43,9.8,1,Mostly Clear,3.8,2022-03-08 19:00:00,19
98,225,323,49,8.4,1,Mostly Clear,6.9,2022-03-08 20:00:00,20
81,203,284,53,7.4,1,Mostly Clear,8.6,2022-03-08 21:00:00,21
64,115,179,57,6.9,1,Mostly Clear,8.7,2022-03-08 22:00:00,22
39,53,92,58,6.6,1,Mostly Clear,8.5,2022-03-08 23:00:00,23
13,18,31,59,6.5,1,Mostly Clear,10.9,2022-03-09 00:00:00,0
4,6,10,59,6.5,3,Cloudy,9.4,2022-03-09 01:00:00,1
0,4,4,62,6.7,3,Cloudy,8.0,2022-03-09 02:00:00,2
0,4,4,67,6.7,3,Cloudy,11.2,2022-03-09 03:00:00,3
3,3,6,76,6.4,53,Heavy Drizzle,6.9,2022-03-09 04:00:00,4
1,11,12,88,5.8,55,Heavy Drizzle,6.6,2022-03-09 05:00:00,5
10,58,68,92,5.4,61,Light Rain,2.6,2022-03-09 06:00:00,6
15,71,86,93,5.0,61,Light Rain,9.7,2022-03-09 07:00:00,7
44,152,196,97,4.1,73,Snow,9.2,2022-03-09 08:00:00,8
29,140,169,96,4.0,61,Light Rain,8.5,2022-03-09 09:00:00,9
31,87,118,96,4.1,61,Light Rain,12.6,2022-03-09 10:00:00,10
21,75,96,96,4.3,61,Light Rain,13.3,2022-03-09 11:00:00,11
24,66,90,96,4.4,55,Heavy Drizzle,10.3,2022-03-09 12:00:00,12
24,79,103,95,4.7,53,Heavy Drizzle,6.5,2022-03-09 13:00:00,13
54,82,136,95,4.9,53,Heavy Drizzle,7.2,2022-03-09 14:00:00,14
63,148,211,95,5.6,53,Heavy Drizzle,8.3,2022-03-09 15:00:00,15
88,229,317,96,5.6,51,Light Drizzle,11.3,2022-03-09 16:00:00,16
134,439,573,94,5.5,3,Cloudy,10.2,2022-03-09 17:00:00,17
121,439,560,92,5.4,3,Cloudy,8.7,2022-03-09 18:00:00,18
107,281,388,92,5.3,3,Cloudy,7.3,2022-03-09 19:00:00,19
73,183,256,92,5.2,3,Cloudy,10.7,2022-03-09 20:00:00,20
46,159,205,91,5.1,2,Partly Cloudy,12.0,2022-03-09 21:00:00,21
44,115,159,91,5.0,3,Cloudy,13.2,2022-03-09 22:00:00,22
44,49,93,89,4.8,3,Cloudy,11.6,2022-03-09 23:00:00,23
15,20,35,88,4.7,2,Partly Cloudy,10.0,2022-03-10 00:00:00,0
8,14,22,87,4.6,1,Mostly Clear,10.4,2022-03-10 01:00:00,1
2,4,6,88,4.1,1,Mostly Clear,8.6,2022-03-10 02:00:00,2
0,4,4,90,3.3,1,Mostly Clear,7.4,2022-03-10 03:00:00,3
7,9,16,90,3.0,1,Mostly Clear,5.6,2022-03-10 04:00:00,4
14,25,39,89,3.2,1,Mostly Clear,5.3,2022-03-10 05:00:00,5
25,106,131,94,1.6,1,Mostly Clear,4.4,2022-03-10 06:00:00,6
55,253,308,95,0.9,1,Mostly Clear,4.7,2022-03-10 07:00:00,7
128,465,593,94,1.0,1,Mostly Clear,6.0,2022-03-10 08:00:00,8
111,304,415,86,3.5,0,Clear,6.0,2022-03-10 09:00:00,9
119,193,312,74,5.8,0,Clear,8.3,2022-03-10 10:00:00,10
119,218,337,60,7.7,2,Partly Cloudy,9.3,2022-03-10 11:00:00,11
126,304,430,52,8.9,3,Cloudy,6.9,2022-03-10 12:00:00,12
144,235,379,47,10.1,3,Cloudy,6.5,2022-03-10 13:00:00,13
187,250,437,44,10.9,2,Partly Cloudy,7.2,2022-03-10 14:00:00,14
195,329,524,44,10.5,3,Cloudy,7.3,2022-03-10 15:00:00,15
240,335,575,44,10.3,3,Cloudy,7.3,2022-03-10 16:00:00,16
255,574,829,44,10.1,3,Cloudy,6.9,2022-03-10 17:00:00,17
208,517,725,48,9.5,2,Partly Cloudy,7.5,2022-03-10 18:00:00,18
127,394,521,54,8.6,0,Clear,4.7,2022-03-10 19:00:00,19
106,244,350,64,7.7,1,Mostly Clear,5.6,2022-03-10 20:00:00,20
79,186,265,73,6.6,0,Clear,5.3,2022-03-10 21:00:00,21
69,124,193,77,6.1,1,Mostly Clear,4.6,2022-03-10 22:00:00,22
43,88,131,80,5.9,0,Clear,5.8,2022-03-10 23:00:00,23
27,39,66,84,5.1,0,Clear,6.8,2022-03-11 00:00:00,0
8,22,30,89,4.4,0,Clear,7.4,2022-03-11 01:00:00,1
15,8,23,93,3.7,0,Clear,7.2,2022-03-11 02:00:00,2
1,7,8,90,3.1,0,Clear,8.4,2022-03-11 03:00:00,3
5,6,11,91,2.7,0,Clear,8.6,2022-03-11 04:00:00,4
3,18,21,95,1.9,0,Clear,7.3,2022-03-11 05:00:00,5
29,114,143,96,1.7,0,Clear,6.2,2022-03-11 06:00:00,6
63,205,268,98,1.4,0,Clear,6.8,2022-03-11 07:00:00,7
118,370,488,98,1.7,0,Clear,6.7,2022-03-11 08:00:00,8
124,254,378,93,5.4,0,Clear,7.6,2022-03-11 09:00:00,9
187,213,400,77,8.6,0,Clear,8.3,2022-03-11 10:00:00,10
202,253,455,66,10.5,0,Clear,9.0,2022-03-11 11:00:00,11
299,319,618,60,12.1,0,Clear,9.7,2022-03-11 12:00:00,12
315,321,636,57,13.5,0,Clear,11.3,2022-03-11 13:00:00,13
297,320,617,54,14.7,0,Clear,13.6,2022-03-11 14:00:00,14
381,424,805,53,15.2,0,Clear,14.6,2022-03-11 15:00:00,15
365,503,868,53,15.4,0,Clear,14.6,2022-03-11 16:00:00,16
473,622,1095,53,15.3,0,Clear,13.8,2022-03-11 17:00:00,17
312,505,817,57,14.4,0,Clear,12.1,2022-03-11 18:00:00,18
153,350,503,65,12.3,0,Clear,14.0,2022-03-11 19:00:00,19
119,201,320,73,10.3,0,Clear,16.8,2022-03-11 20:00:00,20
87,147,234,79,9.2,0,Clear,15.6,2022-03-11 21:00:00,21
81,133,214,85,8.5,0,Clear,13.2,2022-03-11 22:00:00,22
93,126,219,90,8.0,1,Mostly Clear,13.9,2022-03-11 23:00:00,23
65,112,177,92,7.8,1,Mostly Clear,12.6,2022-03-12 00:00:00,0
58,50,108,93,7.8,1,Mostly Clear,11.6,2022-03-12 01:00:00,1
45,46,91,93,8.0,2,Partly Cloudy,12.7,2022-03-12 02:00:00,2
21,21,42,95,8.4,2,Partly Cloudy,11.2,2022-03-12 03:00:00,3
12,8,20,96,8.4,3,Cloudy,8.6,2022-03-12 04:00:00,4
1,5,6,98,8.4,51,Light Drizzle,6.0,2022-03-12 05:00:00,5
4,6,10,98,8.6,51,Light Drizzle,5.9,2022-03-12 06:00:00,6
5,15,20,93,6.2,53,Heavy Drizzle,26.7,2022-03-12 07:00:00,7
8,26,34,91,3.0,71,Light Snow,27.7,2022-03-12 08:00:00,8
12,35,47,96,1.6,75,Heavy Snow,26.5,2022-03-12 09:00:00,9
22,40,62,96,1.1,75,Heavy Snow,28.2,2022-03-12 10:00:00,10
25,68,93,88,0.7,75,Heavy Snow,21.5,2022-03-12 11:00:00,11
29,89,118,77,0.7,75,Heavy Snow,24.6,2022-03-12 12:00:00,12
18,89,107,77,0.2,73,Snow,26.2,2022-03-12 13:00:00,13
29,72,101,72,-0.3,73,Snow,29.6,2022-03-12 14:00:00,14
38,91,129,67,-1.1,73,Snow,27.3,2022-03-12 15:00:00,15
39,130,169,60,-1.8,73,Snow,28.3,2022-03-12 16:00:00,16
45,147,192,51,-1.8,71,Light Snow,28.5,2022-03-12 17:00:00,17
32,130,162,44,-1.6,1,Mostly Clear,27.6,2022-03-12 18:00:00,18
28,102,130,45,-2.0,0,Clear,25.8,2022-03-12 19:00:00,19
21,54,75,45,-3.1,0,Clear,24.8,2022-03-12 20:00:00,20
30,55,85,47,-3.6,0,Clear,23.6,2022-03-12 21:00:00,21
12,61,73,48,-4.2,0,Clear,22.6,2022-03-12 22:00:00,22
27,41,68,47,-4.5,0,Clear,22.3,2022-03-12 23:00:00,23
24,52,76,48,-4.7,0,Clear,21.4,2022-03-13 00:00:00,0
17,31,48,49,-4.9,0,Clear,21.2,2022-03-13 01:00:00,1
18,17,35,53,-5.4,0,Clear,20.5,2022-03-13 03:00:00,3
4,10,14,55,-5.7,0,Clear,19.8,2022-03-13 04:00:00,4
5,7,12,55,-5.9,0,Clear,17.6,2022-03-13 05:00:00,5
8,11,19,56,-6.2,0,Clear,13.2,2022-03-13 06:00:00,6
10,36,46,56,-6.5,0,Clear,14.7,2022-03-13 07:00:00,7
19,47,66,55,-6.6,0,Clear,14.5,2022-03-13 08:00:00,8
29,93,122,53,-5.9,0,Clear,15.5,2022-03-13 09:00:00,9
71,156,227,50,-4.6,0,Clear,14.3,2022-03-13 10:00:00,10
113,172,285,47,-2.9,0,Clear,13.9,2022-03-13 11:00:00,11
143,211,354,44,-1.1,0,Clear,14.1,2022-03-13 12:00:00,12
126,248,374,42,0.6,0,Clear,13.8,2022-03-13 13:00:00,13
175,226,401,41,2.1,0,Clear,14.8,2022-03-13 14:00:00,14
143,248,391,39,3.3,0,Clear,17.0,2022-03-13 15:00:00,15
170,265,435,39,4.1,0,Clear,17.7,2022-03-13 16:00:00,16
175,243,418,40,4.6,0,Clear,18.2,2022-03-13 17:00:00,17
128,186,314,47,4.1,1,Mostly Clear,10.3,2022-03-13 18:00:00,18
81,162,243,53,3.3,0,Clear,6.9,2022-03-13 19:00:00,19
54,118,172,58,1.6,0,Clear,9.9,2022-03-13 20:00:00,20
31,67,98,61,1.1,0,Clear,8.9,2022-03-13 21:00:00,21
44,63,107,65,0.4,0,Clear,9.8,2022-03-13 22:00:00,22
22,32,54,69,-0.5,0,Clear,10.7,2022-03-13 23:00:00,23
13,20,33,72,-1.6,0,Clear,9.8,2022-03-14 00:00:00,0
4,11,15,74,-2.6,0,Clear,10.0,2022-03-14 01:00:00,1
4,8,12,76,-3.4,0,Clear,10.2,2022-03-14 02:00:00,2
0,5,5,70,-2.1,0,Clear,10.3,2022-03-14 03:00:00,3
5,4,9,69,-1.6,0,Clear,10.0,2022-03-14 04:00:00,4
12,22,34,70,-1.3,0,Clear,10.4,2022-03-14 05:00:00,5
24,95,119,72,-1.6,0,Clear,8.4,2022-03-14 06:00:00,6
58,217,275,75,-1.9,0,Clear,7.9,2022-03-14 07:00:00,7
103,368,471,73,-0.9,0,Clear,6.7,2022-03-14 08:00:00,8
89,243,332,64,2.9,0,Clear,7.5,2022-03-14 09:00:00,9
117,142,259,55,6.0,0,Clear,6.4,2022-03-14 10:00:00,10
129,186,315,66,6.4,0,Clear,6.9,2022-03-14 11:00:00,11
177,220,397,64,6.9,0,Clear,9.4,2022-03-14 12:00:00,12
231,239,470,59,8.1,0,Clear,10.3,2022-03-14 13:00:00,13
217,230,447,49,11.3,1,Mostly Clear,10.8,2022-03-14 14:00:00,14
303,325,628,39,14.8,1,Mostly Clear,11.7,2022-03-14 15:00:00,15
341,410,751,37,15.7,1,Mostly Clear,11.8,2022-03-14 16:00:00,16
416,630,1046,37,15.5,1,Mostly Clear,11.9,2022-03-14 17:00:00,17
329,566,895,42,14.4,1,Mostly Clear,8.1,2022-03-14 18:00:00,18
197,392,589,49,11.8,1,Mostly Clear,10.2,2022-03-14 19:00:00,19
130,263,393,57,9.6,1,Mostly Clear,12.2,2022-03-14 20:00:00,20
80,166,246,62,8.2,1,Mostly Clear,12.1,2022-03-14 21:00:00,21
81,97,178,65,7.3,0,Clear,12.0,2022-03-14 22:00:00,22
35,53,88,68,6.8,0,Clear,11.9,2022-03-14 23:00:00,23
17,19,36,70,6.4,0,Clear,12.1,2022-03-15 00:00:00,0
4,7,11,72,6.1,0,Clear,12.1,2022-03-15 01:00:00,1
2,10,12,74,5.8,0,Clear,12.1,2022-03-15 02:00:00,2
3,8,11,73,5.5,0,Clear,11.6,2022-03-15 03:00:00,3
1,6,7,75,5.0,0,Clear,11.4,2022-03-15 04:00:00,4
11,39,50,78,4.5,0,Clear,10.5,2022-03-15 05:00:00,5
31,143,174,80,4.0,0,Clear,8.9,2022-03-15 06:00:00,6
56,313,369,83,3.3,0,Clear,7.9,2022-03-15 07:00:00,7
184,521,705,86,3.0,0,Clear,7.7,2022-03-15 08:00:00,8
104,311,415,75,6.9,1,Mostly Clear,7.0,2022-03-15 09:00:00,9
186,194,380,61,10.4,1,Mostly Clear,6.6,2022-03-15 10:00:00,10
232,213,445,55,13.1,0,Clear,5.4,2022-03-15 11:00:00,11
290,277,567,49,15.7,0,Clear,5.6,2022-03-15 12:00:00,12
268,288,556,45,17.7,0,Clear,6.9,2022-03-15 13:00:00,13
317,272,589,41,19.2,0,Clear,6.1,2022-03-15 14:00:00,14
335,354,689,34,20.4,0,Clear,6.2,2022-03-15 15:00:00,15
414,466,880,32,20.6,0,Clear,8.0,2022-03-15 16:00:00,16
538,733,1271,34,20.2,1,Mostly Clear,9.1,2022-03-15 17:00:00,17
485,707,1192,39,18.8,2,Partly Cloudy,6.8,2022-03-15 18:00:00,18
331,446,777,44,16.3,2,Partly Cloudy,8.2,2022-03-15 19:00:00,19
179,310,489,47,14.7,1,Mostly Clear,8.6,2022-03-15 20:00:00,20
141,202,343,50,13.6,0,Clear,8.1,2022-03-15 21:00:00,21
150,163,313,57,12.0,0,Clear,8.0,2022-03-15 22:00:00,22
60,79,139,66,10.4,0,Clear,8.6,2022-03-15 23:00:00,23
36,28,64,74,8.9,0,Clear,7.2,2022-03-16 00:00:00,0
8,12,20,80,7.6,0,Clear,7.6,2022-03-16 01:00:00,1
10,5,15,84,6.6,0,Clear,8.2,2022-03-16 02:00:00,2
4,3,7,81,6.1,0,Clear,8.4,2022-03-16 03:00:00,3
8,7,15,83,5.5,0,Clear,7.7,2022-03-16 04:00:00,4
12,35,47,85,5.1,0,Clear,7.4,2022-03-16 05:00:00,5
31,142,173,88,4.5,1,Mostly Clear,4.9,2022-03-16 06:00:00,6
87,318,405,89,4.2,1,Mostly Clear,4.4,2022-03-16 07:00:00,7
180,604,784,87,4.8,1,Mostly Clear,3.0,2022-03-16 08:00:00,8
193,322,515,83,8.7,1,Mostly Clear,2.7,2022-03-16 09:00:00,9
178,217,395,59,14.1,0,Clear,1.3,2022-03-16 10:00:00,10
251,231,482,50,17.0,0,Clear,3.3,2022-03-16 11:00:00,11
240,263,503,46,18.6,0,Clear,8.1,2022-03-16 12:00:00,12
348,290,638,43,19.5,0,Clear,10.2,2022-03-16 13:00:00,13
344,269,613,42,20.0,0,Clear,12.3,2022-03-16 14:00:00,14
429,371,800,38,20.6,0,Clear,14.0,2022-03-16 15:00:00,15
428,483,911,39,20.3,1,Mostly Clear,15.3,2022-03-16 16:00:00,16
516,807,1323,42,19.4,1,Mostly Clear,14.1,2022-03-16 17:00:00,17
494,726,1220,47,18.1,1,Mostly Clear,11.0,2022-03-16 18:00:00,18
322,479,801,55,15.9,1,Mostly Clear,11.6,2022-03-16 19:00:00,19
171,293,464,61,14.1,1,Mostly Clear,12.5,2022-03-16 20:00:00,20
169,259,428,64,12.9,1,Mostly Clear,11.5,2022-03-16 21:00:00,21
115,160,275,68,11.9,1,Mostly Clear,10.2,2022-03-16 22:00:00,22
67,90,157,73,11.0,1,Mostly Clear,9.4,2022-03-16 23:00:00,23
40,31,71,77,10.4,51,Light Drizzle,9.4,2022-03-17 00:00:00,0
10,12,22,80,9.7,51,Light Drizzle,8.4,2022-03-17 01:00:00,1
6,12,18,83,9.0,51,Light Drizzle,7.9,2022-03-17 02:00:00,2
4,1,5,84,9.2,51,Light Drizzle,7.0,2022-03-17 03:00:00,3
2,8,10,91,9.2,55,Heavy Drizzle,5.4,2022-03-17 04:00:00,4
15,26,41,93,9.3,61,Light Rain,6.4,2022-03-17 05:00:00,5
22,96,118,93,9.3,61,Light Rain,7.3,2022-03-17 06:00:00,6
61,227,288,95,9.1,53,Heavy Drizzle,9.7,2022-03-17 07:00:00,7
108,452,560,95,9.2,53,Heavy Drizzle,11.2,2022-03-17 08:00:00,8
104,282,386,95,9.6,51,Light Drizzle,10.5,2022-03-17 09:00:00,9
87,161,248,95,10.4,51,Light Drizzle,11.2,2022-03-17 10:00:00,10
92,135,227,95,11.1,53,Heavy Drizzle,11.3,2022-03-17 11:00:00,11
29,92,121,95,11.6,55,Heavy Drizzle,11.3,2022-03-17 12:00:00,12
23,62,85,96,11.9,61,Light Rain,11.7,2022-03-17 13:00:00,13
32,53,85,94,13.4,55,Heavy Drizzle,10.7,2022-03-17 14:00:00,14
70,156,226,94,14.7,53,Heavy Drizzle,11.4,2022-03-17 15:00:00,15
112,247,359,97,14.3,53,Heavy Drizzle,10.8,2022-03-17 16:00:00,16
186,410,596,97,14.6,53,Heavy Drizzle,10.6,2022-03-17 17:00:00,17
188,445,633,97,14.1,51,Light Drizzle,9.7,2022-03-17 18:00:00,18
141,295,436,95,13.3,3,Cloudy,5.5,2022-03-17 19:00:00,19
123,244,367,94,12.8,3,Cloudy,5.1,2022-03-17 20:00:00,20
127,165,292,95,12.3,1,Mostly Clear,5.2,2022-03-17 21:00:00,21
88,121,209,95,11.7,1,Mostly Clear,5.7,2022-03-17 22:00:00,22
85,115,200,96,10.9,0,Clear,4.7,2022-03-17 23:00:00,23
40,40,80,97,10.1,0,Clear,5.1,2022-03-18 00:00:00,0
21,32,53,98,9.3,0,Clear,5.6,2022-03-18 01:00:00,1
9,7,16,99,8.4,0,Clear,7.4,2022-03-18 02:00:00,2
5,9,14,97,9.0,0,Clear,8.3,2022-03-18 03:00:00,3
2,7,9,97,8.6,0,Clear,8.2,2022-03-18 04:00:00,4
13,36,49,96,8.1,0,Clear,7.8,2022-03-18 05:00:00,5
31,116,147,97,7.5,0,Clear,7.4,2022-03-18 06:00:00,6
67,266,333,97,6.9,0,Clear,7.3,2022-03-18 07:00:00,7
122,410,532,98,7.0,0,Clear,7.5,2022-03-18 08:00:00,8
159,293,452,94,11.0,0,Clear,6.0,2022-03-18 09:00:00,9
178,211,389,86,14.5,0,Clear,3.3,2022-03-18 10:00:00,10
301,258,559,77,17.6,0,Clear,4.8,2022-03-18 11:00:00,11
383,315,698,65,20.4,0,Clear,6.6,2022-03-18 12:00:00,12
396,293,689,56,21.9,0,Clear,8.7,2022-03-18 13:00:00,13
462,359,821,50,22.7,3,Cloudy,12.5,2022-03-18 14:00:00,14
519,411,930,47,23.1,3,Cloudy,12.9,2022-03-18 15:00:00,15
581,531,1112,47,22.9,3,Cloudy,12.6,2022-03-18 16:00:00,16
636,657,1293,52,21.9,3,Cloudy,12.0,2022-03-18 17:00:00,17
475,574,1049,59,20.4,3,Cloudy,10.5,2022-03-18 18:00:00,18
340,415,755,68,18.5,1,Mostly Clear,14.3,2022-03-18 19:00:00,19
214,294,508,75,16.9,2,Partly Cloudy,18.6,2022-03-18 20:00:00,20
182,178,360,79,15.7,3,Cloudy,18.8,2022-03-18 21:00:00,21
158,188,346,82,14.9,2,Partly Cloudy,15.5,2022-03-18 22:00:00,22
123,128,251,85,14.5,2,Partly Cloudy,14.2,2022-03-18 23:00:00,23
101,106,207,87,14.1,1,Mostly Clear,15.3,2022-03-19 00:00:00,0
56,77,133,87,14.0,1,Mostly Clear,14.7,2022-03-19 01:00:00,1
54,60,114,85,14.1,0,Clear,14.9,2022-03-19 02:00:00,2
24,20,44,82,14.5,0,Clear,16.2,2022-03-19 03:00:00,3
9,18,27,82,14.3,0,Clear,14.8,2022-03-19 04:00:00,4
10,8,18,85,13.9,0,Clear,14.1,2022-03-19 05:00:00,5
24,36,60,87,13.6,0,Clear,13.7,2022-03-19 06:00:00,6
59,92,151,89,13.6,0,Clear,13.1,2022-03-19 07:00:00,7
119,156,275,88,14.1,0,Clear,13.8,2022-03-19 08:00:00,8
248,298,546,85,15.6,0,Clear,12.4,2022-03-19 09:00:00,9
458,351,809,78,17.2,1,Mostly Clear,14.8,2022-03-19 10:00:00,10
568,467,1035,70,19.0,1,Mostly Clear,15.1,2022-03-19 11:00:00,11
613,468,1081,64,20.2,1,Mostly Clear,16.6,2022-03-19 12:00:00,12
722,476,1198,66,20.9,1,Mostly Clear,17.3,2022-03-19 13:00:00,13
763,470,1233,71,20.8,51,Light Drizzle,24.5,2022-03-19 14:00:00,14
758,490,1248,63,21.9,51,Light Drizzle,25.0,2022-03-19 15:00:00,15
780,471,1251,60,22.1,1,Mostly Clear,25.3,2022-03-19 16:00:00,16
732,439,1171,55,22.4,0,Clear,23.0,2022-03-19 17:00:00,17
608,429,1037,54,22.1,0,Clear,18.9,2022-03-19 18:00:00,18
469,362,831,53,21.0,0,Clear,16.0,2022-03-19 19:00:00,19
320,217,537,58,19.1,1,Mostly Clear,11.6,2022-03-19 20:00:00,20
233,186,419,66,17.3,1,Mostly Clear,9.4,2022-03-19 21:00:00,21
194,140,334,63,16.5,0,Clear,12.8,2022-03-19 22:00:00,22
150,119,269,55,15.6,0,Clear,15.1,2022-03-19 23:00:00,23
109,105,214,54,14.8,1,Mostly Clear,13.5,2022-03-20 00:00:00,0
84,82,166,55,14.1,1,Mostly Clear,14.0,2022-03-20 01:00:00,1
58,60,118,56,13.0,1,Mostly Clear,14.5,2022-03-20 02:00:00,2
30,20,50,62,13.5,0,Clear,13.5,2022-03-20 03:00:00,3
4,6,10,62,12.6,0,Clear,12.6,2022-03-20 04:00:00,4
10,7,17,63,11.8,0,Clear,13.2,2022-03-20 05:00:00,5
15,26,41,62,11.0,0,Clear,13.7,2022-03-20 06:00:00,6
31,46,77,62,10.1,0,Clear,12.9,2022-03-20 07:00:00,7
114,131,245,63,9.7,0,Clear,11.1,2022-03-20 08:00:00,8
242,219,461,59,10.2,0,Clear,12.0,2022-03-20 09:00:00,9
337,305,642,53,11.4,2,Partly Cloudy,22.3,2022-03-20 10:00:00,10
449,304,753,50,12.1,3,Cloudy,22.8,2022-03-20 11:00:00,11
483,389,872,50,12.4,3,Cloudy,23.7,2022-03-20 12:00:00,12
519,389,908,50,12.5,3,Cloudy,21.8,2022-03-20 13:00:00,13
478,426,904,48,13.1,3,Cloudy,22.7,2022-03-20 14:00:00,14
391,386,777,53,13.2,3,Cloudy,23.9,2022-03-20 15:00:00,15
400,351,751,52,13.0,3,Cloudy,25.1,2022-03-20 16:00:00,16
282,318,600,50,12.8,3,Cloudy,26.7,2022-03-20 17:00:00,17
204,258,462,49,12.4,3,Cloudy,25.5,2022-03-20 18:00:00,18
148,194,342,50,11.5,3,Cloudy,23.0,2022-03-20 19:00:00,19
108,141,249,50,10.8,1,Mostly Clear,21.7,2022-03-20 20:00:00,20
47,89,136,47,10.3,1,Mostly Clear,20.9,2022-03-20 21:00:00,21
49,80,129,43,10.0,0,Clear,20.1,2022-03-20 22:00:00,22
38,39,77,40,9.6,1,Mostly Clear,18.9,2022-03-20 23:00:00,23
17,14,31,39,9.2,0,Clear,19.4,2022-03-21 00:00:00,0
12,17,29,40,8.8,0,Clear,19.1,2022-03-21 01:00:00,1
1,11,12,42,8.2,0,Clear,18.3,2022-03-21 02:00:00,2
3,7,10,45,8.4,0,Clear,17.3,2022-03-21 03:00:00,3
3,10,13,47,8.0,0,Clear,15.8,2022-03-21 04:00:00,4
14,36,50,49,7.5,0,Clear,12.5,2022-03-21 05:00:00,5
42,127,169,56,6.5,0,Clear,8.4,2022-03-21 06:00:00,6
92,263,355,65,5.2,0,Clear,9.5,2022-03-21 07:00:00,7
132,502,634,70,5.2,0,Clear,10.4,2022-03-21 08:00:00,8
142,308,450,57,8.8,0,Clear,10.3,2022-03-21 09:00:00,9
189,194,383,49,11.7,0,Clear,11.7,2022-03-21 10:00:00,10
237,213,450,43,14.0,0,Clear,13.3,2022-03-21 11:00:00,11
280,279,559,39,15.7,0,Clear,13.1,2022-03-21 12:00:00,12
365,311,676,38,17.1,0,Clear,13.7,2022-03-21 13:00:00,13
332,268,600,36,18.3,2,Partly Cloudy,20.7,2022-03-21 14:00:00,14
358,405,763,35,18.7,2,Partly Cloudy,19.3,2022-03-21 15:00:00,15
417,532,949,34,19.2,1,Mostly Clear,15.8,2022-03-21 16:00:00,16
639,813,1452,32,19.9,1,Mostly Clear,16.8,2022-03-21 17:00:00,17
653,704,1357,37,19.2,0,Clear,8.5,2022-03-21 18:00:00,18
394,537,931,43,17.4,0,Clear,7.1,2022-03-21 19:00:00,19
182,305,487,50,15.2,0,Clear,9.4,2022-03-21 20:00:00,20
159,200,359,56,13.2,0,Clear,8.9,2022-03-21 21:00:00,21
90,100,190,62,11.7,0,Clear,9.2,2022-03-21 22:00:00,22
60,60,120,69,10.3,0,Clear,9.5,2022-03-21 23:00:00,23
13,23,36,72,9.6,0,Clear,7.9,2022-03-22 00:00:00,0
10,11,21,75,8.8,0,Clear,6.5,2022-03-22 01:00:00,1
6,3,9,81,7.7,0,Clear,6.5,2022-03-22 02:00:00,2
3,6,9,86,6.9,0,Clear,5.9,2022-03-22 03:00:00,3
5,10,15,84,7.1,1,Mostly Clear,7.7,2022-03-22 04:00:00,4
13,58,71,86,6.5,1,Mostly Clear,7.3,2022-03-22 05:00:00,5
103,174,277,86,6.2,1,Mostly Clear,9.2,2022-03-22 06:00:00,6
133,423,556,78,6.5,1,Mostly Clear,10.4,2022-03-22 07:00:00,7
217,662,879,72,7.3,0,Clear,11.2,2022-03-22 08:00:00,8
164,418,582,66,9.2,1,Mostly Clear,7.9,2022-03-22 09:00:00,9
188,241,429,59,11.1,1,Mostly Clear,8.4,2022-03-22 10:00:00,10
232,253,485,57,12.6,3,Cloudy,8.9,2022-03-22 11:00:00,11
275,338,613,55,13.7,3,Cloudy,8.5,2022-03-22 12:00:00,12
287,295,582,53,14.4,2,Partly Cloudy,7.0,2022-03-22 13:00:00,13
343,280,623,52,15.2,3,Cloudy,7.5,2022-03-22 14:00:00,14
451,407,858,45,17.7,1,Mostly Clear,7.7,2022-03-22 15:00:00,15
472,502,974,45,18.0,2,Partly Cloudy,6.6,2022-03-22 16:00:00,16
807,988,1795,47,17.4,2,Partly Cloudy,7.6,2022-03-22 17:00:00,17
732,847,1579,51,16.5,0,Clear,7.9,2022-03-22 18:00:00,18
477,567,1044,58,14.9,1,Mostly Clear,7.9,2022-03-22 19:00:00,19
201,334,535,63,13.1,1,Mostly Clear,8.8,2022-03-22 20:00:00,20
174,235,409,67,11.6,1,Mostly Clear,9.9,2022-03-22 21:00:00,21
100,135,235,69,10.7,1,Mostly Clear,12.0,2022-03-22 22:00:00,22
54,72,126,69,10.1,1,Mostly Clear,10.9,2022-03-22 23:00:00,23
13,34,47,69,9.6,1,Mostly Clear,10.2,2022-03-23 00:00:00,0
10,7,17,70,9.2,1,Mostly Clear,10.5,2022-03-23 01:00:00,1
7,5,12,73,8.9,1,Mostly Clear,11.0,2022-03-23 02:00:00,2
2,7,9,76,8.6,1,Mostly Clear,12.5,2022-03-23 03:00:00,3
5,8,13,77,8.3,1,Mostly Clear,12.3,2022-03-23 04:00:00,4
15,57,72,77,7.9,1,Mostly Clear,12.6,2022-03-23 05:00:00,5
62,148,210,74,8.1,1,Mostly Clear,15.7,2022-03-23 06:00:00,6
145,390,535,70,8.3,2,Partly Cloudy,14.1,2022-03-23 07:00:00,7
217,626,843,69,8.7,1,Mostly Clear,15.2,2022-03-23 08:00:00,8
210,349,559,69,9.4,1,Mostly Clear,15.6,2022-03-23 09:00:00,9
132,219,351,66,10.5,2,Partly Cloudy,17.7,2022-03-23 10:00:00,10
116,226,342,63,12.1,3,Cloudy,15.4,2022-03-23 11:00:00,11
69,127,196,64,12.8,3,Cloudy,15.9,2022-03-23 12:00:00,12
47,123,170,69,12.5,51,Light Drizzle,15.2,2022-03-23 13:00:00,13
52,116,168,77,12.6,53,Heavy Drizzle,17.2,2022-03-23 14:00:00,14
115,197,312,93,10.0,55,Heavy Drizzle,18.2,2022-03-23 15:00:00,15
136,352,488,91,10.6,51,Light Drizzle,18.9,2022-03-23 16:00:00,16
175,490,665,90,11.1,51,Light Drizzle,18.1,2022-03-23 17:00:00,17
80,293,373,92,11.1,53,Heavy Drizzle,14.0,2022-03-23 18:00:00,18
42,147,189,95,11.2,53,Heavy Drizzle,14.8,2022-03-23 19:00:00,19
30,82,112,96,11.8,61,Light Rain,17.3,2022-03-23 20:00:00,20
27,54,81,97,12.8,55,Heavy Drizzle,16.2,2022-03-23 21:00:00,21
27,70,97,97,13.9,53,Heavy Drizzle,15.2,2022-03-23 22:00:00,22
11,33,44,97,14.9,51,Light Drizzle,14.2,2022-03-23 23:00:00,23
9,13,22,98,15.6,51,Light Drizzle,12.6,2022-03-24 00:00:00,0
3,0,3,98,16.3,51,Light Drizzle,11.0,2022-03-24 01:00:00,1
2,6,8,98,16.8,3,Cloudy,12.6,2022-03-24 02:00:00,2
3,2,5,98,17.2,51,Light Drizzle,15.0,2022-03-24 03:00:00,3
5,11,16,98,17.6,51,Light Drizzle,16.6,2022-03-24 04:00:00,4
7,40,47,98,17.7,51,Light Drizzle,16.7,2022-03-24 05:00:00,5
25,107,132,98,17.7,51,Light Drizzle,2.9,2022-03-24 06:00:00,6
54,233,287,98,17.5,53,Heavy Drizzle,3.2,2022-03-24 07:00:00,7
113,409,522,99,16.5,61,Light Rain,10.3,2022-03-24 08:00:00,8
122,282,404,97,15.1,51,Light Drizzle,11.9,2022-03-24 09:00:00,9
94,189,283,91,14.3,3,Cloudy,8.9,2022-03-24 10:00:00,10
166,205,371,89,14.3,3,Cloudy,8.4,2022-03-24 11:00:00,11
157,297,454,86,15.1,3,Cloudy,7.3,2022-03-24 12:00:00,12
217,274,491,81,16.1,3,Cloudy,8.4,2022-03-24 13:00:00,13
206,211,417,77,16.7,3,Cloudy,8.0,2022-03-24 14:00:00,14
249,297,546,85,13.8,3,Cloudy,8.4,2022-03-24 15:00:00,15
276,374,650,84,13.9,3,Cloudy,7.9,2022-03-24 16:00:00,16
384,618,1002,87,13.7,53,Heavy Drizzle,7.9,2022-03-24 17:00:00,17
292,525,817,92,12.7,53,Heavy Drizzle,9.7,2022-03-24 18:00:00,18
131,334,465,95,11.9,61,Light Rain,8.9,2022-03-24 19:00:00,19
78,174,252,97,11.3,63,Rain,6.4,2022-03-24 20:00:00,20
76,156,232,99,11.0,61,Light Rain,6.1,2022-03-24 21:00:00,21
64,129,193,99,10.9,51,Light Drizzle,5.2,2022-03-24 22:00:00,22
42,70,112,100,10.9,51,Light Drizzle,6.9,2022-03-24 23:00:00,23
37,56,93,100,11.1,51,Light Drizzle,10.9,2022-03-25 00:00:00,0
22,20,42,97,11.5,1,Mostly Clear,5.1,2022-03-25 01:00:00,1
13,14,27,94,11.4,0,Clear,7.1,2022-03-25 02:00:00,2
5,10,15,94,9.6,0,Clear,7.8,2022-03-25 03:00:00,3
7,15,22,93,9.0,0,Clear,9.3,2022-03-25 04:00:00,4
18,43,61,92,8.4,1,Mostly Clear,9.8,2022-03-25 05:00:00,5
78,135,213,90,8.2,1,Mostly Clear,8.9,2022-03-25 06:00:00,6
99,279,378,87,7.9,0,Clear,7.6,2022-03-25 07:00:00,7
173,458,631,89,7.9,0,Clear,8.2,2022-03-25 08:00:00,8
278,301,579,83,9.9,0,Clear,7.9,2022-03-25 09:00:00,9
326,229,555,63,12.2,0,Clear,7.8,2022-03-25 10:00:00,10
434,268,702,51,13.4,0,Clear,10.7,2022-03-25 11:00:00,11
407,372,779,45,14.7,2,Partly Cloudy,17.0,2022-03-25 12:00:00,12
505,396,901,42,15.5,2,Partly Cloudy,18.8,2022-03-25 13:00:00,13
507,361,868,42,15.6,2,Partly Cloudy,16.3,2022-03-25 14:00:00,14
547,426,973,40,16.1,2,Partly Cloudy,16.9,2022-03-25 15:00:00,15
570,514,1084,40,16.1,2,Partly Cloudy,17.0,2022-03-25 16:00:00,16
655,645,1300,41,15.7,2,Partly Cloudy,16.3,2022-03-25 17:00:00,17
609,653,1262,41,15.3,1,Mostly Clear,12.0,2022-03-25 18:00:00,18
414,475,889,44,13.9,2,Partly Cloudy,9.5,2022-03-25 19:00:00,19
214,260,474,46,12.5,2,Partly Cloudy,10.5,2022-03-25 20:00:00,20
129,184,313,47,11.5,2,Partly Cloudy,12.3,2022-03-25 21:00:00,21
99,158,257,48,11.1,2,Partly Cloudy,11.9,2022-03-25 22:00:00,22
113,137,250,50,10.5,2,Partly Cloudy,11.8,2022-03-25 23:00:00,23
117,120,237,53,9.8,2,Partly Cloudy,12.3,2022-03-26 00:00:00,0
66,95,161,56,9.2,2,Partly Cloudy,11.8,2022-03-26 01:00:00,1
37,45,82,62,8.3,2,Partly Cloudy,11.9,2022-03-26 02:00:00,2
13,23,36,58,9.5,2,Partly Cloudy,12.2,2022-03-26 03:00:00,3
5,8,13,60,9.2,1,Mostly Clear,10.2,2022-03-26 04:00:00,4
15,10,25,64,8.6,1,Mostly Clear,9.2,2022-03-26 05:00:00,5
61,56,117,67,7.9,0,Clear,7.5,2022-03-26 06:00:00,6
183,172,355,70,7.6,0,Clear,9.2,2022-03-26 07:00:00,7
218,216,434,71,7.7,1,Mostly Clear,12.8,2022-03-26 08:00:00,8
373,273,646,65,8.2,1,Mostly Clear,16.3,2022-03-26 09:00:00,9
493,379,872,55,9.2,1,Mostly Clear,17.7,2022-03-26 10:00:00,10
624,410,1034,48,10.3,1,Mostly Clear,19.1,2022-03-26 11:00:00,11
673,396,1069,40,10.7,1,Mostly Clear,20.9,2022-03-26 12:00:00,12
566,336,902,38,10.3,53,Heavy Drizzle,22.0,2022-03-26 13:00:00,13
617,374,991,32,10.6,2,Partly Cloudy,23.1,2022-03-26 14:00:00,14
550,336,886,46,10.3,53,Heavy Drizzle,22.4,2022-03-26 15:00:00,15
502,321,823,45,8.8,51,Light Drizzle,23.2,2022-03-26 16:00:00,16
488,320,808,48,9.0,2,Partly Cloudy,23.4,2022-03-26 17:00:00,17
379,336,715,42,8.8,51,Light Drizzle,18.8,2022-03-26 18:00:00,18
204,256,460,48,7.7,3,Cloudy,18.3,2022-03-26 19:00:00,19
115,160,275,53,7.2,2,Partly Cloudy,20.6,2022-03-26 20:00:00,20
78,117,195,55,6.5,0,Clear,21.4,2022-03-26 21:00:00,21
86,113,199,56,5.9,0,Clear,20.5,2022-03-26 22:00:00,22
73,115,188,57,5.5,0,Clear,20.1,2022-03-26 23:00:00,23
64,62,126,58,5.2,0,Clear,19.2,2022-03-27 00:00:00,0
47,51,98,59,4.7,0,Clear,18.6,2022-03-27 01:00:00,1
48,57,105,60,4.3,0,Clear,17.9,2022-03-27 02:00:00,2
10,18,28,58,3.6,0,Clear,16.9,2022-03-27 03:00:00,3
10,8,18,59,3.3,0,Clear,15.3,2022-03-27 04:00:00,4
10,10,20,60,2.9,0,Clear,13.7,2022-03-27 05:00:00,5
27,27,54,61,2.6,1,Mostly Clear,13.5,2022-03-27 06:00:00,6
38,49,87,62,2.3,0,Clear,13.5,2022-03-27 07:00:00,7
111,120,231,64,2.6,0,Clear,12.7,2022-03-27 08:00:00,8
187,153,340,56,3.9,0,Clear,18.4,2022-03-27 09:00:00,9
201,254,455,49,5.1,2,Partly Cloudy,21.9,2022-03-27 10:00:00,10
219,269,488,45,5.7,3,Cloudy,21.8,2022-03-27 11:00:00,11
221,253,474,42,6.2,3,Cloudy,21.9,2022-03-27 12:00:00,12
249,273,522,41,6.4,2,Partly Cloudy,23.1,2022-03-27 13:00:00,13
197,223,420,39,6.6,2,Partly Cloudy,24.8,2022-03-27 14:00:00,14
256,261,517,35,6.3,2,Partly Cloudy,25.2,2022-03-27 15:00:00,15
199,257,456,36,6.0,2,Partly Cloudy,25.1,2022-03-27 16:00:00,16
163,246,409,37,5.5,2,Partly Cloudy,25.4,2022-03-27 17:00:00,17
123,188,311,36,4.8,2,Partly Cloudy,23.6,2022-03-27 18:00:00,18
98,139,237,33,3.6,3,Cloudy,21.8,2022-03-27 19:00:00,19
49,104,153,34,2.7,2,Partly Cloudy,19.9,2022-03-27 20:00:00,20
35,75,110,35,1.9,0,Clear,20.2,2022-03-27 21:00:00,21
37,70,107,36,1.2,0,Clear,18.9,2022-03-27 22:00:00,22
24,45,69,37,0.7,0,Clear,17.1,2022-03-27 23:00:00,23
12,10,22,38,0.1,0,Clear,16.4,2022-03-28 00:00:00,0
3,11,14,40,-0.3,0,Clear,15.9,2022-03-28 01:00:00,1
2,4,6,41,-0.7,0,Clear,15.3,2022-03-28 02:00:00,2
4,3,7,46,-1.1,0,Clear,15.8,2022-03-28 03:00:00,3
5,5,10,46,-1.4,0,Clear,15.8,2022-03-28 04:00:00,4
12,25,37,46,-1.8,0,Clear,14.0,2022-03-28 05:00:00,5
32,121,153,46,-2.1,1,Mostly Clear,7.1,2022-03-28 06:00:00,6
58,205,263,57,-2.5,1,Mostly Clear,5.6,2022-03-28 07:00:00,7
105,383,488,55,-2.0,2,Partly Cloudy,8.8,2022-03-28 08:00:00,8
94,218,312,46,-0.2,3,Cloudy,15.3,2022-03-28 09:00:00,9
85,140,225,42,1.2,3,Cloudy,17.2,2022-03-28 10:00:00,10
74,140,214,37,2.6,3,Cloudy,21.0,2022-03-28 11:00:00,11
92,197,289,34,3.4,2,Partly Cloudy,26.0,2022-03-28 12:00:00,12
89,160,249,33,3.8,2,Partly Cloudy,25.6,2022-03-28 13:00:00,13
69,161,230,32,4.2,2,Partly Cloudy,25.7,2022-03-28 14:00:00,14
105,240,345,35,3.3,1,Mostly Clear,26.7,2022-03-28 15:00:00,15
106,276,382,32,3.1,1,Mostly Clear,28.8,2022-03-28 16:00:00,16
143,386,529,28,2.9,1,Mostly Clear,30.1,2022-03-28 17:00:00,17
99,315,414,28,2.1,1,Mostly Clear,26.6,2022-03-28 18:00:00,18
68,273,341,25,0.9,0,Clear,22.5,2022-03-28 19:00:00,19
44,154,198,26,0.0,0,Clear,21.0,2022-03-28 20:00:00,20
36,112,148,27,-0.7,0,Clear,20.4,2022-03-28 21:00:00,21
30,65,95,29,-1.1,0,Clear,19.6,2022-03-28 22:00:00,22
4,30,34,31,-1.4,0,Clear,19.6,2022-03-28 23:00:00,23
3,9,12,33,-1.7,0,Clear,18.4,2022-03-29 00:00:00,0
2,3,5,35,-2.0,0,Clear,18.6,2022-03-29 01:00:00,1
0,1,1,37,-2.2,0,Clear,17.9,2022-03-29 02:00:00,2
1,2,3,39,-3.1,0,Clear,17.1,2022-03-29 03:00:00,3
2,12,14,40,-3.3,0,Clear,16.4,2022-03-29 04:00:00,4
7,37,44,41,-3.4,0,Clear,15.6,2022-03-29 05:00:00,5
29,122,151,43,-3.5,0,Clear,13.9,2022-03-29 06:00:00,6
52,255,307,47,-3.5,0,Clear,14.9,2022-03-29 07:00:00,7
117,405,522,48,-3.0,0,Clear,16.4,2022-03-29 08:00:00,8
90,273,363,47,-1.9,0,Clear,16.5,2022-03-29 09:00:00,9
77,143,220,45,-0.5,0,Clear,16.0,2022-03-29 10:00:00,10
99,151,250,42,1.1,0,Clear,15.5,2022-03-29 11:00:00,11
83,214,297,39,2.4,0,Clear,15.3,2022-03-29 12:00:00,12
122,212,334,37,3.8,1,Mostly Clear,15.1,2022-03-29 13:00:00,13
125,194,319,35,5.0,0,Clear,15.5,2022-03-29 14:00:00,14
142,249,391,34,5.8,0,Clear,15.8,2022-03-29 15:00:00,15
177,344,521,33,6.5,0,Clear,15.5,2022-03-29 16:00:00,16
249,546,795,32,6.9,0,Clear,14.7,2022-03-29 17:00:00,17
234,491,725,32,6.7,0,Clear,10.3,2022-03-29 18:00:00,18
127,381,508,39,5.6,0,Clear,6.3,2022-03-29 19:00:00,19
97,204,301,57,4.1,0,Clear,7.0,2022-03-29 20:00:00,20
88,190,278,53,3.2,0,Clear,7.8,2022-03-29 21:00:00,21
68,121,189,49,3.3,0,Clear,7.6,2022-03-29 22:00:00,22
45,50,95,54,2.8,1,Mostly Clear,6.0,2022-03-29 23:00:00,23
22,19,41,63,1.9,1,Mostly Clear,3.3,2022-03-30 00:00:00,0
4,3,7,76,0.1,1,Mostly Clear,5.0,2022-03-30 01:00:00,1
1,5,6,67,2.1,1,Mostly Clear,6.1,2022-03-30 02:00:00,2
0,4,4,66,1.9,1,Mostly Clear,6.6,2022-03-30 03:00:00,3
7,8,15,64,2.5,1,Mostly Clear,0.8,2022-03-30 04:00:00,4
7,41,48,73,1.6,2,Partly Cloudy,3.0,2022-03-30 05:00:00,5
27,110,137,78,1.5,3,Cloudy,5.1,2022-03-30 06:00:00,6
49,205,254,83,1.1,3,Cloudy,5.1,2022-03-30 07:00:00,7
101,494,595,83,1.9,3,Cloudy,6.5,2022-03-30 08:00:00,8
104,302,406,70,3.7,3,Cloudy,6.5,2022-03-30 09:00:00,9
124,188,312,69,4.4,3,Cloudy,8.3,2022-03-30 10:00:00,10
122,198,320,57,6.8,1,Mostly Clear,10.0,2022-03-30 11:00:00,11
160,235,395,49,9.2,1,Mostly Clear,12.8,2022-03-30 12:00:00,12
196,264,460,45,11.3,1,Mostly Clear,14.7,2022-03-30 13:00:00,13
231,249,480,45,12.5,0,Clear,16.3,2022-03-30 14:00:00,14
235,323,558,43,14.0,1,Mostly Clear,16.3,2022-03-30 15:00:00,15
261,432,693,43,14.6,1,Mostly Clear,16.9,2022-03-30 16:00:00,16
387,696,1083,46,14.3,1,Mostly Clear,17.2,2022-03-30 17:00:00,17
337,636,973,51,13.3,2,Partly Cloudy,12.8,2022-03-30 18:00:00,18
200,445,645,55,11.9,2,Partly Cloudy,14.0,2022-03-30 19:00:00,19
165,269,434,59,11.0,3,Cloudy,15.3,2022-03-30 20:00:00,20
107,234,341,62,10.9,1,Mostly Clear,14.0,2022-03-30 21:00:00,21
121,152,273,66,11.2,0,Clear,12.1,2022-03-30 22:00:00,22
49,87,136,71,11.3,0,Clear,12.6,2022-03-30 23:00:00,23
22,20,42,75,11.7,1,Mostly Clear,12.6,2022-03-31 00:00:00,0
9,18,27,82,12.1,1,Mostly Clear,14.1,2022-03-31 01:00:00,1
7,12,19,90,12.6,1,Mostly Clear,16.0,2022-03-31 02:00:00,2
6,9,15,93,12.7,3,Cloudy,19.3,2022-03-31 03:00:00,3
3,18,21,92,14.2,3,Cloudy,23.1,2022-03-31 04:00:00,4
13,59,72,90,15.0,3,Cloudy,25.1,2022-03-31 05:00:00,5
38,124,162,88,15.2,3,Cloudy,21.7,2022-03-31 06:00:00,6
74,323,397,86,15.3,3,Cloudy,21.6,2022-03-31 07:00:00,7
140,493,633,84,15.6,3,Cloudy,22.7,2022-03-31 08:00:00,8
133,328,461,81,16.3,3,Cloudy,23.1,2022-03-31 09:00:00,9
129,209,338,78,17.2,3,Cloudy,23.1,2022-03-31 10:00:00,10
125,208,333,75,18.5,3,Cloudy,24.7,2022-03-31 11:00:00,11
166,267,433,76,19.3,51,Light Drizzle,23.8,2022-03-31 12:00:00,12
140,250,390,80,19.1,53,Heavy Drizzle,21.6,2022-03-31 13:00:00,13
85,159,244,90,18.0,55,Heavy Drizzle,23.3,2022-03-31 14:00:00,14
163,250,413,74,20.9,51,Light Drizzle,25.6,2022-03-31 15:00:00,15
202,379,581,76,20.5,51,Light Drizzle,28.6,2022-03-31 16:00:00,16
254,607,861,74,20.7,1,Mostly Clear,26.6,2022-03-31 17:00:00,17
266,575,841,79,20.5,53,Heavy Drizzle,25.6,2022-03-31 18:00:00,18
216,457,673,93,18.7,61,Light Rain,20.1,2022-03-31 19:00:00,19
144,239,383,96,18.2,61,Light Rain,18.0,2022-03-31 20:00:00,20
90,181,271,97,18.1,61,Light Rain,19.5,2022-03-31 21:00:00,21
80,132,212,98,17.4,63,Rain,18.5,2022-03-31 22:00:00,22
68,99,167,97,16.9,53,Heavy Drizzle,15.3,2022-03-31 23:00:00,23
37,61,98,95,16.5,53,Heavy Drizzle,12.0,2022-04-01 00:00:00,0
17,21,38,93,15.8,51,Light Drizzle,12.6,2022-04-01 01:00:00,1
9,13,22,92,14.0,3,Cloudy,17.6,2022-04-01 02:00:00,2
2,7,9,87,13.2,51,Light Drizzle,21.4,2022-04-01 03:00:00,3
11,10,21,83,11.6,51,Light Drizzle,21.4,2022-04-01 04:00:00,4
8,34,42,75,10.5,51,Light Drizzle,19.3,2022-04-01 05:00:00,5
25,113,138,65,10.2,2,Partly Cloudy,14.8,2022-04-01 06:00:00,6
61,235,296,59,9.9,2,Partly Cloudy,14.2,2022-04-01 07:00:00,7
138,417,555,58,9.6,2,Partly Cloudy,13.3,2022-04-01 08:00:00,8
129,267,396,55,9.6,1,Mostly Clear,14.6,2022-04-01 09:00:00,9
191,220,411,52,10.5,0,Clear,16.7,2022-04-01 10:00:00,10
186,251,437,45,12.2,1,Mostly Clear,23.9,2022-04-01 11:00:00,11
148,242,390,46,12.2,1,Mostly Clear,23.4,2022-04-01 12:00:00,12
240,267,507,45,12.5,2,Partly Cloudy,24.7,2022-04-01 13:00:00,13
270,305,575,44,12.1,1,Mostly Clear,26.0,2022-04-01 14:00:00,14
307,378,685,39,12.1,1,Mostly Clear,28.4,2022-04-01 15:00:00,15
350,433,783,35,12.3,0,Clear,28.9,2022-04-01 16:00:00,16
424,625,1049,35,11.8,0,Clear,28.9,2022-04-01 17:00:00,17
337,527,864,35,11.0,0,Clear,25.1,2022-04-01 18:00:00,18
237,411,648,35,9.9,0,Clear,20.2,2022-04-01 19:00:00,19
118,226,344,37,9.0,0,Clear,18.0,2022-04-01 20:00:00,20
119,191,310,40,8.4,0,Clear,16.9,2022-04-01 21:00:00,21
98,154,252,44,7.7,0,Clear,17.3,2022-04-01 22:00:00,22
67,130,197,48,6.8,0,Clear,16.9,2022-04-01 23:00:00,23
75,95,170,52,6.0,0,Clear,16.4,2022-04-02 00:00:00,0
50,61,111,53,5.4,0,Clear,15.6,2022-04-02 01:00:00,1
33,49,82,53,4.8,0,Clear,14.7,2022-04-02 02:00:00,2
10,21,31,57,4.6,0,Clear,13.4,2022-04-02 03:00:00,3
11,11,22,57,4.1,0,Clear,13.0,2022-04-02 04:00:00,4
5,12,17,58,3.5,0,Clear,12.2,2022-04-02 05:00:00,5
21,33,54,59,3.0,1,Mostly Clear,11.2,2022-04-02 06:00:00,6
29,81,110,62,2.5,0,Clear,9.1,2022-04-02 07:00:00,7
101,162,263,64,3.0,0,Clear,8.2,2022-04-02 08:00:00,8
207,294,501,55,4.4,0,Clear,12.2,2022-04-02 09:00:00,9
382,362,744,53,5.6,0,Clear,9.5,2022-04-02 10:00:00,10
532,412,944,50,7.2,0,Clear,6.2,2022-04-02 11:00:00,11
707,441,1148,47,8.8,0,Clear,4.5,2022-04-02 12:00:00,12
767,465,1232,44,10.3,0,Clear,3.9,2022-04-02 13:00:00,13
795,453,1248,42,11.5,0,Clear,3.2,2022-04-02 14:00:00,14
801,464,1265,40,12.7,0,Clear,3.0,2022-04-02 15:00:00,15
787,470,1257,39,13.2,0,Clear,7.2,2022-04-02 16:00:00,16
781,476,1257,40,13.2,0,Clear,9.8,2022-04-02 17:00:00,17
564,437,1001,40,12.9,0,Clear,8.0,2022-04-02 18:00:00,18
430,328,758,46,11.7,0,Clear,6.3,2022-04-02 19:00:00,19
234,212,446,54,9.6,2,Partly Cloudy,8.9,2022-04-02 20:00:00,20
146,192,338,61,8.2,1,Mostly Clear,11.7,2022-04-02 21:00:00,21
152,160,312,65,7.4,1,Mostly Clear,12.0,2022-04-02 22:00:00,22
168,188,356,70,6.9,1,Mostly Clear,13.3,2022-04-02 23:00:00,23
92,111,203,74,6.7,3,Cloudy,12.8,2022-04-03 00:00:00,0
70,61,131,76,7.0,3,Cloudy,11.1,2022-04-03 01:00:00,1
49,56,105,78,7.2,2,Partly Cloudy,10.8,2022-04-03 02:00:00,2
21,25,46,76,7.7,2,Partly Cloudy,11.3,2022-04-03 03:00:00,3
7,8,15,77,7.9,2,Partly Cloudy,10.0,2022-04-03 04:00:00,4
13,18,31,79,7.9,2,Partly Cloudy,8.0,2022-04-03 05:00:00,5
235,174,409,82,7.8,1,Mostly Clear,1.3,2022-04-03 06:00:00,6
152,115,267,85,7.5,1,Mostly Clear,1.5,2022-04-03 07:00:00,7
151,180,331,81,8.1,1,Mostly Clear,2.9,2022-04-03 08:00:00,8
288,241,529,70,9.9,0,Clear,3.3,2022-04-03 09:00:00,9
487,403,890,55,12.0,0,Clear,7.4,2022-04-03 10:00:00,10
468,445,913,47,13.1,1,Mostly Clear,23.3,2022-04-03 11:00:00,11
510,400,910,45,13.3,1,Mostly Clear,24.6,2022-04-03 12:00:00,12
572,440,1012,46,13.2,51,Light Drizzle,24.3,2022-04-03 13:00:00,13
583,373,956,46,13.4,1,Mostly Clear,25.8,2022-04-03 14:00:00,14
480,370,850,44,13.7,1,Mostly Clear,27.1,2022-04-03 15:00:00,15
381,355,736,43,13.1,0,Clear,26.2,2022-04-03 16:00:00,16
268,280,548,44,12.7,0,Clear,25.7,2022-04-03 17:00:00,17
235,262,497,44,11.8,0,Clear,22.6,2022-04-03 18:00:00,18
119,189,308,43,10.6,0,Clear,18.4,2022-04-03 19:00:00,19
88,127,215,43,9.5,0,Clear,14.8,2022-04-03 20:00:00,20
71,112,183,43,8.7,0,Clear,14.8,2022-04-03 21:00:00,21
62,86,148,43,7.9,0,Clear,16.1,2022-04-03 22:00:00,22
24,43,67,45,7.1,0,Clear,15.8,2022-04-03 23:00:00,23
19,19,38,48,6.3,0,Clear,15.4,2022-04-04 00:00:00,0
12,11,23,51,5.6,0,Clear,14.4,2022-04-04 01:00:00,1
5,11,16,54,5.0,0,Clear,13.6,2022-04-04 02:00:00,2
1,4,5,57,4.3,0,Clear,12.8,2022-04-04 03:00:00,3
12,10,22,60,3.8,0,Clear,12.0,2022-04-04 04:00:00,4
15,33,48,62,3.3,0,Clear,11.3,2022-04-04 05:00:00,5
18,125,143,66,2.7,0,Clear,8.9,2022-04-04 06:00:00,6
85,267,352,74,2.0,0,Clear,7.7,2022-04-04 07:00:00,7
156,454,610,75,2.9,0,Clear,8.3,2022-04-04 08:00:00,8
134,285,419,63,5.1,0,Clear,6.8,2022-04-04 09:00:00,9
178,179,357,57,6.9,2,Partly Cloudy,8.9,2022-04-04 10:00:00,10
215,207,422,52,8.5,0,Clear,5.1,2022-04-04 11:00:00,11
221,248,469,46,10.2,1,Mostly Clear,5.0,2022-04-04 12:00:00,12
273,233,506,43,11.6,1,Mostly Clear,6.6,2022-04-04 13:00:00,13
315,249,564,40,12.8,2,Partly Cloudy,7.6,2022-04-04 14:00:00,14
296,307,603,38,12.7,2,Partly Cloudy,8.0,2022-04-04 15:00:00,15
266,387,653,36,13.2,2,Partly Cloudy,8.5,2022-04-04 16:00:00,16
376,614,990,36,13.1,2,Partly Cloudy,8.2,2022-04-04 17:00:00,17
302,566,868,39,12.6,2,Partly Cloudy,5.8,2022-04-04 18:00:00,18
204,374,578,46,11.8,2,Partly Cloudy,1.9,2022-04-04 19:00:00,19
142,290,432,53,10.5,2,Partly Cloudy,3.0,2022-04-04 20:00:00,20
108,173,281,56,9.2,2,Partly Cloudy,4.7,2022-04-04 21:00:00,21
65,88,153,60,8.6,2,Partly Cloudy,6.6,2022-04-04 22:00:00,22
63,90,153,63,8.5,3,Cloudy,8.2,2022-04-04 23:00:00,23
38,25,63,66,8.3,2,Partly Cloudy,9.2,2022-04-05 00:00:00,0
12,9,21,70,8.0,2,Partly Cloudy,9.4,2022-04-05 01:00:00,1
1,4,5,75,7.6,2,Partly Cloudy,9.4,2022-04-05 02:00:00,2
2,7,9,76,7.8,2,Partly Cloudy,8.9,2022-04-05 03:00:00,3
6,9,15,79,7.7,3,Cloudy,8.7,2022-04-05 04:00:00,4
17,50,67,82,7.7,2,Partly Cloudy,8.4,2022-04-05 05:00:00,5
48,160,208,85,7.5,2,Partly Cloudy,6.4,2022-04-05 06:00:00,6
83,342,425,90,7.0,3,Cloudy,5.9,2022-04-05 07:00:00,7
115,386,501,90,7.8,3,Cloudy,6.4,2022-04-05 08:00:00,8
71,217,288,81,9.5,51,Light Drizzle,4.6,2022-04-05 09:00:00,9
39,102,141,82,10.0,53,Heavy Drizzle,4.4,2022-04-05 10:00:00,10
30,79,109,90,9.8,53,Heavy Drizzle,3.0,2022-04-05 11:00:00,11
28,97,125,91,10.3,53,Heavy Drizzle,4.2,2022-04-05 12:00:00,12
45,112,157,91,11.2,51,Light Drizzle,4.3,2022-04-05 13:00:00,13
59,135,194,88,12.3,51,Light Drizzle,4.3,2022-04-05 14:00:00,14
111,214,325,88,12.3,51,Light Drizzle,6.4,2022-04-05 15:00:00,15
150,327,477,92,12.3,51,Light Drizzle,8.9,2022-04-05 16:00:00,16
213,587,800,91,12.3,51,Light Drizzle,10.8,2022-04-05 17:00:00,17
189,537,726,92,12.3,3,Cloudy,8.8,2022-04-05 18:00:00,18
100,230,330,95,11.8,51,Light Drizzle,11.2,2022-04-05 19:00:00,19
46,110,156,96,11.3,53,Heavy Drizzle,12.2,2022-04-05 20:00:00,20
24,61,85,96,11.0,61,Light Rain,15.0,2022-04-05 21:00:00,21
15,36,51,98,11.0,61,Light Rain,16.6,2022-04-05 22:00:00,22
8,22,30,98,11.1,61,Light Rain,17.9,2022-04-05 23:00:00,23
3,13,16,98,11.2,63,Rain,16.4,2022-04-06 00:00:00,0
0,5,5,100,11.2,63,Rain,16.1,2022-04-06 01:00:00,1
0,3,3,99,11.2,63,Rain,18.3,2022-04-06 02:00:00,2
2,4,6,100,11.8,61,Light Rain,18.7,2022-04-06 03:00:00,3
8,5,13,99,11.5,61,Light Rain,18.4,2022-04-06 04:00:00,4
8,33,41,100,11.1,61,Light Rain,14.0,2022-04-06 05:00:00,5
35,107,142,100,10.8,61,Light Rain,11.5,2022-04-06 06:00:00,6
62,250,312,99,10.7,53,Heavy Drizzle,11.8,2022-04-06 07:00:00,7
84,330,414,99,10.6,51,Light Drizzle,12.3,2022-04-06 08:00:00,8
69,184,253,98,10.8,51,Light Drizzle,12.0,2022-04-06 09:00:00,9
72,167,239,97,11.1,3,Cloudy,11.4,2022-04-06 10:00:00,10
102,171,273,96,11.8,3,Cloudy,9.3,2022-04-06 11:00:00,11
115,250,365,93,12.7,3,Cloudy,9.5,2022-04-06 12:00:00,12
149,287,436,90,13.5,3,Cloudy,7.9,2022-04-06 13:00:00,13
142,266,408,86,14.3,51,Light Drizzle,4.6,2022-04-06 14:00:00,14
193,369,562,89,13.4,51,Light Drizzle,1.8,2022-04-06 15:00:00,15
207,406,613,88,13.6,51,Light Drizzle,1.1,2022-04-06 16:00:00,16
326,732,1058,87,13.9,3,Cloudy,2.3,2022-04-06 17:00:00,17
295,674,969,88,13.7,3,Cloudy,6.8,2022-04-06 18:00:00,18
231,491,722,90,13.4,3,Cloudy,9.4,2022-04-06 19:00:00,19
172,270,442,94,12.5,3,Cloudy,11.6,2022-04-06 20:00:00,20
120,231,351,96,11.9,3,Cloudy,11.6,2022-04-06 21:00:00,21
78,194,272,95,11.9,3,Cloudy,12.7,2022-04-06 22:00:00,22
44,96,140,95,11.8,3,Cloudy,17.0,2022-04-06 23:00:00,23
21,29,50,94,11.8,3,Cloudy,18.3,2022-04-07 00:00:00,0
7,15,22,95,11.1,3,Cloudy,18.4,2022-04-07 01:00:00,1
2,14,16,94,10.4,3,Cloudy,16.6,2022-04-07 02:00:00,2
2,5,7,92,9.9,3,Cloudy,16.0,2022-04-07 03:00:00,3
4,8,12,93,9.7,3,Cloudy,13.8,2022-04-07 04:00:00,4
17,39,56,94,9.6,3,Cloudy,13.6,2022-04-07 05:00:00,5
14,65,79,95,9.5,51,Light Drizzle,8.3,2022-04-07 06:00:00,6
30,95,125,97,9.5,51,Light Drizzle,11.5,2022-04-07 07:00:00,7
57,261,318,98,9.8,53,Heavy Drizzle,11.9,2022-04-07 08:00:00,8
54,185,239,99,10.2,53,Heavy Drizzle,10.5,2022-04-07 09:00:00,9
29,93,122,98,10.8,61,Light Rain,9.2,2022-04-07 10:00:00,10
42,122,164,98,11.4,55,Heavy Drizzle,6.9,2022-04-07 11:00:00,11
58,167,225,98,12.0,61,Light Rain,7.6,2022-04-07 12:00:00,12
32,141,173,98,12.7,61,Light Rain,8.4,2022-04-07 13:00:00,13
59,137,196,97,12.7,53,Heavy Drizzle,8.6,2022-04-07 14:00:00,14
101,201,302,98,11.1,61,Light Rain,11.0,2022-04-07 15:00:00,15
107,261,368,98,10.8,63,Rain,13.6,2022-04-07 16:00:00,16
106,354,460,97,10.5,61,Light Rain,14.0,2022-04-07 17:00:00,17
60,239,299,97,10.2,61,Light Rain,14.0,2022-04-07 18:00:00,18
95,239,334,96,9.9,53,Heavy Drizzle,13.4,2022-04-07 19:00:00,19
73,213,286,95,9.7,51,Light Drizzle,12.5,2022-04-07 20:00:00,20
60,169,229,95,9.7,1,Mostly Clear,12.7,2022-04-07 21:00:00,21
83,171,254,95,9.3,1,Mostly Clear,10.3,2022-04-07 22:00:00,22
49,101,150,96,8.6,1,Mostly Clear,10.5,2022-04-07 23:00:00,23
49,68,117,96,8.0,1,Mostly Clear,10.8,2022-04-08 00:00:00,0
16,33,49,96,7.7,1,Mostly Clear,11.5,2022-04-08 01:00:00,1
12,15,27,95,7.5,0,Clear,13.9,2022-04-08 02:00:00,2
6,13,19,92,7.6,0,Clear,14.2,2022-04-08 03:00:00,3
5,13,18,92,7.2,0,Clear,12.7,2022-04-08 04:00:00,4
13,30,43,92,6.5,0,Clear,11.1,2022-04-08 05:00:00,5
41,129,170,92,5.8,0,Clear,9.4,2022-04-08 06:00:00,6
68,253,321,92,5.2,0,Clear,8.7,2022-04-08 07:00:00,7
151,478,629,91,6.5,0,Clear,9.1,2022-04-08 08:00:00,8
175,303,478,80,9.3,0,Clear,7.4,2022-04-08 09:00:00,9
190,223,413,66,11.5,0,Clear,8.9,2022-04-08 10:00:00,10
219,305,524,50,13.3,0,Clear,8.6,2022-04-08 11:00:00,11
322,321,643,44,14.5,0,Clear,8.5,2022-04-08 12:00:00,12
313,360,673,41,15.2,51,Light Drizzle,10.8,2022-04-08 13:00:00,13
377,355,732,39,15.5,51,Light Drizzle,17.6,2022-04-08 14:00:00,14
454,427,881,32,16.7,1,Mostly Clear,18.9,2022-04-08 15:00:00,15
398,495,893,32,16.9,1,Mostly Clear,17.3,2022-04-08 16:00:00,16
488,609,1097,33,16.4,1,Mostly Clear,16.8,2022-04-08 17:00:00,17
404,576,980,38,15.2,51,Light Drizzle,9.4,2022-04-08 18:00:00,18
302,466,768,46,14.0,2,Partly Cloudy,7.3,2022-04-08 19:00:00,19
152,289,441,53,12.3,2,Partly Cloudy,5.2,2022-04-08 20:00:00,20
128,199,327,62,11.1,2,Partly Cloudy,8.7,2022-04-08 21:00:00,21
99,154,253,72,10.5,2,Partly Cloudy,10.4,2022-04-08 22:00:00,22
70,110,180,79,9.5,2,Partly Cloudy,6.6,2022-04-08 23:00:00,23
56,89,145,82,8.5,2,Partly Cloudy,4.6,2022-04-09 00:00:00,0
40,55,95,83,7.5,2,Partly Cloudy,4.6,2022-04-09 01:00:00,1
34,52,86,84,7.0,2,Partly Cloudy,6.0,2022-04-09 02:00:00,2
16,12,28,89,6.7,51,Light Drizzle,5.8,2022-04-09 03:00:00,3
8,7,15,90,6.1,51,Light Drizzle,7.8,2022-04-09 04:00:00,4
7,14,21,92,5.9,51,Light Drizzle,7.2,2022-04-09 05:00:00,5
20,35,55,93,5.7,51,Light Drizzle,7.2,2022-04-09 06:00:00,6
50,103,153,93,5.6,51,Light Drizzle,7.3,2022-04-09 07:00:00,7
118,173,291,91,6.4,0,Clear,8.1,2022-04-09 08:00:00,8
245,276,521,79,8.0,0,Clear,9.0,2022-04-09 09:00:00,9
416,357,773,69,9.2,0,Clear,14.1,2022-04-09 10:00:00,10
458,407,865,64,10.4,1,Mostly Clear,13.5,2022-04-09 11:00:00,11
579,429,1008,59,11.8,2,Partly Cloudy,12.4,2022-04-09 12:00:00,12
653,441,1094,54,12.9,1,Mostly Clear,11.4,2022-04-09 13:00:00,13
693,436,1129,51,13.7,2,Partly Cloudy,10.6,2022-04-09 14:00:00,14
601,428,1029,52,13.8,51,Light Drizzle,10.7,2022-04-09 15:00:00,15
546,356,902,51,13.7,51,Light Drizzle,11.2,2022-04-09 16:00:00,16
526,394,920,57,11.9,53,Heavy Drizzle,16.3,2022-04-09 17:00:00,17
357,335,692,60,9.9,51,Light Drizzle,13.1,2022-04-09 18:00:00,18
274,300,574,52,9.9,2,Partly Cloudy,9.0,2022-04-09 19:00:00,19
145,192,337,53,9.5,3,Cloudy,5.5,2022-04-09 20:00:00,20
124,152,276,62,8.3,2,Partly Cloudy,7.2,2022-04-09 21:00:00,21
123,153,276,59,7.5,2,Partly Cloudy,12.9,2022-04-09 22:00:00,22
111,157,268,55,7.2,2,Partly Cloudy,16.4,2022-04-09 23:00:00,23
81,110,191,56,6.5,1,Mostly Clear,15.3,2022-04-10 00:00:00,0
55,72,127,61,5.9,0,Clear,16.1,2022-04-10 01:00:00,1
57,39,96,67,5.4,0,Clear,16.9,2022-04-10 02:00:00,2
24,24,48,70,5.3,0,Clear,16.0,2022-04-10 03:00:00,3
8,4,12,71,5.0,0,Clear,15.8,2022-04-10 04:00:00,4
6,10,16,72,4.6,0,Clear,14.7,2022-04-10 05:00:00,5
24,49,73,72,4.3,0,Clear,9.8,2022-04-10 06:00:00,6
31,61,92,74,3.9,0,Clear,9.4,2022-04-10 07:00:00,7
83,106,189,72,4.8,0,Clear,10.7,2022-04-10 08:00:00,8
194,183,377,62,6.4,1,Mostly Clear,16.3,2022-04-10 09:00:00,9
272,265,537,52,7.7,3,Cloudy,21.8,2022-04-10 10:00:00,10
305,288,593,48,8.3,51,Light Drizzle,22.6,2022-04-10 11:00:00,11
319,334,653,44,9.1,51,Light Drizzle,23.0,2022-04-10 12:00:00,12
341,326,667,40,10.4,2,Partly Cloudy,22.7,2022-04-10 13:00:00,13
285,341,626,38,10.9,3,Cloudy,23.9,2022-04-10 14:00:00,14
366,333,699,39,10.7,2,Partly Cloudy,25.0,2022-04-10 15:00:00,15
337,343,680,39,11.3,1,Mostly Clear,25.8,2022-04-10 16:00:00,16
347,319,666,39,11.5,2,Partly Cloudy,26.0,2022-04-10 17:00:00,17
261,325,586,40,11.3,2,Partly Cloudy,19.3,2022-04-10 18:00:00,18
183,281,464,42,10.5,0,Clear,11.3,2022-04-10 19:00:00,19
119,167,286,46,9.3,0,Clear,7.4,2022-04-10 20:00:00,20
82,108,190,50,7.9,0,Clear,7.6,2022-04-10 21:00:00,21
68,84,152,58,6.7,0,Clear,6.7,2022-04-10 22:00:00,22
32,52,84,69,5.2,0,Clear,7.2,2022-04-10 23:00:00,23
11,18,29,73,4.3,0,Clear,8.0,2022-04-11 00:00:00,0
8,9,17,76,3.6,0,Clear,7.6,2022-04-11 01:00:00,1
1,14,15,79,2.9,0,Clear,8.0,2022-04-11 02:00:00,2
4,6,10,79,3.3,0,Clear,7.6,2022-04-11 03:00:00,3
6,11,17,80,3.1,0,Clear,6.6,2022-04-11 04:00:00,4
10,34,44,84,2.2,0,Clear,6.2,2022-04-11 05:00:00,5
29,133,162,86,1.6,0,Clear,7.4,2022-04-11 06:00:00,6
59,260,319,86,1.5,0,Clear,6.5,2022-04-11 07:00:00,7
127,452,579,83,4.2,0,Clear,7.2,2022-04-11 08:00:00,8
140,266,406,60,8.2,1,Mostly Clear,6.9,2022-04-11 09:00:00,9
186,204,390,54,9.9,1,Mostly Clear,7.9,2022-04-11 10:00:00,10
226,211,437,52,11.6,1,Mostly Clear,8.1,2022-04-11 11:00:00,11
273,301,574,49,13.3,1,Mostly Clear,8.7,2022-04-11 12:00:00,12
270,269,539,48,14.8,1,Mostly Clear,10.0,2022-04-11 13:00:00,13
329,283,612,48,15.7,1,Mostly Clear,12.1,2022-04-11 14:00:00,14
342,314,656,47,17.0,0,Clear,13.6,2022-04-11 15:00:00,15
324,423,747,47,17.6,0,Clear,14.7,2022-04-11 16:00:00,16
449,680,1129,49,17.6,0,Clear,14.7,2022-04-11 17:00:00,17
357,617,974,54,16.7,0,Clear,11.1,2022-04-11 18:00:00,18
306,445,751,61,14.6,0,Clear,14.0,2022-04-11 19:00:00,19
194,286,480,68,12.4,1,Mostly Clear,12.0,2022-04-11 20:00:00,20
108,174,282,72,11.5,2,Partly Cloudy,9.9,2022-04-11 21:00:00,21
73,112,185,76,11.0,1,Mostly Clear,8.5,2022-04-11 22:00:00,22
48,62,110,78,11.0,2,Partly Cloudy,7.5,2022-04-11 23:00:00,23
27,19,46,80,11.2,3,Cloudy,5.6,2022-04-12 00:00:00,0
4,7,11,83,11.2,2,Partly Cloudy,5.4,2022-04-12 01:00:00,1
1,2,3,84,11.3,2,Partly Cloudy,4.6,2022-04-12 02:00:00,2
2,4,6,85,10.6,2,Partly Cloudy,4.3,2022-04-12 03:00:00,3
7,17,24,86,10.5,2,Partly Cloudy,6.3,2022-04-12 04:00:00,4
13,44,57,85,10.9,2,Partly Cloudy,7.2,2022-04-12 05:00:00,5
33,136,169,85,11.1,2,Partly Cloudy,5.4,2022-04-12 06:00:00,6
76,319,395,84,11.4,3,Cloudy,5.7,2022-04-12 07:00:00,7
170,465,635,80,12.3,3,Cloudy,7.6,2022-04-12 08:00:00,8
168,366,534,80,13.3,51,Light Drizzle,8.3,2022-04-12 09:00:00,9
195,240,435,83,14.3,51,Light Drizzle,7.0,2022-04-12 10:00:00,10
261,240,501,76,16.9,0,Clear,9.8,2022-04-12 11:00:00,11
330,307,637,67,18.9,2,Partly Cloudy,15.0,2022-04-12 12:00:00,12
282,296,578,58,21.1,3,Cloudy,14.2,2022-04-12 13:00:00,13
332,281,613,54,21.9,3,Cloudy,12.6,2022-04-12 14:00:00,14
342,354,696,49,23.4,3,Cloudy,8.8,2022-04-12 15:00:00,15
423,487,910,47,23.7,3,Cloudy,8.0,2022-04-12 16:00:00,16
635,822,1457,50,23.6,3,Cloudy,5.4,2022-04-12 17:00:00,17
523,829,1352,55,23.0,1,Mostly Clear,2.9,2022-04-12 18:00:00,18
442,565,1007,60,21.8,1,Mostly Clear,4.3,2022-04-12 19:00:00,19
255,347,602,68,19.9,2,Partly Cloudy,6.3,2022-04-12 20:00:00,20
191,289,480,75,18.3,2,Partly Cloudy,7.3,2022-04-12 21:00:00,21
128,215,343,81,16.9,1,Mostly Clear,8.9,2022-04-12 22:00:00,22
73,85,158,85,15.9,1,Mostly Clear,8.7,2022-04-12 23:00:00,23
33,42,75,88,14.9,0,Clear,7.2,2022-04-13 00:00:00,0
17,9,26,90,14.3,0,Clear,6.7,2022-04-13 01:00:00,1
5,5,10,92,13.9,1,Mostly Clear,6.4,2022-04-13 02:00:00,2
4,7,11,93,13.3,1,Mostly Clear,5.9,2022-04-13 03:00:00,3
4,9,13,94,12.4,1,Mostly Clear,5.5,2022-04-13 04:00:00,4
17,43,60,95,12.0,1,Mostly Clear,7.4,2022-04-13 05:00:00,5
50,150,200,95,11.7,1,Mostly Clear,1.8,2022-04-13 06:00:00,6
102,368,470,96,11.3,1,Mostly Clear,4.3,2022-04-13 07:00:00,7
221,592,813,93,13.8,1,Mostly Clear,2.9,2022-04-13 08:00:00,8
214,390,604,79,17.7,1,Mostly Clear,2.2,2022-04-13 09:00:00,9
284,279,563,71,20.0,1,Mostly Clear,4.9,2022-04-13 10:00:00,10
290,273,563,65,22.2,1,Mostly Clear,6.3,2022-04-13 11:00:00,11
320,291,611,59,24.3,1,Mostly Clear,6.6,2022-04-13 12:00:00,12
379,327,706,56,25.7,1,Mostly Clear,8.6,2022-04-13 13:00:00,13
323,314,637,53,26.7,1,Mostly Clear,11.2,2022-04-13 14:00:00,14
360,367,727,49,28.3,1,Mostly Clear,13.4,2022-04-13 15:00:00,15
383,526,909,46,28.5,3,Cloudy,17.6,2022-04-13 16:00:00,16
556,839,1395,49,27.8,2,Partly Cloudy,12.6,2022-04-13 17:00:00,17
556,796,1352,51,26.5,1,Mostly Clear,13.7,2022-04-13 18:00:00,18
443,519,962,56,24.9,2,Partly Cloudy,14.1,2022-04-13 19:00:00,19
285,360,645,61,23.5,3,Cloudy,15.4,2022-04-13 20:00:00,20
181,296,477,64,22.6,1,Mostly Clear,18.4,2022-04-13 21:00:00,21
195,212,407,64,22.4,1,Mostly Clear,20.0,2022-04-13 22:00:00,22
94,119,213,62,22.3,1,Mostly Clear,19.6,2022-04-13 23:00:00,23
39,45,84,59,22.4,1,Mostly Clear,20.7,2022-04-14 00:00:00,0
31,14,45,60,22.2,1,Mostly Clear,21.1,2022-04-14 01:00:00,1
12,8,20,60,21.8,1,Mostly Clear,21.7,2022-04-14 02:00:00,2
3,8,11,59,21.6,1,Mostly Clear,21.1,2022-04-14 03:00:00,3
3,15,18,61,21.0,1,Mostly Clear,20.4,2022-04-14 04:00:00,4
9,42,51,64,20.3,0,Clear,19.4,2022-04-14 05:00:00,5
40,136,176,67,19.7,0,Clear,14.7,2022-04-14 06:00:00,6
96,333,429,72,19.1,0,Clear,16.9,2022-04-14 07:00:00,7
199,561,760,72,19.7,0,Clear,16.9,2022-04-14 08:00:00,8
208,364,572,69,21.1,1,Mostly Clear,16.0,2022-04-14 09:00:00,9
265,249,514,65,22.5,0,Clear,19.5,2022-04-14 10:00:00,10
279,267,546,62,23.7,0,Clear,18.2,2022-04-14 11:00:00,11
312,324,636,58,24.8,2,Partly Cloudy,17.0,2022-04-14 12:00:00,12
285,309,594,54,25.8,2,Partly Cloudy,18.9,2022-04-14 13:00:00,13
319,286,605,52,26.4,1,Mostly Clear,20.2,2022-04-14 14:00:00,14
331,328,659,41,27.4,2,Partly Cloudy,20.3,2022-04-14 15:00:00,15
242,318,560,49,24.4,3,Cloudy,24.5,2022-04-14 16:00:00,16
463,671,1134,54,21.3,3,Cloudy,23.4,2022-04-14 17:00:00,17
399,672,1071,51,19.1,51,Light Drizzle,18.1,2022-04-14 18:00:00,18
285,380,665,46,17.4,51,Light Drizzle,16.4,2022-04-14 19:00:00,19
170,306,476,43,16.6,1,Mostly Clear,9.1,2022-04-14 20:00:00,20
156,201,357,41,16.2,1,Mostly Clear,8.3,2022-04-14 21:00:00,21
153,187,340,41,15.6,1,Mostly Clear,7.9,2022-04-14 22:00:00,22
83,97,180,44,14.4,1,Mostly Clear,8.9,2022-04-14 23:00:00,23
38,59,97,52,13.1,0,Clear,7.9,2022-04-15 00:00:00,0
27,27,54,64,11.3,0,Clear,9.8,2022-04-15 01:00:00,1
11,19,30,70,9.8,0,Clear,9.0,2022-04-15 02:00:00,2
5,12,17,69,9.4,0,Clear,9.1,2022-04-15 03:00:00,3
6,14,20,71,8.5,0,Clear,9.8,2022-04-15 04:00:00,4
14,40,54,68,8.1,0,Clear,9.9,2022-04-15 05:00:00,5
34,103,137,65,8.0,0,Clear,9.5,2022-04-15 06:00:00,6
87,234,321,69,7.6,0,Clear,7.9,2022-04-15 07:00:00,7
151,375,526,72,9.9,0,Clear,6.8,2022-04-15 08:00:00,8
242,263,505,59,13.4,0,Clear,4.7,2022-04-15 09:00:00,9
422,277,699,34,15.8,0,Clear,5.0,2022-04-15 10:00:00,10
526,311,837,29,17.0,0,Clear,6.6,2022-04-15 11:00:00,11
575,402,977,29,18.0,0,Clear,8.4,2022-04-15 12:00:00,12
561,377,938,29,19.0,0,Clear,10.0,2022-04-15 13:00:00,13
609,398,1007,28,19.8,0,Clear,12.2,2022-04-15 14:00:00,14
652,443,1095,26,20.7,0,Clear,14.2,2022-04-15 15:00:00,15
679,581,1260,26,20.8,0,Clear,16.7,2022-04-15 16:00:00,16
699,600,1299,27,20.5,0,Clear,18.4,2022-04-15 17:00:00,17
565,554,1119,30,19.8,0,Clear,14.6,2022-04-15 18:00:00,18
422,398,820,34,18.3,0,Clear,14.2,2022-04-15 19:00:00,19
258,276,534,39,16.6,0,Clear,17.0,2022-04-15 20:00:00,20
207,180,387,41,15.5,0,Clear,19.8,2022-04-15 21:00:00,21
141,179,320,42,14.9,1,Mostly Clear,20.2,2022-04-15 22:00:00,22
132,142,274,45,14.4,1,Mostly Clear,20.4,2022-04-15 23:00:00,23
80,116,196,48,14.5,2,Partly Cloudy,21.0,2022-04-16 00:00:00,0
58,76,134,49,14.4,2,Partly Cloudy,21.1,2022-04-16 01:00:00,1
70,55,125,50,14.4,3,Cloudy,20.7,2022-04-16 02:00:00,2
17,34,51,47,15.0,3,Cloudy,20.1,2022-04-16 03:00:00,3
9,15,24,48,14.9,3,Cloudy,18.7,2022-04-16 04:00:00,4
6,18,24,50,14.7,3,Cloudy,17.8,2022-04-16 05:00:00,5
29,34,63,52,14.3,3,Cloudy,14.2,2022-04-16 06:00:00,6
54,117,171,55,14.0,2,Partly Cloudy,14.2,2022-04-16 07:00:00,7
129,188,317,58,14.1,2,Partly Cloudy,14.5,2022-04-16 08:00:00,8
301,322,623,57,15.0,1,Mostly Clear,14.2,2022-04-16 09:00:00,9
541,356,897,57,15.4,1,Mostly Clear,15.8,2022-04-16 10:00:00,10
689,405,1094,51,17.3,1,Mostly Clear,14.3,2022-04-16 11:00:00,11
846,423,1269,47,19.4,0,Clear,14.5,2022-04-16 12:00:00,12
938,427,1365,42,21.5,0,Clear,14.5,2022-04-16 13:00:00,13
898,489,1387,35,23.0,0,Clear,16.3,2022-04-16 14:00:00,14
892,454,1346,33,24.3,0,Clear,18.0,2022-04-16 15:00:00,15
873,446,1319,31,24.8,2,Partly Cloudy,19.5,2022-04-16 16:00:00,16
804,428,1232,33,24.5,2,Partly Cloudy,13.7,2022-04-16 17:00:00,17
410,323,733,37,23.5,51,Light Drizzle,9.9,2022-04-16 18:00:00,18
281,243,524,42,21.7,1,Mostly Clear,6.6,2022-04-16 19:00:00,19
171,173,344,48,19.5,51,Light Drizzle,9.8,2022-04-16 20:00:00,20
138,155,293,59,17.3,51,Light Drizzle,15.6,2022-04-16 21:00:00,21
226,182,408,72,15.3,51,Light Drizzle,11.2,2022-04-16 22:00:00,22
141,154,295,79,14.0,51,Light Drizzle,10.2,2022-04-16 23:00:00,23
99,100,199,82,12.9,51,Light Drizzle,9.7,2022-04-17 00:00:00,0
60,70,130,82,12.3,1,Mostly Clear,11.3,2022-04-17 01:00:00,1
41,38,79,82,11.5,0,Clear,13.2,2022-04-17 02:00:00,2
49,24,73,80,11.5,51,Light Drizzle,13.4,2022-04-17 03:00:00,3
8,6,14,75,11.1,0,Clear,10.2,2022-04-17 04:00:00,4
28,8,36,71,10.2,0,Clear,7.6,2022-04-17 05:00:00,5
40,35,75,68,9.3,0,Clear,10.3,2022-04-17 06:00:00,6
32,72,104,67,8.7,0,Clear,9.2,2022-04-17 07:00:00,7
119,132,251,59,9.2,0,Clear,12.7,2022-04-17 08:00:00,8
243,202,445,49,9.8,0,Clear,16.6,2022-04-17 09:00:00,9
393,301,694,45,10.3,0,Clear,18.5,2022-04-17 10:00:00,10
476,295,771,42,10.8,1,Mostly Clear,20.2,2022-04-17 11:00:00,11
507,383,890,41,11.4,1,Mostly Clear,20.8,2022-04-17 12:00:00,12
528,341,869,40,11.9,2,Partly Cloudy,19.4,2022-04-17 13:00:00,13
518,296,814,38,12.4,2,Partly Cloudy,18.3,2022-04-17 14:00:00,14
511,358,869,35,12.8,0,Clear,17.4,2022-04-17 15:00:00,15
499,318,817,34,12.9,0,Clear,16.8,2022-04-17 16:00:00,16
440,347,787,33,12.6,0,Clear,14.7,2022-04-17 17:00:00,17
380,283,663,33,12.1,0,Clear,10.9,2022-04-17 18:00:00,18
282,243,525,32,11.3,0,Clear,10.1,2022-04-17 19:00:00,19
123,186,309,40,10.1,0,Clear,8.2,2022-04-17 20:00:00,20
111,113,224,51,8.6,0,Clear,9.8,2022-04-17 21:00:00,21
88,85,173,62,7.1,1,Mostly Clear,13.0,2022-04-17 22:00:00,22
32,43,75,64,6.1,1,Mostly Clear,13.7,2022-04-17 23:00:00,23
13,44,57,64,5.6,1,Mostly Clear,10.9,2022-04-18 00:00:00,0
4,15,19,62,5.4,1,Mostly Clear,10.7,2022-04-18 01:00:00,1
3,12,15,59,5.5,1,Mostly Clear,10.3,2022-04-18 02:00:00,2
1,5,6,56,5.0,1,Mostly Clear,9.7,2022-04-18 03:00:00,3
5,20,25,59,4.6,1,Mostly Clear,9.6,2022-04-18 04:00:00,4
11,51,62,58,4.7,1,Mostly Clear,9.9,2022-04-18 05:00:00,5
26,123,149,57,4.8,1,Mostly Clear,8.2,2022-04-18 06:00:00,6
66,267,333,60,5.0,1,Mostly Clear,8.0,2022-04-18 07:00:00,7
123,388,511,57,6.5,3,Cloudy,9.4,2022-04-18 08:00:00,8
75,195,270,52,7.8,3,Cloudy,10.4,2022-04-18 09:00:00,9
105,132,237,52,8.5,3,Cloudy,15.5,2022-04-18 10:00:00,10
89,131,220,55,8.5,51,Light Drizzle,16.4,2022-04-18 11:00:00,11
74,141,215,58,8.7,51,Light Drizzle,16.9,2022-04-18 12:00:00,12
31,107,138,66,8.4,53,Heavy Drizzle,17.7,2022-04-18 13:00:00,13
38,82,120,80,7.7,55,Heavy Drizzle,15.8,2022-04-18 14:00:00,14
35,76,111,89,7.5,61,Light Rain,13.9,2022-04-18 15:00:00,15
33,87,120,91,7.5,61,Light Rain,13.4,2022-04-18 16:00:00,16
63,237,300,93,7.4,61,Light Rain,15.8,2022-04-18 17:00:00,17
71,247,318,92,7.4,61,Light Rain,18.6,2022-04-18 18:00:00,18
20,60,80,93,7.3,53,Heavy Drizzle,16.7,2022-04-18 19:00:00,19
11,50,61,92,7.3,53,Heavy Drizzle,10.2,2022-04-18 20:00:00,20
6,43,49,94,7.3,53,Heavy Drizzle,13.0,2022-04-18 21:00:00,21
14,28,42,96,6.8,55,Heavy Drizzle,18.9,2022-04-18 22:00:00,22
3,24,27,97,5.5,61,Light Rain,21.2,2022-04-18 23:00:00,23
2,12,14,96,4.3,51,Light Drizzle,20.8,2022-04-19 00:00:00,0
0,8,8,95,4.2,55,Heavy Drizzle,21.2,2022-04-19 01:00:00,1
1,3,4,94,4.2,51,Light Drizzle,19.5,2022-04-19 02:00:00,2
1,3,4,92,4.6,2,Partly Cloudy,19.3,2022-04-19 03:00:00,3
4,15,19,87,4.5,0,Clear,17.9,2022-04-19 04:00:00,4
10,47,57,85,4.2,0,Clear,17.4,2022-04-19 05:00:00,5
24,147,171,85,3.7,2,Partly Cloudy,15.1,2022-04-19 06:00:00,6
87,353,440,84,3.6,1,Mostly Clear,14.8,2022-04-19 07:00:00,7
158,539,697,81,4.7,1,Mostly Clear,13.0,2022-04-19 08:00:00,8
144,327,471,67,6.2,51,Light Drizzle,17.5,2022-04-19 09:00:00,9
119,188,307,58,7.1,51,Light Drizzle,21.3,2022-04-19 10:00:00,10
141,185,326,51,8.2,51,Light Drizzle,24.0,2022-04-19 11:00:00,11
159,254,413,44,9.0,51,Light Drizzle,25.8,2022-04-19 12:00:00,12
134,264,398,40,9.8,51,Light Drizzle,26.4,2022-04-19 13:00:00,13
121,203,324,37,10.6,51,Light Drizzle,27.2,2022-04-19 14:00:00,14
219,312,531,36,10.8,51,Light Drizzle,27.7,2022-04-19 15:00:00,15
215,384,599,36,10.8,51,Light Drizzle,27.6,2022-04-19 16:00:00,16
304,696,1000,35,10.8,1,Mostly Clear,25.0,2022-04-19 17:00:00,17
280,561,841,34,11.0,1,Mostly Clear,22.2,2022-04-19 18:00:00,18
146,439,585,37,10.3,0,Clear,17.4,2022-04-19 19:00:00,19
115,247,362,40,9.2,0,Clear,16.3,2022-04-19 20:00:00,20
93,206,299,44,8.3,0,Clear,14.8,2022-04-19 21:00:00,21
66,127,193,49,7.5,0,Clear,14.0,2022-04-19 22:00:00,22
58,60,118,53,6.9,0,Clear,14.0,2022-04-19 23:00:00,23
20,30,50,57,6.2,0,Clear,13.7,2022-04-20 00:00:00,0
3,8,11,61,5.5,0,Clear,12.6,2022-04-20 01:00:00,1
6,1,7,66,4.8,0,Clear,11.5,2022-04-20 02:00:00,2
2,3,5,69,4.4,0,Clear,11.2,2022-04-20 03:00:00,3
3,11,14,71,4.0,0,Clear,11.5,2022-04-20 04:00:00,4
10,39,49,73,3.6,0,Clear,11.6,2022-04-20 05:00:00,5
40,151,191,75,3.2,0,Clear,9.0,2022-04-20 06:00:00,6
92,357,449,78,3.1,0,Clear,9.4,2022-04-20 07:00:00,7
165,654,819,72,5.0,0,Clear,7.9,2022-04-20 08:00:00,8
168,347,515,59,7.3,0,Clear,8.9,2022-04-20 09:00:00,9
198,227,425,52,8.7,0,Clear,10.8,2022-04-20 10:00:00,10
240,215,455,47,10.2,0,Clear,9.3,2022-04-20 11:00:00,11
211,300,511,44,11.6,0,Clear,8.5,2022-04-20 12:00:00,12
263,263,526,41,12.8,0,Clear,8.3,2022-04-20 13:00:00,13
303,264,567,39,13.8,0,Clear,7.6,2022-04-20 14:00:00,14
316,375,691,37,15.0,0,Clear,6.5,2022-04-20 15:00:00,15
330,492,822,36,15.5,0,Clear,6.3,2022-04-20 16:00:00,16
498,820,1318,36,15.6,0,Clear,6.0,2022-04-20 17:00:00,17
441,791,1232,36,15.3,0,Clear,5.3,2022-04-20 18:00:00,18
308,534,842,44,14.3,0,Clear,3.5,2022-04-20 19:00:00,19
199,306,505,52,12.5,0,Clear,6.7,2022-04-20 20:00:00,20
146,266,412,57,10.5,0,Clear,8.9,2022-04-20 21:00:00,21
93,199,292,63,9.4,0,Clear,10.6,2022-04-20 22:00:00,22
53,78,131,67,8.8,0,Clear,12.3,2022-04-20 23:00:00,23
14,35,49,70,8.3,1,Mostly Clear,12.8,2022-04-21 00:00:00,0
11,13,24,72,8.0,1,Mostly Clear,12.6,2022-04-21 01:00:00,1
2,9,11,74,7.8,1,Mostly Clear,12.2,2022-04-21 02:00:00,2
4,14,18,74,8.3,1,Mostly Clear,11.6,2022-04-21 03:00:00,3
2,14,16,76,8.0,1,Mostly Clear,11.7,2022-04-21 04:00:00,4
18,44,62,78,7.7,1,Mostly Clear,12.1,2022-04-21 05:00:00,5
32,140,172,80,7.4,1,Mostly Clear,12.2,2022-04-21 06:00:00,6
88,352,440,81,7.2,1,Mostly Clear,13.1,2022-04-21 07:00:00,7
213,615,828,76,8.7,1,Mostly Clear,12.6,2022-04-21 08:00:00,8
174,348,522,67,10.8,1,Mostly Clear,15.8,2022-04-21 09:00:00,9
198,215,413,60,12.8,2,Partly Cloudy,17.3,2022-04-21 10:00:00,10
208,230,438,54,14.7,2,Partly Cloudy,16.2,2022-04-21 11:00:00,11
234,284,518,51,15.8,1,Mostly Clear,17.3,2022-04-21 12:00:00,12
277,306,583,50,16.6,3,Cloudy,17.5,2022-04-21 13:00:00,13
264,257,521,49,17.4,3,Cloudy,16.6,2022-04-21 14:00:00,14
301,340,641,50,18.2,3,Cloudy,15.3,2022-04-21 15:00:00,15
357,480,837,51,18.3,3,Cloudy,13.4,2022-04-21 16:00:00,16
425,753,1178,52,18.3,2,Partly Cloudy,11.1,2022-04-21 17:00:00,17
395,645,1040,58,17.4,2,Partly Cloudy,9.2,2022-04-21 18:00:00,18
313,497,810,63,16.7,3,Cloudy,8.4,2022-04-21 19:00:00,19
223,355,578,68,15.7,3,Cloudy,7.0,2022-04-21 20:00:00,20
153,280,433,72,15.0,3,Cloudy,7.3,2022-04-21 21:00:00,21
174,220,394,74,14.9,3,Cloudy,8.1,2022-04-21 22:00:00,22
100,125,225,77,14.7,3,Cloudy,8.1,2022-04-21 23:00:00,23
35,55,90,81,14.3,3,Cloudy,7.0,2022-04-22 00:00:00,0
31,35,66,83,14.1,3,Cloudy,7.2,2022-04-22 01:00:00,1
22,20,42,85,14.0,3,Cloudy,6.0,2022-04-22 02:00:00,2
3,17,20,86,13.3,0,Clear,5.0,2022-04-22 03:00:00,3
8,11,19,90,12.3,0,Clear,5.7,2022-04-22 04:00:00,4
14,45,59,93,11.0,0,Clear,6.4,2022-04-22 05:00:00,5
42,138,180,94,10.4,0,Clear,8.0,2022-04-22 06:00:00,6
102,308,410,94,10.1,0,Clear,10.0,2022-04-22 07:00:00,7
187,482,669,87,13.3,0,Clear,10.1,2022-04-22 08:00:00,8
220,351,571,76,16.8,0,Clear,8.1,2022-04-22 09:00:00,9
244,222,466,65,18.2,1,Mostly Clear,9.5,2022-04-22 10:00:00,10
313,302,615,52,19.7,0,Clear,9.8,2022-04-22 11:00:00,11
354,355,709,43,20.8,0,Clear,13.1,2022-04-22 12:00:00,12
402,365,767,38,21.6,0,Clear,14.5,2022-04-22 13:00:00,13
421,374,795,35,22.0,1,Mostly Clear,12.3,2022-04-22 14:00:00,14
509,461,970,32,22.9,1,Mostly Clear,11.1,2022-04-22 15:00:00,15
582,578,1160,32,22.8,1,Mostly Clear,10.7,2022-04-22 16:00:00,16
607,750,1357,33,22.3,1,Mostly Clear,9.9,2022-04-22 17:00:00,17
571,645,1216,40,21.3,1,Mostly Clear,5.9,2022-04-22 18:00:00,18
401,481,882,48,19.6,1,Mostly Clear,5.2,2022-04-22 19:00:00,19
264,320,584,54,17.8,1,Mostly Clear,7.2,2022-04-22 20:00:00,20
219,245,464,59,16.1,1,Mostly Clear,8.5,2022-04-22 21:00:00,21
213,221,434,63,15.0,0,Clear,8.4,2022-04-22 22:00:00,22
184,186,370,66,14.1,2,Partly Cloudy,7.2,2022-04-22 23:00:00,23
116,133,249,70,13.3,3,Cloudy,7.2,2022-04-23 00:00:00,0
93,106,199,73,12.5,2,Partly Cloudy,6.5,2022-04-23 01:00:00,1
56,61,117,75,11.9,1,Mostly Clear,6.3,2022-04-23 02:00:00,2
19,29,48,73,11.5,0,Clear,6.1,2022-04-23 03:00:00,3
11,16,27,76,10.7,0,Clear,6.4,2022-04-23 04:00:00,4
17,14,31,79,10.1,0,Clear,6.9,2022-04-23 05:00:00,5
33,71,104,83,9.3,0,Clear,6.2,2022-04-23 06:00:00,6
57,134,191,85,9.5,1,Mostly Clear,9.2,2022-04-23 07:00:00,7
133,216,349,75,12.9,2,Partly Cloudy,10.1,2022-04-23 08:00:00,8
325,291,616,65,15.4,2,Partly Cloudy,9.7,2022-04-23 09:00:00,9
438,364,802,59,16.8,1,Mostly Clear,11.2,2022-04-23 10:00:00,10
528,449,977,56,17.6,1,Mostly Clear,11.6,2022-04-23 11:00:00,11
621,514,1135,54,18.4,1,Mostly Clear,10.9,2022-04-23 12:00:00,12
697,481,1178,53,19.4,1,Mostly Clear,10.9,2022-04-23 13:00:00,13
691,467,1158,52,20.7,0,Clear,11.0,2022-04-23 14:00:00,14
740,450,1190,50,23.3,0,Clear,10.5,2022-04-23 15:00:00,15
729,519,1248,51,23.9,1,Mostly Clear,9.7,2022-04-23 16:00:00,16
746,506,1252,52,23.9,2,Partly Cloudy,9.0,2022-04-23 17:00:00,17
620,471,1091,56,22.5,0,Clear,12.0,2022-04-23 18:00:00,18
485,426,911,57,20.2,0,Clear,14.9,2022-04-23 19:00:00,19
329,293,622,58,17.9,0,Clear,13.4,2022-04-23 20:00:00,20
309,238,547,59,16.5,0,Clear,12.3,2022-04-23 21:00:00,21
254,223,477,64,15.6,0,Clear,11.5,2022-04-23 22:00:00,22
189,194,383,70,14.8,0,Clear,11.1,2022-04-23 23:00:00,23
148,116,264,77,14.3,0,Clear,9.9,2022-04-24 00:00:00,0
122,110,232,84,13.8,0,Clear,8.7,2022-04-24 01:00:00,1
72,43,115,90,13.2,0,Clear,7.2,2022-04-24 02:00:00,2
38,32,70,90,12.5,0,Clear,6.0,2022-04-24 03:00:00,3
13,9,22,90,12.6,0,Clear,6.4,2022-04-24 04:00:00,4
12,13,25,86,14.2,0,Clear,4.0,2022-04-24 05:00:00,5
20,39,59,87,14.3,0,Clear,5.7,2022-04-24 06:00:00,6
48,84,132,94,12.4,0,Clear,7.5,2022-04-24 07:00:00,7
120,174,294,89,15.3,0,Clear,5.4,2022-04-24 08:00:00,8
280,278,558,79,18.2,0,Clear,5.2,2022-04-24 09:00:00,9
454,388,842,73,20.3,0,Clear,5.0,2022-04-24 10:00:00,10
596,471,1067,69,22.2,0,Clear,5.4,2022-04-24 11:00:00,11
687,519,1206,64,23.9,0,Clear,5.6,2022-04-24 12:00:00,12
694,515,1209,60,25.3,0,Clear,7.3,2022-04-24 13:00:00,13
749,517,1266,58,26.2,0,Clear,9.0,2022-04-24 14:00:00,14
673,449,1122,54,25.5,0,Clear,9.6,2022-04-24 15:00:00,15
638,424,1062,54,25.5,0,Clear,10.7,2022-04-24 16:00:00,16
609,499,1108,55,25.1,0,Clear,12.0,2022-04-24 17:00:00,17
558,453,1011,59,24.0,0,Clear,13.0,2022-04-24 18:00:00,18
418,343,761,64,22.3,0,Clear,14.1,2022-04-24 19:00:00,19
239,258,497,68,20.0,0,Clear,17.7,2022-04-24 20:00:00,20
164,146,310,69,18.0,0,Clear,17.7,2022-04-24 21:00:00,21
159,143,302,70,16.5,0,Clear,15.3,2022-04-24 22:00:00,22
67,59,126,72,15.5,0,Clear,13.2,2022-04-24 23:00:00,23
36,42,78,76,14.5,0,Clear,11.7,2022-04-25 00:00:00,0
12,19,31,79,13.8,0,Clear,11.8,2022-04-25 01:00:00,1
11,20,31,83,13.2,0,Clear,10.6,2022-04-25 02:00:00,2
4,4,8,85,12.3,0,Clear,10.1,2022-04-25 03:00:00,3
8,18,26,88,12.0,0,Clear,10.1,2022-04-25 04:00:00,4
17,50,67,91,11.6,1,Mostly Clear,9.2,2022-04-25 05:00:00,5
32,171,203,93,11.4,3,Cloudy,11.0,2022-04-25 06:00:00,6
82,345,427,93,11.5,3,Cloudy,9.5,2022-04-25 07:00:00,7
205,536,741,87,13.2,3,Cloudy,9.7,2022-04-25 08:00:00,8
156,302,458,81,15.4,3,Cloudy,9.5,2022-04-25 09:00:00,9
164,199,363,75,17.5,3,Cloudy,9.4,2022-04-25 10:00:00,10
212,243,455,70,19.4,3,Cloudy,10.2,2022-04-25 11:00:00,11
207,300,507,66,21.1,3,Cloudy,12.1,2022-04-25 12:00:00,12
245,266,511,63,22.3,1,Mostly Clear,13.0,2022-04-25 13:00:00,13
243,284,527,61,23.1,1,Mostly Clear,13.3,2022-04-25 14:00:00,14
275,332,607,63,21.7,1,Mostly Clear,12.7,2022-04-25 15:00:00,15
335,514,849,62,22.0,1,Mostly Clear,14.4,2022-04-25 16:00:00,16
446,749,1195,64,21.4,1,Mostly Clear,16.7,2022-04-25 17:00:00,17
440,692,1132,68,20.2,2,Partly Cloudy,14.1,2022-04-25 18:00:00,18
366,498,864,72,18.8,1,Mostly Clear,14.2,2022-04-25 19:00:00,19
192,347,539,77,17.3,0,Clear,13.6,2022-04-25 20:00:00,20
138,248,386,82,16.0,1,Mostly Clear,12.8,2022-04-25 21:00:00,21
81,125,206,86,15.4,1,Mostly Clear,10.9,2022-04-25 22:00:00,22
55,74,129,91,15.0,1,Mostly Clear,9.9,2022-04-25 23:00:00,23
19,32,51,95,14.7,1,Mostly Clear,10.1,2022-04-26 00:00:00,0
6,11,17,98,14.3,1,Mostly Clear,9.4,2022-04-26 01:00:00,1
5,9,14,98,13.9,1,Mostly Clear,6.3,2022-04-26 02:00:00,2
3,2,5,98,13.4,1,Mostly Clear,5.8,2022-04-26 03:00:00,3
4,17,21,98,13.2,1,Mostly Clear,6.4,2022-04-26 04:00:00,4
12,74,86,99,12.9,1,Mostly Clear,6.4,2022-04-26 05:00:00,5
49,176,225,100,12.8,3,Cloudy,7.3,2022-04-26 06:00:00,6
108,442,550,99,13.0,3,Cloudy,7.9,2022-04-26 07:00:00,7
230,687,917,91,14.9,3,Cloudy,7.3,2022-04-26 08:00:00,8
188,380,568,82,17.1,3,Cloudy,5.4,2022-04-26 09:00:00,9
201,236,437,72,19.7,3,Cloudy,6.4,2022-04-26 10:00:00,10
172,234,406,67,21.7,3,Cloudy,7.6,2022-04-26 11:00:00,11
192,334,526,64,23.0,3,Cloudy,9.3,2022-04-26 12:00:00,12
187,305,492,60,24.1,51,Light Drizzle,11.6,2022-04-26 13:00:00,13
161,196,357,66,23.0,53,Heavy Drizzle,11.4,2022-04-26 14:00:00,14
123,242,365,81,19.6,53,Heavy Drizzle,12.0,2022-04-26 15:00:00,15
114,282,396,83,18.4,53,Heavy Drizzle,10.9,2022-04-26 16:00:00,16
202,508,710,80,17.9,51,Light Drizzle,9.3,2022-04-26 17:00:00,17
214,494,708,78,17.5,51,Light Drizzle,4.2,2022-04-26 18:00:00,18
119,309,428,78,17.0,51,Light Drizzle,3.5,2022-04-26 19:00:00,19
75,225,300,79,16.6,3,Cloudy,4.9,2022-04-26 20:00:00,20
99,187,286,83,16.0,2,Partly Cloudy,9.6,2022-04-26 21:00:00,21
112,143,255,86,15.2,2,Partly Cloudy,9.0,2022-04-26 22:00:00,22
55,91,146,83,14.0,2,Partly Cloudy,12.9,2022-04-26 23:00:00,23
22,38,60,75,13.0,1,Mostly Clear,15.5,2022-04-27 00:00:00,0
10,6,16,70,12.1,0,Clear,14.2,2022-04-27 01:00:00,1
10,3,13,66,11.2,0,Clear,13.4,2022-04-27 02:00:00,2
1,2,3,76,10.2,1,Mostly Clear,13.0,2022-04-27 03:00:00,3
8,17,25,71,9.8,2,Partly Cloudy,13.2,2022-04-27 04:00:00,4
15,52,67,65,9.3,1,Mostly Clear,14.0,2022-04-27 05:00:00,5
42,171,213,59,8.9,1,Mostly Clear,14.5,2022-04-27 06:00:00,6
97,398,495,55,8.7,0,Clear,12.2,2022-04-27 07:00:00,7
208,677,885,48,8.9,0,Clear,12.2,2022-04-27 08:00:00,8
156,390,546,43,9.9,0,Clear,16.5,2022-04-27 09:00:00,9
150,218,368,41,11.2,1,Mostly Clear,22.9,2022-04-27 10:00:00,10
172,231,403,41,12.2,3,Cloudy,22.2,2022-04-27 11:00:00,11
185,302,487,41,13.0,3,Cloudy,21.9,2022-04-27 12:00:00,12
168,286,454,39,13.2,3,Cloudy,22.5,2022-04-27 13:00:00,13
195,280,475,37,13.8,2,Partly Cloudy,23.3,2022-04-27 14:00:00,14
194,366,560,37,14.4,2,Partly Cloudy,24.5,2022-04-27 15:00:00,15
306,449,755,36,14.4,2,Partly Cloudy,23.2,2022-04-27 16:00:00,16
436,769,1205,35,14.2,1,Mostly Clear,22.7,2022-04-27 17:00:00,17
425,703,1128,36,13.4,1,Mostly Clear,17.4,2022-04-27 18:00:00,18
274,544,818,38,12.1,0,Clear,16.7,2022-04-27 19:00:00,19
203,300,503,41,10.7,0,Clear,18.4,2022-04-27 20:00:00,20
134,268,402,42,9.4,0,Clear,18.2,2022-04-27 21:00:00,21
91,150,241,45,8.4,0,Clear,16.9,2022-04-27 22:00:00,22
46,83,129,46,7.5,0,Clear,15.5,2022-04-27 23:00:00,23
21,29,50,47,6.7,1,Mostly Clear,16.8,2022-04-28 00:00:00,0
7,16,23,46,6.1,0,Clear,18.2,2022-04-28 01:00:00,1
10,8,18,46,5.3,0,Clear,18.2,2022-04-28 02:00:00,2
1,4,5,48,4.2,0,Clear,16.5,2022-04-28 03:00:00,3
2,15,17,48,3.6,0,Clear,15.2,2022-04-28 04:00:00,4
10,38,48,51,3.1,0,Clear,13.8,2022-04-28 05:00:00,5
29,130,159,53,2.7,0,Clear,13.0,2022-04-28 06:00:00,6
80,358,438,56,2.6,0,Clear,13.7,2022-04-28 07:00:00,7
168,518,686,53,3.4,1,Mostly Clear,20.3,2022-04-28 08:00:00,8
130,316,446,50,4.7,1,Mostly Clear,20.4,2022-04-28 09:00:00,9
131,204,335,47,6.3,0,Clear,18.9,2022-04-28 10:00:00,10
147,206,353,44,8.0,0,Clear,17.7,2022-04-28 11:00:00,11
169,293,462,39,9.9,0,Clear,17.6,2022-04-28 12:00:00,12
206,281,487,35,11.6,0,Clear,18.1,2022-04-28 13:00:00,13
201,276,477,32,13.0,0,Clear,18.6,2022-04-28 14:00:00,14
223,343,566,30,13.9,0,Clear,18.4,2022-04-28 15:00:00,15
314,464,778,29,14.5,0,Clear,17.9,2022-04-28 16:00:00,16
401,793,1194,29,14.6,0,Clear,17.9,2022-04-28 17:00:00,17
425,726,1151,29,14.3,0,Clear,13.8,2022-04-28 18:00:00,18
297,496,793,33,13.5,0,Clear,10.3,2022-04-28 19:00:00,19
176,341,517,38,11.9,1,Mostly Clear,9.3,2022-04-28 20:00:00,20
155,241,396,41,10.6,0,Clear,10.5,2022-04-28 21:00:00,21
134,182,316,44,9.6,0,Clear,11.8,2022-04-28 22:00:00,22
75,108,183,46,8.7,0,Clear,13.0,2022-04-28 23:00:00,23
50,42,92,49,7.8,0,Clear,14.8,2022-04-29 00:00:00,0
18,44,62,51,7.0,0,Clear,15.1,2022-04-29 01:00:00,1
18,14,32,53,6.0,0,Clear,14.0,2022-04-29 02:00:00,2
7,16,23,47,5.9,0,Clear,12.1,2022-04-29 03:00:00,3
7,20,27,51,5.0,0,Clear,9.8,2022-04-29 04:00:00,4
15,41,56,57,3.9,0,Clear,9.0,2022-04-29 05:00:00,5
39,127,166,64,3.0,1,Mostly Clear,7.7,2022-04-29 06:00:00,6
84,282,366,67,3.0,1,Mostly Clear,9.2,2022-04-29 07:00:00,7
159,460,619,51,6.1,0,Clear,8.0,2022-04-29 08:00:00,8
168,305,473,42,8.2,0,Clear,7.9,2022-04-29 09:00:00,9
207,252,459,37,10.3,0,Clear,7.7,2022-04-29 10:00:00,10
288,271,559,32,12.1,0,Clear,9.2,2022-04-29 11:00:00,11
275,313,588,29,13.7,0,Clear,10.4,2022-04-29 12:00:00,12
316,343,659,27,15.2,0,Clear,11.2,2022-04-29 13:00:00,13
342,384,726,26,16.3,0,Clear,11.8,2022-04-29 14:00:00,14
408,447,855,24,17.6,0,Clear,12.8,2022-04-29 15:00:00,15
429,520,949,23,18.1,0,Clear,13.5,2022-04-29 16:00:00,16
586,658,1244,23,18.1,0,Clear,13.5,2022-04-29 17:00:00,17
497,595,1092,25,17.7,0,Clear,9.2,2022-04-29 18:00:00,18
430,472,902,32,16.5,0,Clear,3.8,2022-04-29 19:00:00,19
258,300,558,43,14.6,0,Clear,4.2,2022-04-29 20:00:00,20
201,169,370,48,12.2,0,Clear,1.8,2022-04-29 21:00:00,21
179,193,372,58,10.2,0,Clear,2.1,2022-04-29 22:00:00,22
125,127,252,65,8.7,0,Clear,1.0,2022-04-29 23:00:00,23
104,84,188,69,7.7,0,Clear,4.7,2022-04-30 00:00:00,0
78,81,159,70,6.8,0,Clear,6.4,2022-04-30 01:00:00,1
67,41,108,64,7.0,0,Clear,7.9,2022-04-30 02:00:00,2
17,18,35,65,6.8,0,Clear,14.0,2022-04-30 03:00:00,3
11,7,18,55,6.7,0,Clear,14.2,2022-04-30 04:00:00,4
10,20,30,52,6.1,0,Clear,12.0,2022-04-30 05:00:00,5
27,55,82,58,5.3,0,Clear,8.8,2022-04-30 06:00:00,6
47,87,134,70,4.8,0,Clear,7.4,2022-04-30 07:00:00,7
137,144,281,52,8.4,0,Clear,5.2,2022-04-30 08:00:00,8
250,295,545,42,10.9,0,Clear,5.4,2022-04-30 09:00:00,9
459,409,868,35,13.0,0,Clear,7.0,2022-04-30 10:00:00,10
530,392,922,32,14.9,0,Clear,4.7,2022-04-30 11:00:00,11
615,439,1054,30,16.5,1,Mostly Clear,2.7,2022-04-30 12:00:00,12
693,458,1151,30,17.9,1,Mostly Clear,2.5,2022-04-30 13:00:00,13
727,474,1201,30,19.1,1,Mostly Clear,2.8,2022-04-30 14:00:00,14
742,476,1218,28,19.7,1,Mostly Clear,3.0,2022-04-30 15:00:00,15
709,531,1240,27,20.2,1,Mostly Clear,4.0,2022-04-30 16:00:00,16
573,518,1091,27,20.3,1,Mostly Clear,3.3,2022-04-30 17:00:00,17
562,428,990,28,20.0,1,Mostly Clear,2.2,2022-04-30 18:00:00,18
410,398,808,37,18.7,1,Mostly Clear,2.7,2022-04-30 19:00:00,19
312,288,600,45,16.2,1,Mostly Clear,5.3,2022-04-30 20:00:00,20
238,206,444,50,13.9,0,Clear,8.4,2022-04-30 21:00:00,21
192,211,403,54,12.7,1,Mostly Clear,10.0,2022-04-30 22:00:00,22
244,199,443,58,11.8,0,Clear,9.7,2022-04-30 23:00:00,23
137,119,256,66,11.1,1,Mostly Clear,8.3,2022-05-01 00:00:00,0
68,85,153,75,10.5,1,Mostly Clear,8.0,2022-05-01 01:00:00,1
66,61,127,84,9.9,1,Mostly Clear,7.1,2022-05-01 02:00:00,2
42,24,66,82,9.8,1,Mostly Clear,7.2,2022-05-01 03:00:00,3
6,8,14,89,8.5,1,Mostly Clear,5.7,2022-05-01 04:00:00,4
21,23,44,92,7.9,1,Mostly Clear,6.2,2022-05-01 05:00:00,5
61,59,120,94,8.0,1,Mostly Clear,5.6,2022-05-01 06:00:00,6
67,98,165,95,8.5,1,Mostly Clear,7.6,2022-05-01 07:00:00,7
152,186,338,84,11.9,0,Clear,5.2,2022-05-01 08:00:00,8
225,271,496,73,14.2,2,Partly Cloudy,6.0,2022-05-01 09:00:00,9
378,343,721,66,15.7,2,Partly Cloudy,9.4,2022-05-01 10:00:00,10
384,408,792,60,17.4,51,Light Drizzle,10.9,2022-05-01 11:00:00,11
474,455,929,61,17.9,51,Light Drizzle,11.3,2022-05-01 12:00:00,12
484,394,878,65,18.1,53,Heavy Drizzle,10.9,2022-05-01 13:00:00,13
144,163,307,72,17.6,53,Heavy Drizzle,11.5,2022-05-01 14:00:00,14
118,183,301,77,17.8,61,Light Rain,11.9,2022-05-01 15:00:00,15
176,225,401,81,17.1,53,Heavy Drizzle,12.6,2022-05-01 16:00:00,16
230,255,485,81,16.5,51,Light Drizzle,12.9,2022-05-01 17:00:00,17
194,282,476,81,16.1,1,Mostly Clear,10.2,2022-05-01 18:00:00,18
165,285,450,83,15.4,53,Heavy Drizzle,9.1,2022-05-01 19:00:00,19
140,161,301,87,14.5,2,Partly Cloudy,9.0,2022-05-01 20:00:00,20
91,110,201,89,14.1,2,Partly Cloudy,8.6,2022-05-01 21:00:00,21
83,103,186,91,13.9,2,Partly Cloudy,10.5,2022-05-01 22:00:00,22
126,54,180,92,13.8,2,Partly Cloudy,10.5,2022-05-01 23:00:00,23
49,43,92,96,13.4,3,Cloudy,8.6,2022-05-02 00:00:00,0
18,12,30,97,13.3,2,Partly Cloudy,5.8,2022-05-02 01:00:00,1
5,8,13,97,13.5,2,Partly Cloudy,4.8,2022-05-02 02:00:00,2
9,9,18,98,13.8,3,Cloudy,5.2,2022-05-02 03:00:00,3
7,11,18,98,14.2,3,Cloudy,8.9,2022-05-02 04:00:00,4
27,36,63,99,14.2,3,Cloudy,6.8,2022-05-02 05:00:00,5
47,144,191,100,13.6,3,Cloudy,4.1,2022-05-02 06:00:00,6
95,334,429,100,13.7,3,Cloudy,3.6,2022-05-02 07:00:00,7
187,526,713,95,15.6,3,Cloudy,4.1,2022-05-02 08:00:00,8
191,312,503,88,17.2,3,Cloudy,3.4,2022-05-02 09:00:00,9
219,203,422,79,18.9,3,Cloudy,5.2,2022-05-02 10:00:00,10
240,241,481,68,20.8,2,Partly Cloudy,4.7,2022-05-02 11:00:00,11
267,320,587,56,22.7,0,Clear,3.1,2022-05-02 12:00:00,12
279,281,560,44,24.1,1,Mostly Clear,3.4,2022-05-02 13:00:00,13
296,313,609,38,25.3,1,Mostly Clear,7.6,2022-05-02 14:00:00,14
330,389,719,43,25.1,1,Mostly Clear,7.2,2022-05-02 15:00:00,15
405,507,912,38,25.9,1,Mostly Clear,7.8,2022-05-02 16:00:00,16
493,759,1252,37,25.9,1,Mostly Clear,7.4,2022-05-02 17:00:00,17
495,710,1205,40,25.5,0,Clear,3.8,2022-05-02 18:00:00,18
432,531,963,44,24.3,0,Clear,3.4,2022-05-02 19:00:00,19
240,364,604,58,21.6,0,Clear,7.2,2022-05-02 20:00:00,20
197,270,467,71,18.7,0,Clear,7.2,2022-05-02 21:00:00,21
144,151,295,76,16.8,0,Clear,5.6,2022-05-02 22:00:00,22
87,108,195,76,15.8,0,Clear,6.0,2022-05-02 23:00:00,23
40,49,89,76,15.2,0,Clear,5.1,2022-05-03 00:00:00,0
48,21,69,76,14.6,1,Mostly Clear,8.3,2022-05-03 01:00:00,1
10,14,24,77,13.9,1,Mostly Clear,10.6,2022-05-03 02:00:00,2
6,5,11,83,14.5,1,Mostly Clear,12.0,2022-05-03 03:00:00,3
4,11,15,84,14.2,1,Mostly Clear,12.5,2022-05-03 04:00:00,4
28,64,92,89,13.8,0,Clear,11.5,2022-05-03 05:00:00,5
52,160,212,94,13.3,3,Cloudy,8.2,2022-05-03 06:00:00,6
123,382,505,96,13.4,3,Cloudy,10.0,2022-05-03 07:00:00,7
244,631,875,93,14.2,3,Cloudy,10.2,2022-05-03 08:00:00,8
168,400,568,89,14.9,3,Cloudy,9.8,2022-05-03 09:00:00,9
181,209,390,81,16.5,3,Cloudy,9.4,2022-05-03 10:00:00,10
178,227,405,77,17.5,3,Cloudy,10.2,2022-05-03 11:00:00,11
207,300,507,69,19.6,3,Cloudy,12.2,2022-05-03 12:00:00,12
239,281,520,64,21.5,3,Cloudy,12.9,2022-05-03 13:00:00,13
259,276,535,61,22.4,3,Cloudy,12.7,2022-05-03 14:00:00,14
281,348,629,64,21.8,3,Cloudy,13.8,2022-05-03 15:00:00,15
371,495,866,63,21.8,2,Partly Cloudy,15.4,2022-05-03 16:00:00,16
562,900,1462,64,21.8,1,Mostly Clear,16.6,2022-05-03 17:00:00,17
531,814,1345,66,21.1,2,Partly Cloudy,13.5,2022-05-03 18:00:00,18
430,631,1061,72,19.9,2,Partly Cloudy,13.5,2022-05-03 19:00:00,19
275,434,709,76,18.7,2,Partly Cloudy,16.0,2022-05-03 20:00:00,20
180,285,465,78,17.3,2,Partly Cloudy,18.8,2022-05-03 21:00:00,21
132,176,308,78,16.1,2,Partly Cloudy,17.4,2022-05-03 22:00:00,22
50,97,147,80,15.3,2,Partly Cloudy,14.3,2022-05-03 23:00:00,23
45,30,75,83,14.9,3,Cloudy,10.1,2022-05-04 00:00:00,0
2,5,7,85,14.7,3,Cloudy,9.0,2022-05-04 01:00:00,1
1,4,5,88,14.6,3,Cloudy,8.7,2022-05-04 02:00:00,2
1,6,7,93,12.9,61,Light Rain,10.1,2022-05-04 03:00:00,3
2,5,7,96,12.6,53,Heavy Drizzle,10.4,2022-05-04 04:00:00,4
7,45,52,97,12.4,51,Light Drizzle,10.5,2022-05-04 05:00:00,5
50,156,206,97,12.5,3,Cloudy,8.3,2022-05-04 06:00:00,6
78,348,426,97,12.7,3,Cloudy,4.8,2022-05-04 07:00:00,7
190,648,838,96,13.7,3,Cloudy,4.6,2022-05-04 08:00:00,8
156,361,517,92,15.3,3,Cloudy,7.9,2022-05-04 09:00:00,9
173,211,384,88,17.6,3,Cloudy,7.6,2022-05-04 10:00:00,10
168,256,424,84,19.8,3,Cloudy,7.9,2022-05-04 11:00:00,11
185,272,457,76,22.0,3,Cloudy,7.7,2022-05-04 12:00:00,12
213,275,488,66,24.4,3,Cloudy,6.9,2022-05-04 13:00:00,13
226,280,506,61,25.6,2,Partly Cloudy,5.6,2022-05-04 14:00:00,14
307,371,678,70,23.3,2,Partly Cloudy,4.0,2022-05-04 15:00:00,15
333,459,792,66,24.1,2,Partly Cloudy,4.3,2022-05-04 16:00:00,16
467,829,1296,70,22.8,51,Light Drizzle,1.5,2022-05-04 17:00:00,17
451,767,1218,69,22.6,51,Light Drizzle,2.7,2022-05-04 18:00:00,18
340,543,883,65,22.5,1,Mostly Clear,1.8,2022-05-04 19:00:00,19
206,384,590,69,21.2,1,Mostly Clear,3.6,2022-05-04 20:00:00,20
161,283,444,70,19.8,1,Mostly Clear,4.6,2022-05-04 21:00:00,21
144,192,336,71,18.7,1,Mostly Clear,3.6,2022-05-04 22:00:00,22
84,123,207,73,18.0,1,Mostly Clear,8.5,2022-05-04 23:00:00,23
51,40,91,76,17.2,1,Mostly Clear,13.8,2022-05-05 00:00:00,0
22,21,43,80,16.4,0,Clear,13.8,2022-05-05 01:00:00,1
6,10,16,82,15.4,0,Clear,11.9,2022-05-05 02:00:00,2
3,11,14,82,14.7,1,Mostly Clear,10.9,2022-05-05 03:00:00,3
5,14,19,84,14.2,1,Mostly Clear,10.6,2022-05-05 04:00:00,4
11,44,55,85,13.6,2,Partly Cloudy,11.9,2022-05-05 05:00:00,5
49,162,211,85,13.3,1,Mostly Clear,7.9,2022-05-05 06:00:00,6
109,385,494,86,13.4,1,Mostly Clear,9.9,2022-05-05 07:00:00,7
221,620,841,80,14.6,1,Mostly Clear,11.9,2022-05-05 08:00:00,8
211,370,581,72,16.3,3,Cloudy,12.9,2022-05-05 09:00:00,9
227,214,441,68,17.4,3,Cloudy,12.1,2022-05-05 10:00:00,10
187,249,436,65,18.5,3,Cloudy,10.9,2022-05-05 11:00:00,11
252,293,545,61,19.5,3,Cloudy,8.6,2022-05-05 12:00:00,12
270,281,551,59,19.9,3,Cloudy,7.6,2022-05-05 13:00:00,13
273,257,530,58,20.2,3,Cloudy,6.5,2022-05-05 14:00:00,14
325,356,681,62,19.0,3,Cloudy,6.0,2022-05-05 15:00:00,15
318,496,814,61,19.4,3,Cloudy,5.9,2022-05-05 16:00:00,16
490,788,1278,61,19.4,3,Cloudy,5.4,2022-05-05 17:00:00,17
473,688,1161,66,18.6,51,Light Drizzle,5.0,2022-05-05 18:00:00,18
281,514,795,68,18.2,3,Cloudy,5.9,2022-05-05 19:00:00,19
250,345,595,75,17.3,51,Light Drizzle,6.4,2022-05-05 20:00:00,20
174,278,452,78,16.8,2,Partly Cloudy,7.3,2022-05-05 21:00:00,21
143,202,345,81,16.1,3,Cloudy,6.4,2022-05-05 22:00:00,22
111,143,254,83,15.5,3,Cloudy,8.0,2022-05-05 23:00:00,23
79,92,171,87,14.8,1,Mostly Clear,7.8,2022-05-06 00:00:00,0
69,51,120,89,14.6,1,Mostly Clear,7.6,2022-05-06 01:00:00,1
27,21,48,91,14.4,1,Mostly Clear,6.8,2022-05-06 02:00:00,2
7,18,25,92,14.3,3,Cloudy,6.8,2022-05-06 03:00:00,3
9,14,23,94,14.2,3,Cloudy,7.9,2022-05-06 04:00:00,4
14,42,56,95,14.2,51,Light Drizzle,8.1,2022-05-06 05:00:00,5
28,110,138,96,14.1,51,Light Drizzle,9.5,2022-05-06 06:00:00,6
55,173,228,96,14.2,51,Light Drizzle,10.0,2022-05-06 07:00:00,7
40,233,273,92,14.7,51,Light Drizzle,8.6,2022-05-06 08:00:00,8
31,81,112,90,15.2,51,Light Drizzle,9.9,2022-05-06 09:00:00,9
25,56,81,93,15.2,53,Heavy Drizzle,11.0,2022-05-06 10:00:00,10
39,102,141,93,15.5,61,Light Rain,12.2,2022-05-06 11:00:00,11
32,90,122,94,15.7,61,Light Rain,12.5,2022-05-06 12:00:00,12
71,154,225,94,16.1,61,Light Rain,11.4,2022-05-06 13:00:00,13
86,110,196,91,17.0,61,Light Rain,13.7,2022-05-06 14:00:00,14
106,201,307,98,15.6,61,Light Rain,14.5,2022-05-06 15:00:00,15
130,320,450,98,15.6,61,Light Rain,14.8,2022-05-06 16:00:00,16
176,346,522,98,15.7,63,Rain,15.5,2022-05-06 17:00:00,17
83,221,304,99,15.3,61,Light Rain,16.1,2022-05-06 18:00:00,18
39,111,150,99,14.7,53,Heavy Drizzle,18.2,2022-05-06 19:00:00,19
48,100,148,98,14.0,61,Light Rain,18.1,2022-05-06 20:00:00,20
32,88,120,99,13.6,61,Light Rain,18.0,2022-05-06 21:00:00,21
26,56,82,99,13.2,61,Light Rain,20.1,2022-05-06 22:00:00,22
49,77,126,98,12.6,53,Heavy Drizzle,20.3,2022-05-06 23:00:00,23
21,45,66,99,12.0,53,Heavy Drizzle,20.7,2022-05-07 00:00:00,0
9,19,28,99,11.6,55,Heavy Drizzle,20.3,2022-05-07 01:00:00,1
7,19,26,99,11.3,61,Light Rain,21.9,2022-05-07 02:00:00,2
7,13,20,97,9.9,51,Light Drizzle,22.4,2022-05-07 03:00:00,3
4,14,18,97,9.8,61,Light Rain,22.7,2022-05-07 04:00:00,4
9,11,20,97,9.7,61,Light Rain,21.4,2022-05-07 05:00:00,5
9,36,45,97,9.7,61,Light Rain,16.8,2022-05-07 06:00:00,6
8,48,56,97,9.8,53,Heavy Drizzle,12.9,2022-05-07 07:00:00,7
17,44,61,96,10.0,53,Heavy Drizzle,13.7,2022-05-07 08:00:00,8
23,68,91,96,10.1,55,Heavy Drizzle,15.5,2022-05-07 09:00:00,9
68,160,228,94,10.4,55,Heavy Drizzle,21.3,2022-05-07 10:00:00,10
57,139,196,94,10.6,55,Heavy Drizzle,21.3,2022-05-07 11:00:00,11
67,144,211,96,10.7,55,Heavy Drizzle,26.3,2022-05-07 12:00:00,12
48,151,199,95,10.8,53,Heavy Drizzle,26.5,2022-05-07 13:00:00,13
76,133,209,95,10.7,53,Heavy Drizzle,26.5,2022-05-07 14:00:00,14
63,137,200,91,10.6,53,Heavy Drizzle,25.6,2022-05-07 15:00:00,15
59,100,159,93,10.5,53,Heavy Drizzle,21.6,2022-05-07 16:00:00,16
47,123,170,93,10.0,51,Light Drizzle,22.8,2022-05-07 17:00:00,17
56,117,173,93,9.6,51,Light Drizzle,19.2,2022-05-07 18:00:00,18
50,154,204,92,9.1,51,Light Drizzle,20.1,2022-05-07 19:00:00,19
41,82,123,91,8.7,51,Light Drizzle,21.1,2022-05-07 20:00:00,20
31,79,110,90,8.5,51,Light Drizzle,21.3,2022-05-07 21:00:00,21
45,59,104,88,8.2,51,Light Drizzle,22.4,2022-05-07 22:00:00,22
59,63,122,85,7.9,3,Cloudy,23.2,2022-05-07 23:00:00,23
40,70,110,82,7.7,3,Cloudy,23.9,2022-05-08 00:00:00,0
47,43,90,81,7.5,3,Cloudy,22.9,2022-05-08 01:00:00,1
25,32,57,79,7.4,3,Cloudy,21.3,2022-05-08 02:00:00,2
19,18,37,75,7.4,3,Cloudy,16.6,2022-05-08 03:00:00,3
5,11,16,73,7.3,3,Cloudy,15.7,2022-05-08 04:00:00,4
4,12,16,72,7.2,3,Cloudy,16.2,2022-05-08 05:00:00,5
16,27,43,72,7.1,3,Cloudy,16.4,2022-05-08 06:00:00,6
26,64,90,73,7.1,3,Cloudy,14.5,2022-05-08 07:00:00,7
43,126,169,72,7.3,3,Cloudy,14.4,2022-05-08 08:00:00,8
93,170,263,71,7.7,3,Cloudy,14.8,2022-05-08 09:00:00,9
173,254,427,70,8.0,3,Cloudy,15.8,2022-05-08 10:00:00,10
200,306,506,68,8.5,3,Cloudy,16.9,2022-05-08 11:00:00,11
196,310,506,66,9.0,3,Cloudy,17.6,2022-05-08 12:00:00,12
277,316,593,64,9.5,3,Cloudy,16.9,2022-05-08 13:00:00,13
306,329,635,63,9.8,3,Cloudy,15.2,2022-05-08 14:00:00,14
274,345,619,61,10.8,3,Cloudy,13.0,2022-05-08 15:00:00,15
279,363,642,58,11.5,3,Cloudy,11.8,2022-05-08 16:00:00,16
282,326,608,56,11.8,3,Cloudy,10.8,2022-05-08 17:00:00,17
220,305,525,60,11.7,3,Cloudy,8.6,2022-05-08 18:00:00,18
140,242,382,57,11.5,3,Cloudy,7.1,2022-05-08 19:00:00,19
124,200,324,57,11.2,1,Mostly Clear,4.8,2022-05-08 20:00:00,20
109,104,213,58,11.0,0,Clear,4.9,2022-05-08 21:00:00,21
82,77,159,63,10.5,0,Clear,3.5,2022-05-08 22:00:00,22
43,51,94,70,9.3,0,Clear,5.4,2022-05-08 23:00:00,23
35,28,63,74,8.4,0,Clear,7.0,2022-05-09 00:00:00,0
14,19,33,78,7.5,0,Clear,6.5,2022-05-09 01:00:00,1
5,7,12,77,7.1,0,Clear,8.4,2022-05-09 02:00:00,2
5,5,10,82,6.6,0,Clear,9.4,2022-05-09 03:00:00,3
6,17,23,80,6.2,0,Clear,10.5,2022-05-09 04:00:00,4
11,37,48,77,6.2,0,Clear,11.6,2022-05-09 05:00:00,5
38,142,180,74,6.3,0,Clear,11.9,2022-05-09 06:00:00,6
87,323,410,70,7.0,0,Clear,12.3,2022-05-09 07:00:00,7
159,525,684,62,9.3,0,Clear,11.5,2022-05-09 08:00:00,8
140,269,409,49,11.2,0,Clear,13.0,2022-05-09 09:00:00,9
145,220,365,43,12.6,0,Clear,15.0,2022-05-09 10:00:00,10
180,227,407,40,14.0,0,Clear,14.6,2022-05-09 11:00:00,11
221,276,497,37,15.5,0,Clear,13.9,2022-05-09 12:00:00,12
269,283,552,36,16.8,0,Clear,13.4,2022-05-09 13:00:00,13
258,295,553,35,17.8,0,Clear,13.3,2022-05-09 14:00:00,14
277,380,657,33,19.0,0,Clear,13.5,2022-05-09 15:00:00,15
312,475,787,33,19.4,0,Clear,13.0,2022-05-09 16:00:00,16
440,815,1255,34,19.4,0,Clear,12.7,2022-05-09 17:00:00,17
453,765,1218,37,19.0,0,Clear,7.6,2022-05-09 18:00:00,18
284,538,822,48,17.7,0,Clear,5.0,2022-05-09 19:00:00,19
198,338,536,56,16.1,0,Clear,7.0,2022-05-09 20:00:00,20
139,204,343,58,14.2,0,Clear,6.5,2022-05-09 21:00:00,21
113,159,272,63,12.9,0,Clear,7.0,2022-05-09 22:00:00,22
79,82,161,66,11.9,0,Clear,8.7,2022-05-09 23:00:00,23
22,40,62,69,11.1,0,Clear,8.2,2022-05-10 00:00:00,0
8,18,26,70,10.4,0,Clear,9.0,2022-05-10 01:00:00,1
2,7,9,64,10.1,0,Clear,11.3,2022-05-10 02:00:00,2
0,5,5,57,10.3,0,Clear,12.6,2022-05-10 03:00:00,3
2,11,13,49,10.0,0,Clear,13.5,2022-05-10 04:00:00,4
16,49,65,44,9.7,0,Clear,14.0,2022-05-10 05:00:00,5
47,181,228,45,9.5,0,Clear,12.1,2022-05-10 06:00:00,6
108,416,524,50,9.4,0,Clear,12.7,2022-05-10 07:00:00,7
193,645,838,51,10.9,0,Clear,12.6,2022-05-10 08:00:00,8
176,381,557,45,12.6,0,Clear,14.2,2022-05-10 09:00:00,9
177,230,407,44,14.1,0,Clear,17.1,2022-05-10 10:00:00,10
194,243,437,45,15.6,0,Clear,16.8,2022-05-10 11:00:00,11
220,332,552,46,17.1,0,Clear,15.9,2022-05-10 12:00:00,12
255,314,569,47,18.4,0,Clear,15.2,2022-05-10 13:00:00,13
278,311,589,47,19.4,0,Clear,14.5,2022-05-10 14:00:00,14
334,406,740,38,21.2,0,Clear,14.5,2022-05-10 15:00:00,15
372,502,874,39,21.3,0,Clear,15.0,2022-05-10 16:00:00,16
518,917,1435,40,21.1,0,Clear,14.0,2022-05-10 17:00:00,17
557,873,1430,43,20.5,0,Clear,10.3,2022-05-10 18:00:00,18
395,502,897,52,19.2,0,Clear,8.1,2022-05-10 19:00:00,19
257,413,670,61,17.2,0,Clear,8.6,2022-05-10 20:00:00,20
239,254,493,64,15.4,0,Clear,8.5,2022-05-10 21:00:00,21
140,217,357,69,14.0,0,Clear,7.0,2022-05-10 22:00:00,22
79,106,185,74,12.7,0,Clear,7.6,2022-05-10 23:00:00,23
24,35,59,75,11.7,0,Clear,6.9,2022-05-11 00:00:00,0
13,14,27,74,11.1,0,Clear,5.8,2022-05-11 01:00:00,1
5,5,10,72,10.7,0,Clear,7.3,2022-05-11 02:00:00,2
2,4,6,72,10.4,0,Clear,8.9,2022-05-11 03:00:00,3
5,12,17,70,10.0,0,Clear,10.5,2022-05-11 04:00:00,4
20,66,86,67,9.8,0,Clear,11.4,2022-05-11 05:00:00,5
57,177,234,66,9.6,0,Clear,11.3,2022-05-11 06:00:00,6
131,421,552,65,10.1,0,Clear,12.0,2022-05-11 07:00:00,7
219,729,948,58,12.4,0,Clear,11.8,2022-05-11 08:00:00,8
206,387,593,47,14.3,0,Clear,12.3,2022-05-11 09:00:00,9
199,226,425,49,15.6,0,Clear,15.3,2022-05-11 10:00:00,10
220,258,478,54,16.6,0,Clear,15.0,2022-05-11 11:00:00,11
217,326,543,56,17.9,0,Clear,15.0,2022-05-11 12:00:00,12
242,305,547,57,19.3,0,Clear,15.1,2022-05-11 13:00:00,13
306,297,603,57,20.1,1,Mostly Clear,15.9,2022-05-11 14:00:00,14
296,392,688,51,21.9,3,Cloudy,15.5,2022-05-11 15:00:00,15
319,532,851,54,21.3,3,Cloudy,15.1,2022-05-11 16:00:00,16
518,895,1413,59,20.5,3,Cloudy,12.4,2022-05-11 17:00:00,17
500,766,1266,62,20.3,3,Cloudy,7.4,2022-05-11 18:00:00,18
399,508,907,66,19.9,1,Mostly Clear,5.8,2022-05-11 19:00:00,19
213,382,595,72,18.5,1,Mostly Clear,7.0,2022-05-11 20:00:00,20
195,263,458,76,17.4,1,Mostly Clear,7.1,2022-05-11 21:00:00,21
176,228,404,80,16.6,0,Clear,5.9,2022-05-11 22:00:00,22
95,95,190,84,15.6,0,Clear,7.0,2022-05-11 23:00:00,23
43,51,94,88,14.8,0,Clear,5.5,2022-05-12 00:00:00,0
17,13,30,91,14.0,0,Clear,5.4,2022-05-12 01:00:00,1
8,19,27,92,13.6,0,Clear,5.9,2022-05-12 02:00:00,2
4,8,12,92,13.1,0,Clear,7.4,2022-05-12 03:00:00,3
3,15,18,93,12.5,0,Clear,8.4,2022-05-12 04:00:00,4
15,49,64,93,12.3,0,Clear,9.3,2022-05-12 05:00:00,5
52,166,218,92,12.3,0,Clear,8.0,2022-05-12 06:00:00,6
140,383,523,89,13.1,1,Mostly Clear,11.1,2022-05-12 07:00:00,7
215,621,836,82,14.9,3,Cloudy,11.6,2022-05-12 08:00:00,8
153,353,506,80,16.1,3,Cloudy,11.4,2022-05-12 09:00:00,9
147,206,353,81,16.5,3,Cloudy,13.1,2022-05-12 10:00:00,10
218,294,512,80,17.2,3,Cloudy,15.4,2022-05-12 11:00:00,11
265,280,545,80,17.6,3,Cloudy,15.8,2022-05-12 12:00:00,12
224,298,522,78,18.5,3,Cloudy,15.2,2022-05-12 13:00:00,13
317,293,610,78,19.1,3,Cloudy,14.0,2022-05-12 14:00:00,14
323,362,685,70,21.8,3,Cloudy,16.4,2022-05-12 15:00:00,15
335,505,840,72,21.8,3,Cloudy,15.9,2022-05-12 16:00:00,16
532,764,1296,72,22.0,3,Cloudy,16.4,2022-05-12 17:00:00,17
470,696,1166,75,21.6,2,Partly Cloudy,10.5,2022-05-12 18:00:00,18
309,488,797,80,20.5,2,Partly Cloudy,10.9,2022-05-12 19:00:00,19
277,347,624,86,19.2,1,Mostly Clear,9.6,2022-05-12 20:00:00,20
231,261,492,89,18.1,0,Clear,9.7,2022-05-12 21:00:00,21
150,200,350,90,17.6,1,Mostly Clear,10.1,2022-05-12 22:00:00,22
136,138,274,91,17.2,3,Cloudy,9.8,2022-05-12 23:00:00,23
36,60,96,92,16.8,3,Cloudy,9.1,2022-05-13 00:00:00,0
26,44,70,94,16.4,3,Cloudy,8.8,2022-05-13 01:00:00,1
25,28,53,95,16.2,3,Cloudy,8.5,2022-05-13 02:00:00,2
6,16,22,98,16.4,51,Light Drizzle,8.9,2022-05-13 03:00:00,3
6,22,28,98,16.2,3,Cloudy,9.6,2022-05-13 04:00:00,4
7,18,25,99,16.0,51,Light Drizzle,11.3,2022-05-13 05:00:00,5
33,97,130,99,15.8,51,Light Drizzle,8.4,2022-05-13 06:00:00,6
53,218,271,99,15.7,51,Light Drizzle,12.8,2022-05-13 07:00:00,7
96,330,426,99,16.0,51,Light Drizzle,15.4,2022-05-13 08:00:00,8
122,237,359,99,16.7,53,Heavy Drizzle,15.6,2022-05-13 09:00:00,9
167,195,362,99,17.0,53,Heavy Drizzle,16.4,2022-05-13 10:00:00,10
237,230,467,98,17.7,53,Heavy Drizzle,16.5,2022-05-13 11:00:00,11
260,254,514,97,18.8,55,Heavy Drizzle,14.3,2022-05-13 12:00:00,12
296,296,592,93,19.7,51,Light Drizzle,14.2,2022-05-13 13:00:00,13
341,296,637,89,20.3,51,Light Drizzle,13.0,2022-05-13 14:00:00,14
386,361,747,88,20.5,3,Cloudy,15.4,2022-05-13 15:00:00,15
447,443,890,87,21.3,51,Light Drizzle,14.0,2022-05-13 16:00:00,16
452,632,1084,85,22.0,3,Cloudy,12.6,2022-05-13 17:00:00,17
420,545,965,83,22.1,2,Partly Cloudy,7.6,2022-05-13 18:00:00,18
386,410,796,89,20.0,61,Light Rain,6.7,2022-05-13 19:00:00,19
265,285,550,92,19.5,51,Light Drizzle,8.2,2022-05-13 20:00:00,20
193,232,425,95,18.6,3,Cloudy,6.0,2022-05-13 21:00:00,21
216,224,440,98,18.0,2,Partly Cloudy,8.6,2022-05-13 22:00:00,22
253,192,445,98,17.6,3,Cloudy,7.3,2022-05-13 23:00:00,23
136,145,281,99,17.8,3,Cloudy,6.9,2022-05-14 00:00:00,0
104,90,194,99,17.8,3,Cloudy,8.2,2022-05-14 01:00:00,1
76,65,141,100,17.6,3,Cloudy,9.0,2022-05-14 02:00:00,2
35,30,65,100,17.6,51,Light Drizzle,9.3,2022-05-14 03:00:00,3
10,10,20,100,17.4,51,Light Drizzle,8.5,2022-05-14 04:00:00,4
10,11,21,99,17.2,3,Cloudy,6.2,2022-05-14 05:00:00,5
29,46,75,100,17.0,3,Cloudy,5.8,2022-05-14 06:00:00,6
55,115,170,99,17.1,3,Cloudy,4.8,2022-05-14 07:00:00,7
111,217,328,97,17.5,3,Cloudy,6.3,2022-05-14 08:00:00,8
254,351,605,94,17.9,3,Cloudy,7.2,2022-05-14 09:00:00,9
402,373,775,94,18.3,51,Light Drizzle,7.6,2022-05-14 10:00:00,10
436,433,869,92,18.9,51,Light Drizzle,8.0,2022-05-14 11:00:00,11
532,447,979,90,19.5,3,Cloudy,8.7,2022-05-14 12:00:00,12
654,456,1110,88,20.3,3,Cloudy,9.6,2022-05-14 13:00:00,13
560,426,986,84,21.1,51,Light Drizzle,10.9,2022-05-14 14:00:00,14
506,368,874,94,19.8,53,Heavy Drizzle,12.8,2022-05-14 15:00:00,15
530,366,896,94,19.5,53,Heavy Drizzle,12.3,2022-05-14 16:00:00,16
441,365,806,93,19.6,53,Heavy Drizzle,9.5,2022-05-14 17:00:00,17
338,377,715,93,19.9,53,Heavy Drizzle,6.4,2022-05-14 18:00:00,18
307,321,628,95,19.7,51,Light Drizzle,3.9,2022-05-14 19:00:00,19
239,229,468,97,19.1,51,Light Drizzle,5.8,2022-05-14 20:00:00,20
247,214,461,98,18.6,3,Cloudy,6.8,2022-05-14 21:00:00,21
227,182,409,100,18.1,3,Cloudy,4.7,2022-05-14 22:00:00,22
207,189,396,100,17.9,3,Cloudy,4.5,2022-05-14 23:00:00,23
131,116,247,100,17.8,3,Cloudy,5.4,2022-05-15 00:00:00,0
106,79,185,99,17.8,3,Cloudy,5.4,2022-05-15 01:00:00,1
80,80,160,99,17.7,3,Cloudy,5.5,2022-05-15 02:00:00,2
38,31,69,100,17.1,3,Cloudy,4.8,2022-05-15 03:00:00,3
20,15,35,100,16.7,3,Cloudy,4.6,2022-05-15 04:00:00,4
7,17,24,100,16.5,3,Cloudy,5.0,2022-05-15 05:00:00,5
31,39,70,99,16.6,3,Cloudy,4.1,2022-05-15 06:00:00,6
50,112,162,99,16.7,3,Cloudy,4.4,2022-05-15 07:00:00,7
131,177,308,99,17.1,3,Cloudy,4.7,2022-05-15 08:00:00,8
277,242,519,95,18.0,3,Cloudy,5.2,2022-05-15 09:00:00,9
322,330,652,89,19.3,3,Cloudy,5.2,2022-05-15 10:00:00,10
482,399,881,81,21.3,3,Cloudy,3.8,2022-05-15 11:00:00,11
582,486,1068,71,23.4,3,Cloudy,3.8,2022-05-15 12:00:00,12
638,526,1164,65,25.1,3,Cloudy,5.3,2022-05-15 13:00:00,13
650,506,1156,63,26.0,3,Cloudy,6.0,2022-05-15 14:00:00,14
737,497,1234,70,25.3,3,Cloudy,5.8,2022-05-15 15:00:00,15
667,511,1178,69,25.7,2,Partly Cloudy,7.2,2022-05-15 16:00:00,16
519,468,987,68,26.0,1,Mostly Clear,7.3,2022-05-15 17:00:00,17
448,442,890,69,25.6,1,Mostly Clear,3.6,2022-05-15 18:00:00,18
176,209,385,76,24.4,51,Light Drizzle,2.5,2022-05-15 19:00:00,19
85,129,214,82,23.1,51,Light Drizzle,2.6,2022-05-15 20:00:00,20
113,133,246,92,21.1,51,Light Drizzle,6.4,2022-05-15 21:00:00,21
105,107,212,95,20.2,51,Light Drizzle,7.6,2022-05-15 22:00:00,22
58,49,107,96,19.2,51,Light Drizzle,6.6,2022-05-15 23:00:00,23
32,41,73,98,18.5,53,Heavy Drizzle,8.8,2022-05-16 00:00:00,0
13,10,23,100,18.0,51,Light Drizzle,7.4,2022-05-16 01:00:00,1
13,18,31,100,17.8,51,Light Drizzle,5.6,2022-05-16 02:00:00,2
4,5,9,99,17.5,1,Mostly Clear,5.5,2022-05-16 03:00:00,3
15,13,28,99,17.3,3,Cloudy,5.9,2022-05-16 04:00:00,4
19,64,83,99,17.1,3,Cloudy,4.8,2022-05-16 05:00:00,5
55,156,211,99,16.8,3,Cloudy,5.0,2022-05-16 06:00:00,6
111,351,462,99,17.6,3,Cloudy,6.1,2022-05-16 07:00:00,7
182,554,736,95,19.8,3,Cloudy,7.9,2022-05-16 08:00:00,8
158,305,463,87,21.1,3,Cloudy,10.8,2022-05-16 09:00:00,9
146,155,301,83,21.9,3,Cloudy,11.8,2022-05-16 10:00:00,10
84,126,210,78,23.4,3,Cloudy,10.6,2022-05-16 11:00:00,11
87,115,202,69,25.4,3,Cloudy,10.4,2022-05-16 12:00:00,12
171,206,377,64,26.7,51,Light Drizzle,11.1,2022-05-16 13:00:00,13
218,241,459,60,27.4,0,Clear,11.3,2022-05-16 14:00:00,14
255,303,558,64,26.3,1,Mostly Clear,13.2,2022-05-16 15:00:00,15
173,339,512,60,26.2,51,Light Drizzle,17.3,2022-05-16 16:00:00,16
223,478,701,69,23.6,53,Heavy Drizzle,15.9,2022-05-16 17:00:00,17
311,576,887,58,23.2,1,Mostly Clear,15.3,2022-05-16 18:00:00,18
387,454,841,54,22.3,0,Clear,20.3,2022-05-16 19:00:00,19
235,331,566,54,21.0,0,Clear,17.2,2022-05-16 20:00:00,20
153,246,399,53,19.9,0,Clear,16.4,2022-05-16 21:00:00,21
98,129,227,58,18.7,0,Clear,13.5,2022-05-16 22:00:00,22
69,79,148,64,17.4,0,Clear,10.6,2022-05-16 23:00:00,23
29,43,72,69,16.4,0,Clear,10.8,2022-05-17 00:00:00,0
10,11,21,72,15.8,0,Clear,10.8,2022-05-17 01:00:00,1
9,22,31,74,15.5,0,Clear,10.1,2022-05-17 02:00:00,2
8,5,13,76,14.9,0,Clear,9.8,2022-05-17 03:00:00,3
10,22,32,78,14.4,0,Clear,9.7,2022-05-17 04:00:00,4
34,59,93,79,14.0,0,Clear,10.4,2022-05-17 05:00:00,5
52,183,235,79,13.8,0,Clear,11.7,2022-05-17 06:00:00,6
132,430,562,77,14.5,0,Clear,11.5,2022-05-17 07:00:00,7
249,714,963,70,17.1,0,Clear,10.3,2022-05-17 08:00:00,8
208,422,630,60,19.7,0,Clear,9.7,2022-05-17 09:00:00,9
195,253,448,51,21.9,0,Clear,11.9,2022-05-17 10:00:00,10
248,255,503,43,23.7,0,Clear,15.0,2022-05-17 11:00:00,11
254,361,615,34,25.1,1,Mostly Clear,18.4,2022-05-17 12:00:00,12
253,367,620,33,25.5,1,Mostly Clear,22.7,2022-05-17 13:00:00,13
275,300,575,32,25.6,1,Mostly Clear,20.2,2022-05-17 14:00:00,14
322,426,748,35,25.3,1,Mostly Clear,16.3,2022-05-17 15:00:00,15
400,540,940,32,26.0,1,Mostly Clear,16.9,2022-05-17 16:00:00,16
544,903,1447,33,26.1,1,Mostly Clear,18.0,2022-05-17 17:00:00,17
525,825,1350,40,24.9,1,Mostly Clear,16.3,2022-05-17 18:00:00,18
438,606,1044,45,23.2,0,Clear,13.0,2022-05-17 19:00:00,19
318,437,755,50,21.7,0,Clear,12.3,2022-05-17 20:00:00,20
222,251,473,51,20.4,0,Clear,12.2,2022-05-17 21:00:00,21
172,211,383,54,19.4,0,Clear,13.8,2022-05-17 22:00:00,22
73,102,175,55,18.2,0,Clear,14.2,2022-05-17 23:00:00,23
33,43,76,54,17.2,0,Clear,13.0,2022-05-18 00:00:00,0
16,12,28,54,16.1,0,Clear,12.0,2022-05-18 01:00:00,1
10,8,18,55,15.2,0,Clear,11.9,2022-05-18 02:00:00,2
6,11,17,56,15.3,0,Clear,11.3,2022-05-18 03:00:00,3
10,17,27,60,14.3,0,Clear,10.6,2022-05-18 04:00:00,4
20,67,87,65,13.2,0,Clear,9.0,2022-05-18 05:00:00,5
62,163,225,74,12.1,0,Clear,7.4,2022-05-18 06:00:00,6
155,398,553,78,12.3,0,Clear,7.1,2022-05-18 07:00:00,7
227,692,919,64,15.1,0,Clear,6.3,2022-05-18 08:00:00,8
243,416,659,57,16.5,0,Clear,5.4,2022-05-18 09:00:00,9
211,241,452,51,17.8,1,Mostly Clear,4.0,2022-05-18 10:00:00,10
214,275,489,47,19.1,0,Clear,2.9,2022-05-18 11:00:00,11
269,278,547,45,20.4,0,Clear,5.4,2022-05-18 12:00:00,12
280,286,566,42,21.7,1,Mostly Clear,5.9,2022-05-18 13:00:00,13
284,295,579,41,22.7,0,Clear,6.2,2022-05-18 14:00:00,14
321,408,729,38,23.4,1,Mostly Clear,6.8,2022-05-18 15:00:00,15
386,530,916,39,23.0,2,Partly Cloudy,7.2,2022-05-18 16:00:00,16
495,867,1362,43,22.4,2,Partly Cloudy,3.3,2022-05-18 17:00:00,17
575,756,1331,44,22.4,3,Cloudy,3.1,2022-05-18 18:00:00,18
422,528,950,52,21.2,2,Partly Cloudy,3.1,2022-05-18 19:00:00,19
256,359,615,58,19.7,1,Mostly Clear,6.3,2022-05-18 20:00:00,20
177,313,490,62,18.4,3,Cloudy,10.5,2022-05-18 21:00:00,21
140,186,326,65,17.7,3,Cloudy,11.7,2022-05-18 22:00:00,22
72,109,181,67,17.5,3,Cloudy,12.6,2022-05-18 23:00:00,23
24,31,55,68,17.4,51,Light Drizzle,12.3,2022-05-19 00:00:00,0
5,12,17,69,17.4,51,Light Drizzle,8.7,2022-05-19 01:00:00,1
3,10,13,71,17.4,51,Light Drizzle,9.4,2022-05-19 02:00:00,2
1,13,14,90,15.5,63,Rain,9.4,2022-05-19 03:00:00,3
5,15,20,93,15.4,61,Light Rain,8.2,2022-05-19 04:00:00,4
13,46,59,94,15.6,51,Light Drizzle,6.0,2022-05-19 05:00:00,5
44,160,204,92,15.9,3,Cloudy,4.6,2022-05-19 06:00:00,6
114,368,482,94,16.1,3,Cloudy,3.7,2022-05-19 07:00:00,7
231,621,852,90,17.4,3,Cloudy,5.5,2022-05-19 08:00:00,8
189,317,506,83,18.8,2,Partly Cloudy,8.4,2022-05-19 09:00:00,9
191,204,395,75,20.7,2,Partly Cloudy,10.7,2022-05-19 10:00:00,10
232,256,488,67,22.8,0,Clear,11.2,2022-05-19 11:00:00,11
260,291,551,57,25.0,2,Partly Cloudy,15.6,2022-05-19 12:00:00,12
259,289,548,53,26.0,51,Light Drizzle,17.9,2022-05-19 13:00:00,13
275,301,576,52,26.3,2,Partly Cloudy,15.9,2022-05-19 14:00:00,14
323,379,702,47,27.2,1,Mostly Clear,16.6,2022-05-19 15:00:00,15
402,488,890,44,27.7,0,Clear,16.4,2022-05-19 16:00:00,16
541,817,1358,44,27.7,0,Clear,15.4,2022-05-19 17:00:00,17
536,754,1290,45,27.5,1,Mostly Clear,11.8,2022-05-19 18:00:00,18
459,602,1061,53,26.2,1,Mostly Clear,6.6,2022-05-19 19:00:00,19
364,440,804,59,24.4,1,Mostly Clear,8.7,2022-05-19 20:00:00,20
239,278,517,62,22.5,1,Mostly Clear,8.0,2022-05-19 21:00:00,21
140,205,345,73,20.8,1,Mostly Clear,4.8,2022-05-19 22:00:00,22
112,107,219,75,19.7,0,Clear,6.1,2022-05-19 23:00:00,23
53,62,115,80,18.3,0,Clear,7.6,2022-05-20 00:00:00,0
27,42,69,87,16.9,0,Clear,7.6,2022-05-20 01:00:00,1
19,13,32,88,16.6,1,Mostly Clear,8.3,2022-05-20 02:00:00,2
6,11,17,87,17.1,1,Mostly Clear,9.4,2022-05-20 03:00:00,3
7,19,26,88,17.1,1,Mostly Clear,9.4,2022-05-20 04:00:00,4
21,52,73,89,17.1,1,Mostly Clear,9.0,2022-05-20 05:00:00,5
60,157,217,90,17.1,3,Cloudy,7.1,2022-05-20 06:00:00,6
147,433,580,89,18.2,2,Partly Cloudy,3.6,2022-05-20 07:00:00,7
235,552,787,81,21.2,2,Partly Cloudy,1.3,2022-05-20 08:00:00,8
230,353,583,74,23.8,1,Mostly Clear,4.0,2022-05-20 09:00:00,9
320,289,609,68,26.2,1,Mostly Clear,8.5,2022-05-20 10:00:00,10
310,286,596,63,28.2,1,Mostly Clear,7.4,2022-05-20 11:00:00,11
416,340,756,59,29.8,1,Mostly Clear,8.0,2022-05-20 12:00:00,12
336,343,679,55,31.2,1,Mostly Clear,11.0,2022-05-20 13:00:00,13
359,335,694,49,32.4,1,Mostly Clear,12.7,2022-05-20 14:00:00,14
456,438,894,49,32.0,1,Mostly Clear,13.2,2022-05-20 15:00:00,15
439,469,908,44,32.5,1,Mostly Clear,14.8,2022-05-20 16:00:00,16
585,582,1167,42,32.6,1,Mostly Clear,12.2,2022-05-20 17:00:00,17
441,550,991,45,32.1,1,Mostly Clear,11.2,2022-05-20 18:00:00,18
388,440,828,49,30.9,1,Mostly Clear,7.9,2022-05-20 19:00:00,19
288,322,610,50,28.9,1,Mostly Clear,10.2,2022-05-20 20:00:00,20
237,247,484,41,27.8,1,Mostly Clear,14.8,2022-05-20 21:00:00,21
166,241,407,38,27.6,1,Mostly Clear,18.4,2022-05-20 22:00:00,22
163,169,332,42,27.4,1,Mostly Clear,18.9,2022-05-20 23:00:00,23
160,111,271,46,27.2,0,Clear,18.2,2022-05-21 00:00:00,0
124,56,180,49,26.7,0,Clear,17.7,2022-05-21 01:00:00,1
74,43,117,52,25.8,0,Clear,17.6,2022-05-21 02:00:00,2
41,35,76,59,25.6,0,Clear,16.0,2022-05-21 03:00:00,3
17,19,36,57,25.0,1,Mostly Clear,14.8,2022-05-21 04:00:00,4
37,23,60,58,24.2,0,Clear,12.5,2022-05-21 05:00:00,5
71,89,160,64,23.1,0,Clear,8.3,2022-05-21 06:00:00,6
71,155,226,74,22.2,0,Clear,7.2,2022-05-21 07:00:00,7
187,247,434,68,24.3,0,Clear,4.5,2022-05-21 08:00:00,8
337,348,685,59,26.6,0,Clear,4.4,2022-05-21 09:00:00,9
420,378,798,54,28.6,1,Mostly Clear,5.0,2022-05-21 10:00:00,10
516,439,955,50,30.4,1,Mostly Clear,3.6,2022-05-21 11:00:00,11
535,423,958,45,31.9,1,Mostly Clear,4.7,2022-05-21 12:00:00,12
546,376,922,42,33.0,1,Mostly Clear,7.4,2022-05-21 13:00:00,13
511,364,875,41,33.6,1,Mostly Clear,10.0,2022-05-21 14:00:00,14
509,382,891,43,33.6,1,Mostly Clear,12.0,2022-05-21 15:00:00,15
534,411,945,44,33.2,1,Mostly Clear,12.4,2022-05-21 16:00:00,16
469,374,843,44,33.0,0,Clear,11.9,2022-05-21 17:00:00,17
398,386,784,46,32.2,1,Mostly Clear,10.1,2022-05-21 18:00:00,18
409,324,733,54,30.5,0,Clear,8.6,2022-05-21 19:00:00,19
352,282,634,61,28.6,0,Clear,10.7,2022-05-21 20:00:00,20
296,254,550,56,27.8,0,Clear,10.6,2022-05-21 21:00:00,21
243,246,489,55,27.3,1,Mostly Clear,14.2,2022-05-21 22:00:00,22
239,167,406,60,26.4,1,Mostly Clear,15.9,2022-05-21 23:00:00,23
131,113,244,66,25.5,1,Mostly Clear,14.9,2022-05-22 00:00:00,0
109,93,202,71,24.6,1,Mostly Clear,14.1,2022-05-22 01:00:00,1
75,58,133,77,23.8,1,Mostly Clear,12.7,2022-05-22 02:00:00,2
67,35,102,75,24.2,0,Clear,12.8,2022-05-22 03:00:00,3
14,12,26,78,23.6,0,Clear,12.2,2022-05-22 04:00:00,4
20,22,42,81,23.2,1,Mostly Clear,10.7,2022-05-22 05:00:00,5
44,79,123,83,22.7,1,Mostly Clear,7.5,2022-05-22 06:00:00,6
69,135,204,85,22.8,1,Mostly Clear,8.5,2022-05-22 07:00:00,7
165,175,340,79,24.1,1,Mostly Clear,9.3,2022-05-22 08:00:00,8
280,291,571,74,25.5,2,Partly Cloudy,9.1,2022-05-22 09:00:00,9
419,369,788,68,27.3,1,Mostly Clear,7.2,2022-05-22 10:00:00,10
526,387,913,62,29.1,0,Clear,7.6,2022-05-22 11:00:00,11
500,410,910,56,30.5,0,Clear,5.9,2022-05-22 12:00:00,12
515,436,951,52,31.6,0,Clear,6.9,2022-05-22 13:00:00,13
538,368,906,49,32.4,1,Mostly Clear,6.7,2022-05-22 14:00:00,14
497,391,888,49,32.6,1,Mostly Clear,7.9,2022-05-22 15:00:00,15
453,397,850,45,33.2,2,Partly Cloudy,10.5,2022-05-22 16:00:00,16
316,296,612,45,32.4,51,Light Drizzle,13.0,2022-05-22 17:00:00,17
171,169,340,54,30.2,61,Light Rain,5.1,2022-05-22 18:00:00,18
128,180,308,65,27.6,55,Heavy Drizzle,5.9,2022-05-22 19:00:00,19
19,29,48,76,25.7,53,Heavy Drizzle,9.5,2022-05-22 20:00:00,20
15,22,37,81,24.0,51,Light Drizzle,11.4,2022-05-22 21:00:00,21
46,69,115,83,23.3,51,Light Drizzle,11.2,2022-05-22 22:00:00,22
42,53,95,84,22.4,51,Light Drizzle,12.2,2022-05-22 23:00:00,23
22,34,56,84,21.7,2,Partly Cloudy,13.5,2022-05-23 00:00:00,0
10,9,19,83,20.8,1,Mostly Clear,15.5,2022-05-23 01:00:00,1
9,8,17,81,20.2,1,Mostly Clear,16.6,2022-05-23 02:00:00,2
7,5,12,88,18.9,1,Mostly Clear,16.1,2022-05-23 03:00:00,3
9,14,23,85,18.4,1,Mostly Clear,14.3,2022-05-23 04:00:00,4
25,52,77,83,18.0,1,Mostly Clear,13.7,2022-05-23 05:00:00,5
53,187,240,83,17.6,1,Mostly Clear,9.9,2022-05-23 06:00:00,6
118,394,512,78,17.6,1,Mostly Clear,12.3,2022-05-23 07:00:00,7
202,562,764,70,17.9,1,Mostly Clear,13.7,2022-05-23 08:00:00,8
219,325,544,61,18.7,1,Mostly Clear,13.0,2022-05-23 09:00:00,9
251,221,472,53,19.9,2,Partly Cloudy,12.7,2022-05-23 10:00:00,10
288,234,522,48,21.0,3,Cloudy,11.2,2022-05-23 11:00:00,11
293,282,575,44,22.3,2,Partly Cloudy,9.2,2022-05-23 12:00:00,12
327,296,623,42,23.3,3,Cloudy,8.6,2022-05-23 13:00:00,13
360,269,629,40,23.9,2,Partly Cloudy,7.8,2022-05-23 14:00:00,14
411,416,827,46,22.0,1,Mostly Clear,6.4,2022-05-23 15:00:00,15
409,542,951,45,22.5,3,Cloudy,5.6,2022-05-23 16:00:00,16
490,701,1191,45,22.2,3,Cloudy,5.8,2022-05-23 17:00:00,17
355,601,956,48,21.2,3,Cloudy,7.6,2022-05-23 18:00:00,18
240,398,638,54,19.9,51,Light Drizzle,7.7,2022-05-23 19:00:00,19
148,226,374,64,18.8,51,Light Drizzle,5.8,2022-05-23 20:00:00,20
88,143,231,71,18.0,51,Light Drizzle,3.8,2022-05-23 21:00:00,21
88,104,192,74,17.6,51,Light Drizzle,5.1,2022-05-23 22:00:00,22
51,73,124,77,17.4,51,Light Drizzle,6.2,2022-05-23 23:00:00,23
25,24,49,79,17.1,51,Light Drizzle,9.2,2022-05-24 00:00:00,0
13,8,21,81,16.7,51,Light Drizzle,9.0,2022-05-24 01:00:00,1
3,1,4,89,15.9,53,Heavy Drizzle,10.5,2022-05-24 02:00:00,2
1,2,3,92,15.0,55,Heavy Drizzle,9.0,2022-05-24 03:00:00,3
1,8,9,93,14.9,55,Heavy Drizzle,10.0,2022-05-24 04:00:00,4
7,33,40,95,14.9,55,Heavy Drizzle,9.4,2022-05-24 05:00:00,5
24,109,133,96,15.1,53,Heavy Drizzle,10.2,2022-05-24 06:00:00,6
42,250,292,97,15.4,53,Heavy Drizzle,8.2,2022-05-24 07:00:00,7
131,459,590,96,15.7,51,Light Drizzle,8.4,2022-05-24 08:00:00,8
149,304,453,88,15.9,51,Light Drizzle,8.7,2022-05-24 09:00:00,9
119,186,305,86,16.0,51,Light Drizzle,7.1,2022-05-24 10:00:00,10
72,157,229,86,16.1,3,Cloudy,8.5,2022-05-24 11:00:00,11
100,173,273,83,16.3,3,Cloudy,10.6,2022-05-24 12:00:00,12
70,152,222,81,16.1,3,Cloudy,14.2,2022-05-24 13:00:00,13
168,237,405,79,15.7,3,Cloudy,14.4,2022-05-24 14:00:00,14
234,353,587,81,16.1,3,Cloudy,14.1,2022-05-24 15:00:00,15
261,434,695,77,16.1,3,Cloudy,12.8,2022-05-24 16:00:00,16
421,849,1270,74,16.1,3,Cloudy,12.0,2022-05-24 17:00:00,17
399,711,1110,71,16.1,3,Cloudy,10.5,2022-05-24 18:00:00,18
283,554,837,69,16.0,3,Cloudy,9.1,2022-05-24 19:00:00,19
198,323,521,69,15.9,3,Cloudy,7.4,2022-05-24 20:00:00,20
152,222,374,69,15.8,3,Cloudy,7.1,2022-05-24 21:00:00,21
128,166,294,70,15.6,3,Cloudy,6.6,2022-05-24 22:00:00,22
61,101,162,71,15.5,3,Cloudy,5.8,2022-05-24 23:00:00,23
40,36,76,73,15.3,3,Cloudy,6.3,2022-05-25 00:00:00,0
10,16,26,73,15.0,3,Cloudy,6.1,2022-05-25 01:00:00,1
6,7,13,73,15.0,3,Cloudy,6.1,2022-05-25 02:00:00,2
2,7,9,73,15.5,3,Cloudy,7.9,2022-05-25 03:00:00,3
6,12,18,72,15.3,2,Partly Cloudy,8.4,2022-05-25 04:00:00,4
33,61,94,76,14.6,3,Cloudy,8.7,2022-05-25 05:00:00,5
50,192,242,81,14.1,1,Mostly Clear,7.4,2022-05-25 06:00:00,6
126,425,551,82,14.6,2,Partly Cloudy,8.8,2022-05-25 07:00:00,7
240,689,929,76,16.0,3,Cloudy,11.8,2022-05-25 08:00:00,8
190,382,572,76,16.7,3,Cloudy,9.9,2022-05-25 09:00:00,9
165,270,435,77,17.2,3,Cloudy,10.0,2022-05-25 10:00:00,10
208,250,458,76,17.7,3,Cloudy,11.2,2022-05-25 11:00:00,11
244,325,569,75,17.9,3,Cloudy,11.9,2022-05-25 12:00:00,12
290,340,630,69,18.5,3,Cloudy,12.6,2022-05-25 13:00:00,13
276,343,619,63,18.8,3,Cloudy,12.9,2022-05-25 14:00:00,14
335,427,762,52,20.7,3,Cloudy,13.1,2022-05-25 15:00:00,15
402,509,911,51,20.4,3,Cloudy,13.9,2022-05-25 16:00:00,16
502,828,1330,49,20.3,3,Cloudy,13.4,2022-05-25 17:00:00,17
447,806,1253,49,20.0,3,Cloudy,9.8,2022-05-25 18:00:00,18
371,552,923,51,19.4,3,Cloudy,9.7,2022-05-25 19:00:00,19
290,409,699,54,18.5,3,Cloudy,10.5,2022-05-25 20:00:00,20
176,258,434,54,17.7,3,Cloudy,10.3,2022-05-25 21:00:00,21
145,152,297,56,17.1,3,Cloudy,11.4,2022-05-25 22:00:00,22
79,119,198,59,16.6,3,Cloudy,10.0,2022-05-25 23:00:00,23
36,37,73,62,16.2,3,Cloudy,9.3,2022-05-26 00:00:00,0
18,18,36,67,15.7,3,Cloudy,8.3,2022-05-26 01:00:00,1
8,11,19,72,15.2,3,Cloudy,9.1,2022-05-26 02:00:00,2
2,5,7,70,15.4,3,Cloudy,8.8,2022-05-26 03:00:00,3
8,16,24,75,15.1,2,Partly Cloudy,8.9,2022-05-26 04:00:00,4
16,45,61,79,14.9,3,Cloudy,7.4,2022-05-26 05:00:00,5
51,155,206,82,14.7,3,Cloudy,3.1,2022-05-26 06:00:00,6
108,374,482,82,15.1,3,Cloudy,6.2,2022-05-26 07:00:00,7
197,582,779,82,15.7,3,Cloudy,6.7,2022-05-26 08:00:00,8
193,365,558,81,16.6,3,Cloudy,6.9,2022-05-26 09:00:00,9
210,214,424,79,17.6,3,Cloudy,6.4,2022-05-26 10:00:00,10
231,249,480,78,18.5,3,Cloudy,5.6,2022-05-26 11:00:00,11
245,300,545,76,19.5,3,Cloudy,7.1,2022-05-26 12:00:00,12
296,310,606,76,20.1,3,Cloudy,10.6,2022-05-26 13:00:00,13
320,280,600,76,20.5,3,Cloudy,11.6,2022-05-26 14:00:00,14
355,399,754,76,21.5,3,Cloudy,12.4,2022-05-26 15:00:00,15
350,476,826,77,21.5,3,Cloudy,14.2,2022-05-26 16:00:00,16
457,885,1342,77,21.6,2,Partly Cloudy,15.0,2022-05-26 17:00:00,17
427,669,1096,78,21.6,3,Cloudy,9.7,2022-05-26 18:00:00,18
387,510,897,81,21.0,3,Cloudy,9.2,2022-05-26 19:00:00,19
258,344,602,84,20.5,3,Cloudy,8.9,2022-05-26 20:00:00,20
222,266,488,87,19.9,3,Cloudy,7.7,2022-05-26 21:00:00,21
183,213,396,90,19.5,3,Cloudy,7.8,2022-05-26 22:00:00,22
87,91,178,92,19.2,3,Cloudy,7.9,2022-05-26 23:00:00,23
44,59,103,95,18.8,1,Mostly Clear,8.7,2022-05-27 00:00:00,0
15,25,40,97,18.3,1,Mostly Clear,8.5,2022-05-27 01:00:00,1
18,10,28,98,18.1,2,Partly Cloudy,8.4,2022-05-27 02:00:00,2
7,12,19,98,18.2,3,Cloudy,8.4,2022-05-27 03:00:00,3
12,12,24,99,18.2,2,Partly Cloudy,9.2,2022-05-27 04:00:00,4
33,45,78,98,18.3,2,Partly Cloudy,9.9,2022-05-27 05:00:00,5
53,125,178,98,18.4,3,Cloudy,8.8,2022-05-27 06:00:00,6
106,263,369,96,19.1,3,Cloudy,12.4,2022-05-27 07:00:00,7
166,410,576,92,20.2,3,Cloudy,13.4,2022-05-27 08:00:00,8
179,290,469,90,21.0,3,Cloudy,15.5,2022-05-27 09:00:00,9
185,247,432,86,22.1,3,Cloudy,15.2,2022-05-27 10:00:00,10
209,256,465,83,23.0,51,Light Drizzle,14.0,2022-05-27 11:00:00,11
120,167,287,82,23.5,51,Light Drizzle,14.1,2022-05-27 12:00:00,12
96,130,226,77,24.7,51,Light Drizzle,21.9,2022-05-27 13:00:00,13
189,242,431,79,24.3,61,Light Rain,22.0,2022-05-27 14:00:00,14
307,403,710,94,21.9,51,Light Drizzle,21.9,2022-05-27 15:00:00,15
310,432,742,88,23.1,2,Partly Cloudy,18.6,2022-05-27 16:00:00,16
356,471,827,83,23.6,2,Partly Cloudy,16.3,2022-05-27 17:00:00,17
323,456,779,82,22.8,53,Heavy Drizzle,12.1,2022-05-27 18:00:00,18
317,356,673,88,21.8,51,Light Drizzle,10.8,2022-05-27 19:00:00,19
214,206,420,93,21.0,51,Light Drizzle,7.7,2022-05-27 20:00:00,20
63,99,162,95,20.5,51,Light Drizzle,8.0,2022-05-27 21:00:00,21
55,81,136,97,19.8,61,Light Rain,6.8,2022-05-27 22:00:00,22
82,94,176,98,19.5,61,Light Rain,8.0,2022-05-27 23:00:00,23
83,73,156,98,19.3,53,Heavy Drizzle,8.2,2022-05-28 00:00:00,0
58,50,108,98,19.3,53,Heavy Drizzle,9.2,2022-05-28 01:00:00,1
34,40,74,98,19.1,55,Heavy Drizzle,11.0,2022-05-28 02:00:00,2
27,17,44,98,18.1,2,Partly Cloudy,10.7,2022-05-28 03:00:00,3
11,7,18,98,17.7,1,Mostly Clear,9.4,2022-05-28 04:00:00,4
16,15,31,98,17.2,0,Clear,9.5,2022-05-28 05:00:00,5
35,61,96,97,16.6,2,Partly Cloudy,7.7,2022-05-28 06:00:00,6
66,102,168,94,16.9,1,Mostly Clear,10.1,2022-05-28 07:00:00,7
155,239,394,86,18.2,0,Clear,9.0,2022-05-28 08:00:00,8
291,327,618,76,19.2,1,Mostly Clear,10.7,2022-05-28 09:00:00,9
457,411,868,69,20.4,1,Mostly Clear,14.5,2022-05-28 10:00:00,10
692,473,1165,61,21.6,1,Mostly Clear,14.3,2022-05-28 11:00:00,11
707,462,1169,55,22.9,1,Mostly Clear,13.9,2022-05-28 12:00:00,12
740,493,1233,49,24.0,1,Mostly Clear,15.3,2022-05-28 13:00:00,13
775,470,1245,46,24.6,1,Mostly Clear,15.0,2022-05-28 14:00:00,14
768,419,1187,46,25.1,1,Mostly Clear,11.6,2022-05-28 15:00:00,15
662,401,1063,46,25.4,1,Mostly Clear,10.5,2022-05-28 16:00:00,16
709,363,1072,47,25.5,2,Partly Cloudy,10.7,2022-05-28 17:00:00,17
544,422,966,48,25.4,1,Mostly Clear,11.5,2022-05-28 18:00:00,18
480,366,846,54,24.6,0,Clear,10.5,2022-05-28 19:00:00,19
380,235,615,60,23.3,0,Clear,9.5,2022-05-28 20:00:00,20
333,202,535,62,22.0,0,Clear,9.7,2022-05-28 21:00:00,21
247,160,407,67,21.0,0,Clear,10.2,2022-05-28 22:00:00,22
153,139,292,71,20.2,0,Clear,11.3,2022-05-28 23:00:00,23
127,104,231,75,19.5,0,Clear,11.3,2022-05-29 00:00:00,0
99,78,177,79,18.9,0,Clear,11.2,2022-05-29 01:00:00,1
57,50,107,83,18.1,0,Clear,11.5,2022-05-29 02:00:00,2
41,19,60,83,17.8,0,Clear,10.2,2022-05-29 03:00:00,3
18,12,30,86,17.0,0,Clear,8.9,2022-05-29 04:00:00,4
27,12,39,88,16.3,0,Clear,8.2,2022-05-29 05:00:00,5
38,44,82,90,15.5,0,Clear,5.6,2022-05-29 06:00:00,6
68,126,194,90,16.4,1,Mostly Clear,8.2,2022-05-29 07:00:00,7
174,165,339,74,19.6,1,Mostly Clear,5.8,2022-05-29 08:00:00,8
374,249,623,67,21.0,1,Mostly Clear,4.7,2022-05-29 09:00:00,9
511,355,866,63,22.6,1,Mostly Clear,2.5,2022-05-29 10:00:00,10
686,373,1059,56,23.9,1,Mostly Clear,1.9,2022-05-29 11:00:00,11
817,421,1238,51,25.3,2,Partly Cloudy,1.8,2022-05-29 12:00:00,12
952,455,1407,47,26.3,2,Partly Cloudy,3.4,2022-05-29 13:00:00,13
859,436,1295,46,26.1,2,Partly Cloudy,2.2,2022-05-29 14:00:00,14
822,398,1220,42,27.4,2,Partly Cloudy,1.8,2022-05-29 15:00:00,15
750,418,1168,41,27.5,3,Cloudy,2.9,2022-05-29 16:00:00,16
740,416,1156,43,27.3,2,Partly Cloudy,4.7,2022-05-29 17:00:00,17
672,387,1059,47,26.7,3,Cloudy,6.5,2022-05-29 18:00:00,18
533,342,875,53,25.8,2,Partly Cloudy,5.1,2022-05-29 19:00:00,19
431,284,715,63,24.1,0,Clear,9.1,2022-05-29 20:00:00,20
277,240,517,69,22.4,0,Clear,8.3,2022-05-29 21:00:00,21
193,157,350,76,21.2,0,Clear,7.9,2022-05-29 22:00:00,22
153,140,293,81,20.2,0,Clear,8.9,2022-05-29 23:00:00,23
138,72,210,85,19.4,0,Clear,7.6,2022-05-30 00:00:00,0
76,60,136,89,18.6,0,Clear,8.7,2022-05-30 01:00:00,1
44,18,62,91,18.1,0,Clear,19.1,2022-05-30 02:00:00,2
25,22,47,91,18.1,0,Clear,20.4,2022-05-30 03:00:00,3
22,11,33,93,17.8,1,Mostly Clear,20.1,2022-05-30 04:00:00,4
26,12,38,94,17.6,1,Mostly Clear,18.7,2022-05-30 05:00:00,5
40,64,104,94,17.4,1,Mostly Clear,17.7,2022-05-30 06:00:00,6
72,114,186,94,18.3,0,Clear,17.1,2022-05-30 07:00:00,7
150,185,335,80,21.4,0,Clear,15.3,2022-05-30 08:00:00,8
308,275,583,70,23.8,0,Clear,14.5,2022-05-30 09:00:00,9
533,331,864,61,26.2,0,Clear,14.7,2022-05-30 10:00:00,10
585,346,931,52,28.2,0,Clear,16.0,2022-05-30 11:00:00,11
588,417,1005,46,29.7,0,Clear,15.1,2022-05-30 12:00:00,12
607,494,1101,43,30.7,1,Mostly Clear,13.8,2022-05-30 13:00:00,13
606,416,1022,41,31.5,1,Mostly Clear,14.4,2022-05-30 14:00:00,14
555,423,978,44,31.6,1,Mostly Clear,15.5,2022-05-30 15:00:00,15
558,428,986,42,32.1,1,Mostly Clear,16.4,2022-05-30 16:00:00,16
512,388,900,43,31.9,0,Clear,16.3,2022-05-30 17:00:00,17
491,380,871,44,31.4,0,Clear,16.7,2022-05-30 18:00:00,18
371,344,715,52,29.8,0,Clear,17.8,2022-05-30 19:00:00,19
280,259,539,63,27.6,0,Clear,17.0,2022-05-30 20:00:00,20
211,205,416,68,25.7,0,Clear,19.8,2022-05-30 21:00:00,21
127,114,241,72,24.7,0,Clear,20.2,2022-05-30 22:00:00,22
62,72,134,76,23.9,0,Clear,20.4,2022-05-30 23:00:00,23
44,19,63,79,23.2,0,Clear,21.0,2022-05-31 00:00:00,0
13,11,24,81,22.6,0,Clear,21.1,2022-05-31 01:00:00,1
7,3,10,83,22.1,1,Mostly Clear,20.7,2022-05-31 02:00:00,2
8,11,19,87,21.4,1,Mostly Clear,20.1,2022-05-31 03:00:00,3
12,12,24,90,20.7,0,Clear,18.7,2022-05-31 04:00:00,4
24,48,72,92,20.1,0,Clear,17.8,2022-05-31 05:00:00,5
63,152,215,93,19.4,0,Clear,14.2,2022-05-31 06:00:00,6
137,414,551,92,20.4,0,Clear,14.2,2022-05-31 07:00:00,7
188,616,804,75,24.1,0,Clear,14.5,2022-05-31 08:00:00,8
206,378,584,65,26.8,0,Clear,14.2,2022-05-31 09:00:00,9
197,234,431,55,29.5,0,Clear,15.8,2022-05-31 10:00:00,10
223,228,451,45,31.7,0,Clear,14.3,2022-05-31 11:00:00,11
193,283,476,39,33.0,0,Clear,14.5,2022-05-31 12:00:00,12
211,283,494,36,33.3,1,Mostly Clear,14.5,2022-05-31 13:00:00,13
236,248,484,36,33.6,1,Mostly Clear,16.3,2022-05-31 14:00:00,14
254,345,599,36,34.0,0,Clear,16.5,2022-05-31 15:00:00,15
229,427,656,35,34.3,0,Clear,18.9,2022-05-31 16:00:00,16
422,706,1128,35,34.2,1,Mostly Clear,14.5,2022-05-31 17:00:00,17
446,751,1197,40,33.1,1,Mostly Clear,7.1,2022-05-31 18:00:00,18
369,568,937,59,31.3,1,Mostly Clear,6.8,2022-05-31 19:00:00,19
253,412,665,59,30.1,1,Mostly Clear,5.0,2022-05-31 20:00:00,20
232,267,499,58,28.0,0,Clear,2.8,2022-05-31 21:00:00,21
155,182,337,55,27.2,0,Clear,6.0,2022-05-31 22:00:00,22
83,88,171,62,25.6,0,Clear,6.0,2022-05-31 23:00:00,23
41,25,66,71,23.9,0,Clear,6.0,2022-06-01 00:00:00,0
11,15,26,76,22.6,0,Clear,6.0,2022-06-01 01:00:00,1
8,11,19,79,21.9,0,Clear,6.0,2022-06-01 02:00:00,2
4,4,8,80,22.5,1,Mostly Clear,6.0,2022-06-01 03:00:00,3
7,21,28,80,22.4,1,Mostly Clear,6.0,2022-06-01 04:00:00,4
27,70,97,78,22.5,1,Mostly Clear,6.0,2022-06-01 05:00:00,5
78,223,301,79,22.4,2,Partly Cloudy,6.0,2022-06-01 06:00:00,6
150,474,624,77,23.2,1,Mostly Clear,6.0,2022-06-01 07:00:00,7
237,706,943,65,26.2,1,Mostly Clear,6.0,2022-06-01 08:00:00,8
212,360,572,57,28.6,1,Mostly Clear,6.0,2022-06-01 09:00:00,9
173,215,388,51,30.6,1,Mostly Clear,6.0,2022-06-01 10:00:00,10
191,209,400,44,31.9,1,Mostly Clear,6.0,2022-06-01 11:00:00,11
207,287,494,40,32.5,2,Partly Cloudy,6.0,2022-06-01 12:00:00,12
210,254,464,38,33.1,1,Mostly Clear,6.0,2022-06-01 13:00:00,13
223,242,465,36,33.7,2,Partly Cloudy,6.0,2022-06-01 14:00:00,14
232,369,601,34,34.0,1,Mostly Clear,6.0,2022-06-01 15:00:00,15
285,465,750,34,34.0,1,Mostly Clear,6.0,2022-06-01 16:00:00,16
455,790,1245,34,33.5,1,Mostly Clear,6.0,2022-06-01 17:00:00,17
522,725,1247,43,32.3,1,Mostly Clear,6.0,2022-06-01 18:00:00,18
374,549,923,54,31.2,2,Partly Cloudy,6.0,2022-06-01 19:00:00,19
337,410,747,58,29.9,1,Mostly Clear,8.1,2022-06-01 20:00:00,20
188,266,454,57,28.1,0,Clear,8.8,2022-06-01 21:00:00,21
153,179,332,61,26.1,1,Mostly Clear,7.9,2022-06-01 22:00:00,22
72,104,176,61,25.3,1,Mostly Clear,7.7,2022-06-01 23:00:00,23
44,55,99,64,24.7,1,Mostly Clear,8.9,2022-06-02 00:00:00,0
15,13,28,68,24.2,2,Partly Cloudy,7.4,2022-06-02 01:00:00,1
5,11,16,71,23.8,1,Mostly Clear,6.5,2022-06-02 02:00:00,2
7,12,19,79,22.5,1,Mostly Clear,6.6,2022-06-02 03:00:00,3
7,13,20,83,21.8,1,Mostly Clear,7.8,2022-06-02 04:00:00,4
22,64,86,86,21.1,1,Mostly Clear,7.5,2022-06-02 05:00:00,5
60,185,245,88,20.8,2,Partly Cloudy,7.6,2022-06-02 06:00:00,6
133,431,564,88,21.9,2,Partly Cloudy,6.4,2022-06-02 07:00:00,7
268,702,970,75,24.8,1,Mostly Clear,3.6,2022-06-02 08:00:00,8
219,393,612,65,27.4,0,Clear,2.2,2022-06-02 09:00:00,9
218,221,439,57,29.3,1,Mostly Clear,2.6,2022-06-02 10:00:00,10
219,240,459,52,30.8,1,Mostly Clear,3.3,2022-06-02 11:00:00,11
242,311,553,47,32.1,0,Clear,4.1,2022-06-02 12:00:00,12
248,230,478,44,32.6,1,Mostly Clear,5.3,2022-06-02 13:00:00,13
154,190,344,43,32.8,1,Mostly Clear,5.4,2022-06-02 14:00:00,14
124,192,316,44,32.6,2,Partly Cloudy,5.5,2022-06-02 15:00:00,15
183,316,499,61,28.3,61,Light Rain,11.5,2022-06-02 16:00:00,16
117,318,435,84,25.3,63,Rain,9.3,2022-06-02 17:00:00,17
161,373,534,86,24.7,61,Light Rain,4.4,2022-06-02 18:00:00,18
252,403,655,87,24.5,53,Heavy Drizzle,1.1,2022-06-02 19:00:00,19
189,340,529,89,23.9,2,Partly Cloudy,2.6,2022-06-02 20:00:00,20
108,182,290,91,23.5,3,Cloudy,6.0,2022-06-02 21:00:00,21
88,131,219,94,22.8,2,Partly Cloudy,8.0,2022-06-02 22:00:00,22
42,51,93,95,22.3,53,Heavy Drizzle,9.4,2022-06-02 23:00:00,23
40,36,76,94,22.1,1,Mostly Clear,8.8,2022-06-03 00:00:00,0
15,15,30,93,21.7,1,Mostly Clear,6.0,2022-06-03 01:00:00,1
9,4,13,92,21.4,1,Mostly Clear,6.8,2022-06-03 02:00:00,2
4,11,15,96,21.0,1,Mostly Clear,11.0,2022-06-03 03:00:00,3
9,11,20,94,20.4,1,Mostly Clear,14.6,2022-06-03 04:00:00,4
27,54,81,91,19.8,1,Mostly Clear,15.3,2022-06-03 05:00:00,5
69,175,244,88,19.0,1,Mostly Clear,12.3,2022-06-03 06:00:00,6
118,396,514,84,18.9,1,Mostly Clear,12.8,2022-06-03 07:00:00,7
226,561,787,73,19.3,1,Mostly Clear,14.0,2022-06-03 08:00:00,8
189,339,528,60,20.3,1,Mostly Clear,15.0,2022-06-03 09:00:00,9
262,255,517,51,21.6,1,Mostly Clear,14.7,2022-06-03 10:00:00,10
268,295,563,43,23.0,1,Mostly Clear,14.7,2022-06-03 11:00:00,11
326,357,683,36,24.4,1,Mostly Clear,14.5,2022-06-03 12:00:00,12
366,346,712,33,25.5,1,Mostly Clear,13.7,2022-06-03 13:00:00,13
394,402,796,31,26.2,1,Mostly Clear,13.2,2022-06-03 14:00:00,14
434,482,916,31,26.4,1,Mostly Clear,13.5,2022-06-03 15:00:00,15
507,568,1075,32,26.4,1,Mostly Clear,13.9,2022-06-03 16:00:00,16
625,797,1422,33,26.5,1,Mostly Clear,14.3,2022-06-03 17:00:00,17
567,691,1258,35,26.2,1,Mostly Clear,11.6,2022-06-03 18:00:00,18
505,511,1016,38,25.4,1,Mostly Clear,7.7,2022-06-03 19:00:00,19
448,379,827,47,24.0,1,Mostly Clear,4.8,2022-06-03 20:00:00,20
300,257,557,45,22.6,0,Clear,7.6,2022-06-03 21:00:00,21
225,230,455,50,21.4,0,Clear,7.4,2022-06-03 22:00:00,22
180,199,379,57,20.1,0,Clear,7.9,2022-06-03 23:00:00,23
144,142,286,65,18.7,0,Clear,8.7,2022-06-04 00:00:00,0
110,85,195,71,17.5,1,Mostly Clear,9.2,2022-06-04 01:00:00,1
60,59,119,74,16.6,1,Mostly Clear,9.2,2022-06-04 02:00:00,2
38,23,61,72,16.6,1,Mostly Clear,9.4,2022-06-04 03:00:00,3
10,6,16,74,16.0,0,Clear,9.2,2022-06-04 04:00:00,4
26,21,47,77,15.4,0,Clear,8.2,2022-06-04 05:00:00,5
26,61,87,80,14.8,0,Clear,5.6,2022-06-04 06:00:00,6
79,149,228,80,16.0,0,Clear,7.1,2022-06-04 07:00:00,7
207,209,416,58,20.4,0,Clear,5.1,2022-06-04 08:00:00,8
350,380,730,48,23.0,0,Clear,6.6,2022-06-04 09:00:00,9
500,516,1016,36,25.4,0,Clear,8.5,2022-06-04 10:00:00,10
645,564,1209,30,26.7,0,Clear,8.9,2022-06-04 11:00:00,11
678,519,1197,28,27.6,0,Clear,8.8,2022-06-04 12:00:00,12
692,526,1218,27,28.4,0,Clear,8.7,2022-06-04 13:00:00,13
758,538,1296,26,29.0,1,Mostly Clear,10.2,2022-06-04 14:00:00,14
673,570,1243,25,29.4,1,Mostly Clear,10.2,2022-06-04 15:00:00,15
641,530,1171,25,29.4,0,Clear,9.8,2022-06-04 16:00:00,16
645,471,1116,26,29.3,0,Clear,9.0,2022-06-04 17:00:00,17
589,450,1039,28,28.6,0,Clear,8.9,2022-06-04 18:00:00,18
552,398,950,41,27.0,0,Clear,6.6,2022-06-04 19:00:00,19
432,341,773,54,24.9,0,Clear,3.9,2022-06-04 20:00:00,20
344,267,611,48,23.5,0,Clear,4.3,2022-06-04 21:00:00,21
275,210,485,48,23.0,1,Mostly Clear,3.1,2022-06-04 22:00:00,22
196,202,398,65,19.9,1,Mostly Clear,3.2,2022-06-04 23:00:00,23
174,118,292,68,18.3,1,Mostly Clear,6.6,2022-06-05 00:00:00,0
123,83,206,64,17.9,1,Mostly Clear,7.7,2022-06-05 01:00:00,1
59,62,121,59,17.7,1,Mostly Clear,11.2,2022-06-05 02:00:00,2
36,27,63,58,17.8,1,Mostly Clear,14.1,2022-06-05 03:00:00,3
8,11,19,54,17.6,1,Mostly Clear,14.8,2022-06-05 04:00:00,4
14,17,31,51,17.3,1,Mostly Clear,14.0,2022-06-05 05:00:00,5
16,57,73,54,16.9,0,Clear,12.9,2022-06-05 06:00:00,6
60,111,171,57,17.1,0,Clear,12.5,2022-06-05 07:00:00,7
124,190,314,52,18.6,0,Clear,13.8,2022-06-05 08:00:00,8
286,283,569,48,20.0,0,Clear,14.9,2022-06-05 09:00:00,9
442,420,862,43,21.4,0,Clear,14.7,2022-06-05 10:00:00,10
512,479,991,39,22.7,0,Clear,13.7,2022-06-05 11:00:00,11
567,513,1080,37,23.9,0,Clear,12.3,2022-06-05 12:00:00,12
692,526,1218,37,24.8,0,Clear,11.4,2022-06-05 13:00:00,13
642,541,1183,36,25.4,0,Clear,10.8,2022-06-05 14:00:00,14
624,530,1154,35,25.5,0,Clear,10.1,2022-06-05 15:00:00,15
587,514,1101,35,25.6,0,Clear,10.3,2022-06-05 16:00:00,16
570,505,1075,37,25.3,0,Clear,11.2,2022-06-05 17:00:00,17
540,431,971,39,24.6,0,Clear,7.6,2022-06-05 18:00:00,18
482,428,910,42,23.6,0,Clear,8.8,2022-06-05 19:00:00,19
341,318,659,49,22.2,0,Clear,9.3,2022-06-05 20:00:00,20
198,187,385,52,20.8,0,Clear,9.4,2022-06-05 21:00:00,21
164,169,333,57,19.6,0,Clear,9.5,2022-06-05 22:00:00,22
70,75,145,63,18.4,0,Clear,8.5,2022-06-05 23:00:00,23
32,21,53,70,17.2,0,Clear,7.2,2022-06-06 00:00:00,0
11,17,28,74,16.4,0,Clear,6.6,2022-06-06 01:00:00,1
3,10,13,72,16.4,0,Clear,5.7,2022-06-06 02:00:00,2
4,4,8,73,16.5,0,Clear,6.2,2022-06-06 03:00:00,3
11,20,31,71,17.4,0,Clear,6.5,2022-06-06 04:00:00,4
33,55,88,74,17.0,0,Clear,6.8,2022-06-06 05:00:00,5
55,178,233,76,16.8,0,Clear,5.8,2022-06-06 06:00:00,6
145,422,567,76,17.4,0,Clear,4.7,2022-06-06 07:00:00,7
231,641,872,63,19.6,0,Clear,2.8,2022-06-06 08:00:00,8
230,339,569,44,22.0,0,Clear,5.0,2022-06-06 09:00:00,9
220,240,460,36,23.6,0,Clear,8.5,2022-06-06 10:00:00,10
213,278,491,32,25.1,0,Clear,10.2,2022-06-06 11:00:00,11
324,321,645,29,26.2,0,Clear,11.3,2022-06-06 12:00:00,12
331,268,599,29,27.0,0,Clear,13.2,2022-06-06 13:00:00,13
336,299,635,28,27.5,0,Clear,14.0,2022-06-06 14:00:00,14
336,388,724,30,27.5,0,Clear,14.8,2022-06-06 15:00:00,15
401,490,891,30,27.5,0,Clear,16.4,2022-06-06 16:00:00,16
531,863,1394,32,27.0,1,Mostly Clear,17.4,2022-06-06 17:00:00,17
571,806,1377,34,26.2,1,Mostly Clear,15.9,2022-06-06 18:00:00,18
451,540,991,37,24.9,1,Mostly Clear,16.3,2022-06-06 19:00:00,19
338,435,773,43,23.3,1,Mostly Clear,16.1,2022-06-06 20:00:00,20
233,257,490,45,21.8,1,Mostly Clear,15.0,2022-06-06 21:00:00,21
149,167,316,50,20.8,0,Clear,14.4,2022-06-06 22:00:00,22
79,81,160,55,20.0,0,Clear,14.8,2022-06-06 23:00:00,23
20,36,56,61,19.3,1,Mostly Clear,14.5,2022-06-07 00:00:00,0
7,11,18,67,18.8,1,Mostly Clear,13.4,2022-06-07 01:00:00,1
2,9,11,73,18.5,1,Mostly Clear,12.5,2022-06-07 02:00:00,2
2,8,10,80,18.1,1,Mostly Clear,11.6,2022-06-07 03:00:00,3
8,12,20,84,17.9,1,Mostly Clear,11.6,2022-06-07 04:00:00,4
28,60,88,86,17.9,1,Mostly Clear,11.7,2022-06-07 05:00:00,5
87,207,294,88,17.9,1,Mostly Clear,10.1,2022-06-07 06:00:00,6
183,478,661,86,18.7,1,Mostly Clear,10.0,2022-06-07 07:00:00,7
296,802,1098,79,20.3,1,Mostly Clear,11.9,2022-06-07 08:00:00,8
201,403,604,72,22.0,1,Mostly Clear,18.1,2022-06-07 09:00:00,9
217,257,474,64,23.9,2,Partly Cloudy,17.0,2022-06-07 10:00:00,10
253,269,522,54,25.8,2,Partly Cloudy,19.5,2022-06-07 11:00:00,11
277,316,593,49,26.8,3,Cloudy,19.9,2022-06-07 12:00:00,12
282,283,565,46,27.3,3,Cloudy,19.9,2022-06-07 13:00:00,13
289,297,586,57,25.3,55,Heavy Drizzle,17.4,2022-06-07 14:00:00,14
186,266,452,51,26.6,2,Partly Cloudy,16.7,2022-06-07 15:00:00,15
174,236,410,53,26.2,51,Light Drizzle,16.2,2022-06-07 16:00:00,16
259,454,713,60,25.1,51,Light Drizzle,15.2,2022-06-07 17:00:00,17
306,619,925,71,23.7,51,Light Drizzle,4.4,2022-06-07 18:00:00,18
162,318,480,78,22.8,51,Light Drizzle,7.6,2022-06-07 19:00:00,19
127,229,356,80,22.5,51,Light Drizzle,9.9,2022-06-07 20:00:00,20
88,155,243,81,22.0,3,Cloudy,8.7,2022-06-07 21:00:00,21
84,145,229,82,21.7,3,Cloudy,7.6,2022-06-07 22:00:00,22
40,79,119,83,21.5,1,Mostly Clear,7.9,2022-06-07 23:00:00,23
19,31,50,83,21.2,1,Mostly Clear,8.3,2022-06-08 00:00:00,0
10,4,14,83,21.0,1,Mostly Clear,9.6,2022-06-08 01:00:00,1
6,6,12,84,20.8,1,Mostly Clear,10.2,2022-06-08 02:00:00,2
2,3,5,94,20.2,1,Mostly Clear,9.5,2022-06-08 03:00:00,3
8,15,23,95,19.8,1,Mostly Clear,8.5,2022-06-08 04:00:00,4
22,77,99,97,19.4,1,Mostly Clear,7.6,2022-06-08 05:00:00,5
68,211,279,97,19.1,1,Mostly Clear,6.1,2022-06-08 06:00:00,6
163,491,654,97,19.8,0,Clear,6.2,2022-06-08 07:00:00,7
296,795,1091,89,21.5,0,Clear,3.8,2022-06-08 08:00:00,8
225,393,618,81,22.7,0,Clear,4.2,2022-06-08 09:00:00,9
232,247,479,72,24.3,0,Clear,3.4,2022-06-08 10:00:00,10
270,269,539,61,26.4,0,Clear,3.2,2022-06-08 11:00:00,11
308,302,610,55,27.9,1,Mostly Clear,3.6,2022-06-08 12:00:00,12
270,305,575,52,28.7,1,Mostly Clear,3.5,2022-06-08 13:00:00,13
273,259,532,49,29.5,2,Partly Cloudy,1.5,2022-06-08 14:00:00,14
306,393,699,51,29.9,2,Partly Cloudy,3.2,2022-06-08 15:00:00,15
366,529,895,52,29.8,51,Light Drizzle,5.6,2022-06-08 16:00:00,16
503,863,1366,53,29.6,1,Mostly Clear,7.9,2022-06-08 17:00:00,17
405,761,1166,64,27.5,61,Light Rain,8.0,2022-06-08 18:00:00,18
167,352,519,69,26.8,2,Partly Cloudy,7.9,2022-06-08 19:00:00,19
175,300,475,75,25.9,3,Cloudy,8.7,2022-06-08 20:00:00,20
143,268,411,78,24.9,53,Heavy Drizzle,9.1,2022-06-08 21:00:00,21
120,165,285,84,24.1,51,Light Drizzle,8.0,2022-06-08 22:00:00,22
147,139,286,87,23.4,53,Heavy Drizzle,8.2,2022-06-08 23:00:00,23
55,56,111,90,22.9,51,Light Drizzle,9.8,2022-06-09 00:00:00,0
25,14,39,94,22.5,2,Partly Cloudy,12.6,2022-06-09 01:00:00,1
4,1,5,96,22.3,2,Partly Cloudy,15.2,2022-06-09 02:00:00,2
1,4,5,96,22.5,1,Mostly Clear,16.5,2022-06-09 03:00:00,3
6,18,24,96,22.4,3,Cloudy,15.9,2022-06-09 04:00:00,4
20,53,73,96,22.4,3,Cloudy,13.0,2022-06-09 05:00:00,5
56,210,266,96,22.5,2,Partly Cloudy,10.7,2022-06-09 06:00:00,6
137,437,574,96,22.6,1,Mostly Clear,11.9,2022-06-09 07:00:00,7
277,732,1009,89,23.9,0,Clear,11.5,2022-06-09 08:00:00,8
233,439,672,77,25.0,0,Clear,17.1,2022-06-09 09:00:00,9
222,264,486,62,26.0,0,Clear,22.1,2022-06-09 10:00:00,10
259,249,508,49,27.0,1,Mostly Clear,21.3,2022-06-09 11:00:00,11
302,333,635,45,27.7,2,Partly Cloudy,21.9,2022-06-09 12:00:00,12
321,286,607,42,28.1,2,Partly Cloudy,21.8,2022-06-09 13:00:00,13
278,321,599,41,28.3,3,Cloudy,21.2,2022-06-09 14:00:00,14
292,373,665,41,27.3,3,Cloudy,21.4,2022-06-09 15:00:00,15
419,508,927,40,26.9,3,Cloudy,22.1,2022-06-09 16:00:00,16
623,907,1530,40,26.0,2,Partly Cloudy,21.9,2022-06-09 17:00:00,17
614,863,1477,42,25.3,1,Mostly Clear,17.8,2022-06-09 18:00:00,18
487,676,1163,43,24.8,0,Clear,17.8,2022-06-09 19:00:00,19
386,479,865,46,23.8,0,Clear,15.7,2022-06-09 20:00:00,20
288,346,634,48,22.6,0,Clear,13.3,2022-06-09 21:00:00,21
207,263,470,51,21.6,0,Clear,12.2,2022-06-09 22:00:00,22
137,149,286,54,20.6,0,Clear,10.5,2022-06-09 23:00:00,23
65,78,143,58,19.5,0,Clear,8.5,2022-06-10 00:00:00,0
36,32,68,64,18.3,0,Clear,8.4,2022-06-10 01:00:00,1
19,14,33,69,17.3,0,Clear,7.4,2022-06-10 02:00:00,2
4,11,15,75,16.2,0,Clear,8.1,2022-06-10 03:00:00,3
12,12,24,78,15.5,0,Clear,7.8,2022-06-10 04:00:00,4
22,55,77,81,14.9,0,Clear,7.2,2022-06-10 05:00:00,5
66,169,235,84,14.4,0,Clear,6.8,2022-06-10 06:00:00,6
125,345,470,82,15.9,0,Clear,8.9,2022-06-10 07:00:00,7
247,603,850,61,19.6,0,Clear,8.7,2022-06-10 08:00:00,8
229,375,604,51,21.8,0,Clear,8.5,2022-06-10 09:00:00,9
315,286,601,44,23.6,0,Clear,9.0,2022-06-10 10:00:00,10
363,354,717,38,25.1,1,Mostly Clear,10.8,2022-06-10 11:00:00,11
365,383,748,35,26.0,1,Mostly Clear,9.5,2022-06-10 12:00:00,12
409,397,806,36,25.7,2,Partly Cloudy,10.3,2022-06-10 13:00:00,13
417,396,813,35,26.3,2,Partly Cloudy,10.5,2022-06-10 14:00:00,14
502,496,998,36,26.5,3,Cloudy,9.6,2022-06-10 15:00:00,15
551,638,1189,35,26.7,2,Partly Cloudy,8.9,2022-06-10 16:00:00,16
719,812,1531,34,26.9,2,Partly Cloudy,8.5,2022-06-10 17:00:00,17
669,684,1353,36,26.2,2,Partly Cloudy,6.9,2022-06-10 18:00:00,18
521,543,1064,45,25.2,1,Mostly Clear,4.7,2022-06-10 19:00:00,19
410,410,820,57,23.9,2,Partly Cloudy,3.3,2022-06-10 20:00:00,20
340,297,637,60,22.3,1,Mostly Clear,2.5,2022-06-10 21:00:00,21
268,273,541,62,21.6,2,Partly Cloudy,0.7,2022-06-10 22:00:00,22
206,218,424,61,21.4,3,Cloudy,3.5,2022-06-10 23:00:00,23
155,163,318,64,20.8,3,Cloudy,4.0,2022-06-11 00:00:00,0
119,118,237,71,19.6,3,Cloudy,4.4,2022-06-11 01:00:00,1
84,58,142,73,19.2,1,Mostly Clear,4.5,2022-06-11 02:00:00,2
39,37,76,72,18.8,1,Mostly Clear,6.0,2022-06-11 03:00:00,3
13,25,38,71,18.5,2,Partly Cloudy,8.1,2022-06-11 04:00:00,4
10,19,29,67,18.8,2,Partly Cloudy,8.9,2022-06-11 05:00:00,5
26,56,82,69,18.6,51,Light Drizzle,11.1,2022-06-11 06:00:00,6
40,70,110,76,18.1,51,Light Drizzle,9.8,2022-06-11 07:00:00,7
65,122,187,85,17.4,61,Light Rain,6.5,2022-06-11 08:00:00,8
140,170,310,88,17.6,53,Heavy Drizzle,5.2,2022-06-11 09:00:00,9
216,279,495,85,18.6,53,Heavy Drizzle,5.0,2022-06-11 10:00:00,10
392,378,770,81,19.3,55,Heavy Drizzle,4.2,2022-06-11 11:00:00,11
422,433,855,78,19.6,51,Light Drizzle,3.0,2022-06-11 12:00:00,12
532,484,1016,73,20.6,51,Light Drizzle,4.0,2022-06-11 13:00:00,13
628,481,1109,66,22.1,2,Partly Cloudy,2.8,2022-06-11 14:00:00,14
668,474,1142,71,22.2,2,Partly Cloudy,2.5,2022-06-11 15:00:00,15
562,422,984,64,23.6,1,Mostly Clear,2.5,2022-06-11 16:00:00,16
620,491,1111,63,23.8,2,Partly Cloudy,1.5,2022-06-11 17:00:00,17
529,472,1001,63,23.8,2,Partly Cloudy,2.2,2022-06-11 18:00:00,18
575,416,991,71,22.3,55,Heavy Drizzle,3.6,2022-06-11 19:00:00,19
387,334,721,80,21.2,51,Light Drizzle,5.0,2022-06-11 20:00:00,20
319,312,631,86,20.3,51,Light Drizzle,6.1,2022-06-11 21:00:00,21
300,203,503,88,20.0,51,Light Drizzle,7.0,2022-06-11 22:00:00,22
261,203,464,90,19.6,51,Light Drizzle,6.2,2022-06-11 23:00:00,23
176,132,308,93,19.0,51,Light Drizzle,5.8,2022-06-12 00:00:00,0
139,99,238,95,18.7,51,Light Drizzle,6.6,2022-06-12 01:00:00,1
77,84,161,95,18.7,51,Light Drizzle,6.5,2022-06-12 02:00:00,2
56,32,88,95,18.4,1,Mostly Clear,5.8,2022-06-12 03:00:00,3
15,17,32,95,18.0,1,Mostly Clear,5.1,2022-06-12 04:00:00,4
8,17,25,94,18.4,2,Partly Cloudy,5.8,2022-06-12 05:00:00,5
36,27,63,94,18.4,2,Partly Cloudy,4.0,2022-06-12 06:00:00,6
45,65,110,97,18.6,51,Light Drizzle,4.3,2022-06-12 07:00:00,7
77,132,209,94,20.2,51,Light Drizzle,4.6,2022-06-12 08:00:00,8
149,189,338,94,20.7,53,Heavy Drizzle,7.2,2022-06-12 09:00:00,9
292,257,549,94,21.0,61,Light Rain,9.3,2022-06-12 10:00:00,10
308,382,690,88,21.7,61,Light Rain,9.0,2022-06-12 11:00:00,11
569,425,994,82,23.2,51,Light Drizzle,9.4,2022-06-12 12:00:00,12
606,533,1139,76,24.7,51,Light Drizzle,10.3,2022-06-12 13:00:00,13
668,540,1208,71,26.4,2,Partly Cloudy,9.9,2022-06-12 14:00:00,14
628,545,1173,75,25.6,2,Partly Cloudy,9.4,2022-06-12 15:00:00,15
654,519,1173,73,26.5,2,Partly Cloudy,10.2,2022-06-12 16:00:00,16
602,535,1137,73,26.7,2,Partly Cloudy,11.4,2022-06-12 17:00:00,17
571,485,1056,74,25.9,51,Light Drizzle,9.0,2022-06-12 18:00:00,18
464,422,886,78,25.2,51,Light Drizzle,7.5,2022-06-12 19:00:00,19
344,327,671,84,24.6,1,Mostly Clear,7.2,2022-06-12 20:00:00,20
226,265,491,89,23.7,1,Mostly Clear,7.5,2022-06-12 21:00:00,21
136,137,273,93,23.0,1,Mostly Clear,9.5,2022-06-12 22:00:00,22
69,109,178,96,22.4,2,Partly Cloudy,9.8,2022-06-12 23:00:00,23
32,37,69,96,22.2,1,Mostly Clear,10.0,2022-06-13 00:00:00,0
25,15,40,96,22.1,1,Mostly Clear,8.1,2022-06-13 01:00:00,1
16,10,26,96,21.8,1,Mostly Clear,4.9,2022-06-13 02:00:00,2
2,7,9,97,21.6,51,Light Drizzle,7.2,2022-06-13 03:00:00,3
3,18,21,98,21.2,1,Mostly Clear,5.5,2022-06-13 04:00:00,4
29,50,79,98,20.7,0,Clear,5.1,2022-06-13 05:00:00,5
83,206,289,99,20.6,2,Partly Cloudy,6.5,2022-06-13 06:00:00,6
129,412,541,98,21.5,1,Mostly Clear,3.6,2022-06-13 07:00:00,7
217,639,856,94,23.2,1,Mostly Clear,2.5,2022-06-13 08:00:00,8
204,359,563,87,24.4,1,Mostly Clear,1.1,2022-06-13 09:00:00,9
240,223,463,77,26.0,1,Mostly Clear,1.6,2022-06-13 10:00:00,10
242,259,501,66,27.9,0,Clear,1.1,2022-06-13 11:00:00,11
291,304,595,58,29.7,0,Clear,4.0,2022-06-13 12:00:00,12
292,310,602,53,31.0,1,Mostly Clear,5.9,2022-06-13 13:00:00,13
288,282,570,50,32.3,1,Mostly Clear,7.0,2022-06-13 14:00:00,14
311,362,673,49,33.0,1,Mostly Clear,7.4,2022-06-13 15:00:00,15
376,461,837,48,32.8,1,Mostly Clear,7.9,2022-06-13 16:00:00,16
501,831,1332,49,32.5,1,Mostly Clear,8.3,2022-06-13 17:00:00,17
463,858,1321,52,31.6,2,Partly Cloudy,4.2,2022-06-13 18:00:00,18
235,402,637,55,31.2,2,Partly Cloudy,0.7,2022-06-13 19:00:00,19
188,342,530,69,29.5,2,Partly Cloudy,4.1,2022-06-13 20:00:00,20
142,232,374,73,27.9,1,Mostly Clear,5.6,2022-06-13 21:00:00,21
126,168,294,78,26.7,1,Mostly Clear,5.4,2022-06-13 22:00:00,22
95,115,210,75,26.8,1,Mostly Clear,4.9,2022-06-13 23:00:00,23
25,39,64,76,26.6,1,Mostly Clear,4.9,2022-06-14 00:00:00,0
10,11,21,85,25.0,0,Clear,5.4,2022-06-14 01:00:00,1
6,4,10,85,24.8,1,Mostly Clear,6.8,2022-06-14 02:00:00,2
2,7,9,96,22.9,1,Mostly Clear,5.8,2022-06-14 03:00:00,3
5,9,14,95,23.5,1,Mostly Clear,4.5,2022-06-14 04:00:00,4
25,45,70,97,23.1,3,Cloudy,2.6,2022-06-14 05:00:00,5
59,195,254,99,22.2,1,Mostly Clear,4.2,2022-06-14 06:00:00,6
165,462,627,98,23.3,3,Cloudy,7.1,2022-06-14 07:00:00,7
262,710,972,95,24.5,51,Light Drizzle,10.4,2022-06-14 08:00:00,8
208,402,610,95,24.6,51,Light Drizzle,8.4,2022-06-14 09:00:00,9
204,203,407,94,25.0,63,Rain,4.5,2022-06-14 10:00:00,10
257,224,481,98,24.2,63,Rain,4.9,2022-06-14 11:00:00,11
218,325,543,99,24.0,65,Heavy Rain,8.0,2022-06-14 12:00:00,12
221,277,498,98,23.8,63,Rain,8.6,2022-06-14 13:00:00,13
222,205,427,95,23.9,53,Heavy Drizzle,7.2,2022-06-14 14:00:00,14
285,394,679,80,24.9,3,Cloudy,9.4,2022-06-14 15:00:00,15
369,525,894,70,26.8,2,Partly Cloudy,11.4,2022-06-14 16:00:00,16
548,929,1477,64,27.8,3,Cloudy,11.8,2022-06-14 17:00:00,17
536,873,1409,61,28.1,1,Mostly Clear,11.8,2022-06-14 18:00:00,18
437,667,1104,63,27.7,1,Mostly Clear,9.4,2022-06-14 19:00:00,19
305,481,786,71,26.6,1,Mostly Clear,4.8,2022-06-14 20:00:00,20
244,408,652,78,24.9,1,Mostly Clear,5.1,2022-06-14 21:00:00,21
242,291,533,82,23.6,0,Clear,6.3,2022-06-14 22:00:00,22
115,138,253,85,22.7,0,Clear,5.6,2022-06-14 23:00:00,23
40,36,76,87,22.0,0,Clear,4.5,2022-06-15 00:00:00,0
9,9,18,87,21.6,0,Clear,3.8,2022-06-15 01:00:00,1
7,8,15,90,20.8,0,Clear,4.6,2022-06-15 02:00:00,2
2,6,8,97,19.6,0,Clear,4.7,2022-06-15 03:00:00,3
13,15,28,98,19.5,0,Clear,5.6,2022-06-15 04:00:00,4
32,71,103,98,19.3,0,Clear,5.8,2022-06-15 05:00:00,5
71,225,296,99,18.9,2,Partly Cloudy,4.0,2022-06-15 06:00:00,6
153,446,599,95,20.5,0,Clear,5.4,2022-06-15 07:00:00,7
320,821,1141,83,23.1,0,Clear,2.3,2022-06-15 08:00:00,8
229,426,655,71,25.4,1,Mostly Clear,0.8,2022-06-15 09:00:00,9
254,252,506,61,27.3,1,Mostly Clear,1.5,2022-06-15 10:00:00,10
251,293,544,53,28.7,2,Partly Cloudy,2.5,2022-06-15 11:00:00,11
266,341,607,48,30.0,2,Partly Cloudy,4.6,2022-06-15 12:00:00,12
242,299,541,46,30.8,1,Mostly Clear,4.9,2022-06-15 13:00:00,13
281,315,596,45,31.5,1,Mostly Clear,2.6,2022-06-15 14:00:00,14
291,388,679,50,32.0,2,Partly Cloudy,4.8,2022-06-15 15:00:00,15
358,500,858,49,32.2,3,Cloudy,5.2,2022-06-15 16:00:00,16
518,887,1405,51,31.6,3,Cloudy,10.8,2022-06-15 17:00:00,17
569,876,1445,55,30.2,3,Cloudy,10.0,2022-06-15 18:00:00,18
490,599,1089,60,28.7,1,Mostly Clear,8.4,2022-06-15 19:00:00,19
385,472,857,65,27.6,1,Mostly Clear,9.0,2022-06-15 20:00:00,20
340,347,687,66,26.4,1,Mostly Clear,11.0,2022-06-15 21:00:00,21
210,226,436,65,25.9,0,Clear,11.3,2022-06-15 22:00:00,22
109,129,238,65,25.2,3,Cloudy,11.5,2022-06-15 23:00:00,23
51,57,108,65,24.6,3,Cloudy,14.3,2022-06-16 00:00:00,0
29,25,54,64,24.2,3,Cloudy,14.6,2022-06-16 01:00:00,1
13,4,17,65,23.8,3,Cloudy,15.1,2022-06-16 02:00:00,2
11,9,20,73,23.0,51,Light Drizzle,13.0,2022-06-16 03:00:00,3
8,23,31,80,22.0,61,Light Rain,12.6,2022-06-16 04:00:00,4
30,54,84,88,20.9,63,Rain,14.2,2022-06-16 05:00:00,5
49,168,217,92,20.4,63,Rain,10.5,2022-06-16 06:00:00,6
142,372,514,92,20.3,63,Rain,8.5,2022-06-16 07:00:00,7
291,762,1053,92,20.6,3,Cloudy,10.9,2022-06-16 08:00:00,8
203,428,631,88,21.4,3,Cloudy,13.3,2022-06-16 09:00:00,9
252,276,528,81,22.7,2,Partly Cloudy,10.8,2022-06-16 10:00:00,10
252,283,535,75,24.6,3,Cloudy,12.6,2022-06-16 11:00:00,11
267,314,581,71,26.6,3,Cloudy,14.4,2022-06-16 12:00:00,12
299,299,598,66,28.9,3,Cloudy,15.7,2022-06-16 13:00:00,13
333,330,663,63,30.3,3,Cloudy,14.3,2022-06-16 14:00:00,14
344,384,728,77,27.6,51,Light Drizzle,13.3,2022-06-16 15:00:00,15
385,584,969,75,28.2,3,Cloudy,14.4,2022-06-16 16:00:00,16
454,701,1155,75,28.8,51,Light Drizzle,11.9,2022-06-16 17:00:00,17
439,673,1112,79,28.2,3,Cloudy,6.8,2022-06-16 18:00:00,18
431,562,993,83,27.5,51,Light Drizzle,9.4,2022-06-16 19:00:00,19
340,466,806,86,27.0,1,Mostly Clear,10.2,2022-06-16 20:00:00,20
295,338,633,89,26.3,1,Mostly Clear,9.1,2022-06-16 21:00:00,21
230,209,439,93,25.6,0,Clear,6.7,2022-06-16 22:00:00,22
154,170,324,95,25.0,1,Mostly Clear,9.7,2022-06-16 23:00:00,23
85,90,175,96,24.9,1,Mostly Clear,10.4,2022-06-17 00:00:00,0
30,45,75,96,24.8,1,Mostly Clear,8.7,2022-06-17 01:00:00,1
22,17,39,95,24.6,1,Mostly Clear,8.4,2022-06-17 02:00:00,2
7,5,12,89,24.0,1,Mostly Clear,8.7,2022-06-17 03:00:00,3
12,19,31,90,23.9,1,Mostly Clear,8.7,2022-06-17 04:00:00,4
22,57,79,91,23.7,0,Clear,9.3,2022-06-17 05:00:00,5
73,194,267,91,23.6,0,Clear,6.8,2022-06-17 06:00:00,6
125,337,462,88,24.4,0,Clear,8.0,2022-06-17 07:00:00,7
226,513,739,78,27.0,0,Clear,7.4,2022-06-17 08:00:00,8
261,350,611,70,29.0,0,Clear,8.7,2022-06-17 09:00:00,9
294,282,576,64,30.6,0,Clear,12.9,2022-06-17 10:00:00,10
292,305,597,56,32.1,0,Clear,18.1,2022-06-17 11:00:00,11
308,364,672,49,33.3,1,Mostly Clear,20.6,2022-06-17 12:00:00,12
304,343,647,43,34.2,0,Clear,22.4,2022-06-17 13:00:00,13
284,372,656,40,34.5,1,Mostly Clear,23.3,2022-06-17 14:00:00,14
384,404,788,36,34.6,0,Clear,21.6,2022-06-17 15:00:00,15
459,526,985,35,34.3,0,Clear,24.7,2022-06-17 16:00:00,16
528,679,1207,40,32.6,51,Light Drizzle,21.3,2022-06-17 17:00:00,17
484,584,1068,42,31.8,1,Mostly Clear,19.1,2022-06-17 18:00:00,18
427,445,872,44,30.7,0,Clear,17.4,2022-06-17 19:00:00,19
357,393,750,47,29.2,0,Clear,13.6,2022-06-17 20:00:00,20
324,319,643,48,27.6,0,Clear,12.0,2022-06-17 21:00:00,21
312,212,524,48,26.4,0,Clear,13.2,2022-06-17 22:00:00,22
340,197,537,47,25.4,0,Clear,13.8,2022-06-17 23:00:00,23
306,181,487,47,24.4,0,Clear,11.7,2022-06-18 00:00:00,0
132,93,225,50,23.3,0,Clear,10.5,2022-06-18 01:00:00,1
96,48,144,54,22.1,0,Clear,10.1,2022-06-18 02:00:00,2
36,34,70,58,21.4,0,Clear,11.2,2022-06-18 03:00:00,3
20,14,34,58,20.9,0,Clear,12.4,2022-06-18 04:00:00,4
24,23,47,57,20.9,0,Clear,14.8,2022-06-18 05:00:00,5
46,71,117,58,20.9,0,Clear,15.1,2022-06-18 06:00:00,6
77,134,211,59,20.9,0,Clear,16.6,2022-06-18 07:00:00,7
187,255,442,52,21.1,0,Clear,21.1,2022-06-18 08:00:00,8
294,392,686,48,20.9,1,Mostly Clear,24.5,2022-06-18 09:00:00,9
484,419,903,48,21.0,3,Cloudy,24.9,2022-06-18 10:00:00,10
597,533,1130,47,21.5,3,Cloudy,24.3,2022-06-18 11:00:00,11
727,545,1272,46,21.8,3,Cloudy,24.8,2022-06-18 12:00:00,12
777,508,1285,44,22.6,2,Partly Cloudy,28.6,2022-06-18 13:00:00,13
799,534,1333,42,23.2,2,Partly Cloudy,27.0,2022-06-18 14:00:00,14
879,533,1412,41,23.5,1,Mostly Clear,26.6,2022-06-18 15:00:00,15
783,493,1276,39,23.9,0,Clear,25.5,2022-06-18 16:00:00,16
752,458,1210,37,24.0,0,Clear,24.1,2022-06-18 17:00:00,17
580,475,1055,36,23.6,0,Clear,19.5,2022-06-18 18:00:00,18
536,408,944,35,23.1,0,Clear,17.9,2022-06-18 19:00:00,19
477,348,825,37,22.2,0,Clear,15.5,2022-06-18 20:00:00,20
374,288,662,35,21.2,0,Clear,16.8,2022-06-18 21:00:00,21
295,209,504,36,20.4,0,Clear,17.2,2022-06-18 22:00:00,22
261,222,483,37,19.6,0,Clear,17.3,2022-06-18 23:00:00,23
265,172,437,39,18.8,0,Clear,17.9,2022-06-19 00:00:00,0
133,91,224,41,18.0,0,Clear,17.6,2022-06-19 01:00:00,1
102,70,172,43,17.2,0,Clear,15.2,2022-06-19 02:00:00,2
29,24,53,42,16.7,0,Clear,13.4,2022-06-19 03:00:00,3
20,7,27,44,16.0,0,Clear,12.5,2022-06-19 04:00:00,4
16,20,36,46,15.4,0,Clear,12.0,2022-06-19 05:00:00,5
27,36,63,50,14.9,0,Clear,11.2,2022-06-19 06:00:00,6
76,85,161,55,15.0,0,Clear,12.4,2022-06-19 07:00:00,7
131,186,317,49,16.5,0,Clear,14.5,2022-06-19 08:00:00,8
272,297,569,44,18.0,0,Clear,16.1,2022-06-19 09:00:00,9
485,369,854,39,19.3,0,Clear,17.8,2022-06-19 10:00:00,10
608,427,1035,35,20.6,0,Clear,18.3,2022-06-19 11:00:00,11
705,483,1188,32,22.0,0,Clear,19.6,2022-06-19 12:00:00,12
771,515,1286,29,23.2,0,Clear,20.6,2022-06-19 13:00:00,13
747,453,1200,28,24.2,0,Clear,21.5,2022-06-19 14:00:00,14
800,511,1311,27,24.7,0,Clear,22.1,2022-06-19 15:00:00,15
784,426,1210,26,25.2,0,Clear,22.2,2022-06-19 16:00:00,16
734,484,1218,26,25.2,0,Clear,22.0,2022-06-19 17:00:00,17
566,421,987,27,24.9,0,Clear,19.2,2022-06-19 18:00:00,18
491,368,859,28,24.2,0,Clear,16.4,2022-06-19 19:00:00,19
451,254,705,34,22.9,0,Clear,11.5,2022-06-19 20:00:00,20
296,221,517,33,21.4,0,Clear,9.7,2022-06-19 21:00:00,21
244,167,411,37,20.2,1,Mostly Clear,10.3,2022-06-19 22:00:00,22
214,135,349,41,18.9,1,Mostly Clear,11.6,2022-06-19 23:00:00,23
199,92,291,45,17.8,1,Mostly Clear,11.7,2022-06-20 00:00:00,0
54,28,82,50,16.7,0,Clear,12.3,2022-06-20 01:00:00,1
27,13,40,55,15.6,0,Clear,11.8,2022-06-20 02:00:00,2
8,8,16,56,14.7,0,Clear,9.9,2022-06-20 03:00:00,3
7,18,25,62,13.7,0,Clear,9.1,2022-06-20 04:00:00,4
29,34,63,66,13.0,0,Clear,9.5,2022-06-20 05:00:00,5
57,93,150,72,12.4,2,Partly Cloudy,6.3,2022-06-20 06:00:00,6
71,179,250,74,13.8,0,Clear,8.9,2022-06-20 07:00:00,7
174,256,430,51,17.8,0,Clear,5.6,2022-06-20 08:00:00,8
241,284,525,45,20.0,0,Clear,6.8,2022-06-20 09:00:00,9
346,322,668,37,21.9,0,Clear,7.6,2022-06-20 10:00:00,10
510,418,928,32,23.6,0,Clear,9.0,2022-06-20 11:00:00,11
491,480,971,28,25.0,1,Mostly Clear,10.4,2022-06-20 12:00:00,12
589,424,1013,26,25.7,1,Mostly Clear,12.0,2022-06-20 13:00:00,13
605,476,1081,25,26.5,2,Partly Cloudy,11.7,2022-06-20 14:00:00,14
661,492,1153,24,26.3,0,Clear,12.0,2022-06-20 15:00:00,15
619,543,1162,23,26.9,0,Clear,11.7,2022-06-20 16:00:00,16
586,631,1217,23,26.9,0,Clear,12.7,2022-06-20 17:00:00,17
534,589,1123,25,26.6,1,Mostly Clear,12.2,2022-06-20 18:00:00,18
460,447,907,32,25.5,1,Mostly Clear,10.4,2022-06-20 19:00:00,19
374,363,737,57,23.6,1,Mostly Clear,5.4,2022-06-20 20:00:00,20
234,262,496,29,24.7,1,Mostly Clear,5.9,2022-06-20 21:00:00,21
156,142,298,31,23.9,1,Mostly Clear,7.6,2022-06-20 22:00:00,22
85,80,165,35,22.9,1,Mostly Clear,11.0,2022-06-20 23:00:00,23
29,19,48,44,21.0,1,Mostly Clear,12.5,2022-06-21 00:00:00,0
20,6,26,62,17.9,1,Mostly Clear,10.5,2022-06-21 01:00:00,1
9,9,18,63,17.3,1,Mostly Clear,8.4,2022-06-21 02:00:00,2
7,8,15,79,16.9,1,Mostly Clear,7.9,2022-06-21 03:00:00,3
15,20,35,80,16.5,1,Mostly Clear,8.4,2022-06-21 04:00:00,4
29,66,95,82,16.2,1,Mostly Clear,8.2,2022-06-21 05:00:00,5
53,198,251,84,15.9,1,Mostly Clear,5.2,2022-06-21 06:00:00,6
177,446,623,79,17.7,2,Partly Cloudy,9.6,2022-06-21 07:00:00,7
263,724,987,61,21.0,2,Partly Cloudy,5.4,2022-06-21 08:00:00,8
215,367,582,54,22.5,2,Partly Cloudy,4.0,2022-06-21 09:00:00,9
199,204,403,49,23.7,2,Partly Cloudy,4.5,2022-06-21 10:00:00,10
236,252,488,47,24.1,2,Partly Cloudy,3.4,2022-06-21 11:00:00,11
275,306,581,43,25.4,1,Mostly Clear,5.7,2022-06-21 12:00:00,12
273,275,548,38,27.8,1,Mostly Clear,6.1,2022-06-21 13:00:00,13
287,282,569,35,29.4,1,Mostly Clear,6.3,2022-06-21 14:00:00,14
352,378,730,38,29.8,1,Mostly Clear,6.8,2022-06-21 15:00:00,15
367,473,840,37,30.7,1,Mostly Clear,7.1,2022-06-21 16:00:00,16
627,840,1467,37,31.1,1,Mostly Clear,6.6,2022-06-21 17:00:00,17
617,810,1427,38,31.1,1,Mostly Clear,8.4,2022-06-21 18:00:00,18
471,613,1084,43,30.2,0,Clear,9.5,2022-06-21 19:00:00,19
389,488,877,46,27.9,0,Clear,9.4,2022-06-21 20:00:00,20
251,324,575,53,25.2,0,Clear,9.7,2022-06-21 21:00:00,21
215,223,438,59,23.8,0,Clear,12.2,2022-06-21 22:00:00,22
99,85,184,63,22.8,0,Clear,10.0,2022-06-21 23:00:00,23
51,24,75,67,22.0,0,Clear,8.3,2022-06-22 00:00:00,0
19,17,36,70,21.3,0,Clear,7.6,2022-06-22 01:00:00,1
5,7,12,72,20.6,0,Clear,7.0,2022-06-22 02:00:00,2
3,4,7,79,20.0,1,Mostly Clear,6.8,2022-06-22 03:00:00,3
8,14,22,82,19.4,1,Mostly Clear,6.5,2022-06-22 04:00:00,4
30,71,101,84,19.0,1,Mostly Clear,6.1,2022-06-22 05:00:00,5
79,228,307,85,19.0,2,Partly Cloudy,6.3,2022-06-22 06:00:00,6
190,451,641,81,20.7,2,Partly Cloudy,7.1,2022-06-22 07:00:00,7
284,806,1090,64,23.5,2,Partly Cloudy,5.0,2022-06-22 08:00:00,8
244,429,673,61,25.3,1,Mostly Clear,5.6,2022-06-22 09:00:00,9
233,253,486,55,27.7,1,Mostly Clear,2.8,2022-06-22 10:00:00,10
293,275,568,60,27.3,53,Heavy Drizzle,0.5,2022-06-22 11:00:00,11
256,294,550,71,26.5,61,Light Rain,0.8,2022-06-22 12:00:00,12
223,269,492,73,27.0,63,Rain,3.4,2022-06-22 13:00:00,13
219,245,464,77,26.6,63,Rain,5.4,2022-06-22 14:00:00,14
277,348,625,66,28.8,51,Light Drizzle,6.9,2022-06-22 15:00:00,15
224,330,554,66,29.1,51,Light Drizzle,7.2,2022-06-22 16:00:00,16
314,583,897,66,28.7,2,Partly Cloudy,7.9,2022-06-22 17:00:00,17
383,686,1069,69,27.6,2,Partly Cloudy,13.2,2022-06-22 18:00:00,18
332,509,841,76,25.6,53,Heavy Drizzle,14.8,2022-06-22 19:00:00,19
127,219,346,90,23.0,63,Rain,11.9,2022-06-22 20:00:00,20
35,62,97,95,21.8,63,Rain,9.8,2022-06-22 21:00:00,21
47,69,116,98,21.2,61,Light Rain,6.7,2022-06-22 22:00:00,22
27,44,71,98,20.8,63,Rain,6.5,2022-06-22 23:00:00,23
9,19,28,99,20.3,63,Rain,8.1,2022-06-23 00:00:00,0
6,10,16,99,19.9,61,Light Rain,11.9,2022-06-23 01:00:00,1
4,7,11,99,19.7,61,Light Rain,14.8,2022-06-23 02:00:00,2
5,8,13,99,19.8,53,Heavy Drizzle,14.5,2022-06-23 03:00:00,3
8,11,19,99,19.3,51,Light Drizzle,12.4,2022-06-23 04:00:00,4
20,47,67,98,18.9,53,Heavy Drizzle,10.7,2022-06-23 05:00:00,5
51,156,207,98,18.7,55,Heavy Drizzle,10.1,2022-06-23 06:00:00,6
117,316,433,97,18.7,61,Light Rain,9.4,2022-06-23 07:00:00,7
139,390,529,97,18.8,61,Light Rain,6.6,2022-06-23 08:00:00,8
102,220,322,95,19.2,55,Heavy Drizzle,7.9,2022-06-23 09:00:00,9
70,128,198,95,19.2,53,Heavy Drizzle,9.4,2022-06-23 10:00:00,10
124,167,291,93,19.6,53,Heavy Drizzle,10.1,2022-06-23 11:00:00,11
160,246,406,92,19.8,53,Heavy Drizzle,7.7,2022-06-23 12:00:00,12
171,271,442,93,19.9,51,Light Drizzle,7.6,2022-06-23 13:00:00,13
191,257,448,93,19.9,53,Heavy Drizzle,8.3,2022-06-23 14:00:00,14
241,284,525,93,19.8,3,Cloudy,8.5,2022-06-23 15:00:00,15
323,482,805,87,20.1,3,Cloudy,8.0,2022-06-23 16:00:00,16
498,791,1289,82,20.6,3,Cloudy,7.6,2022-06-23 17:00:00,17
529,722,1251,78,21.1,3,Cloudy,3.8,2022-06-23 18:00:00,18
488,612,1100,76,21.2,3,Cloudy,5.1,2022-06-23 19:00:00,19
334,450,784,80,20.7,2,Partly Cloudy,5.8,2022-06-23 20:00:00,20
278,302,580,85,19.7,0,Clear,4.5,2022-06-23 21:00:00,21
215,226,441,93,18.5,0,Clear,3.9,2022-06-23 22:00:00,22
108,142,250,92,18.2,0,Clear,1.3,2022-06-23 23:00:00,23
45,71,116,92,18.6,0,Clear,2.7,2022-06-24 00:00:00,0
48,37,85,95,18.2,0,Clear,3.9,2022-06-24 01:00:00,1
15,12,27,98,17.3,0,Clear,3.9,2022-06-24 02:00:00,2
3,13,16,97,18.1,1,Mostly Clear,2.2,2022-06-24 03:00:00,3
4,15,19,98,17.6,3,Cloudy,2.8,2022-06-24 04:00:00,4
35,50,85,98,17.6,3,Cloudy,3.1,2022-06-24 05:00:00,5
58,169,227,98,17.6,3,Cloudy,2.9,2022-06-24 06:00:00,6
146,341,487,97,17.8,3,Cloudy,2.1,2022-06-24 07:00:00,7
241,592,833,93,19.6,1,Mostly Clear,1.5,2022-06-24 08:00:00,8
238,365,603,79,21.5,2,Partly Cloudy,3.7,2022-06-24 09:00:00,9
317,287,604,69,23.3,3,Cloudy,2.7,2022-06-24 10:00:00,10
372,313,685,65,24.5,3,Cloudy,2.1,2022-06-24 11:00:00,11
397,407,804,62,25.4,3,Cloudy,2.4,2022-06-24 12:00:00,12
468,395,863,58,26.5,51,Light Drizzle,3.9,2022-06-24 13:00:00,13
499,385,884,55,27.1,51,Light Drizzle,5.9,2022-06-24 14:00:00,14
468,514,982,60,26.2,2,Partly Cloudy,5.9,2022-06-24 15:00:00,15
525,628,1153,60,26.5,3,Cloudy,5.5,2022-06-24 16:00:00,16
768,846,1614,59,26.8,3,Cloudy,7.1,2022-06-24 17:00:00,17
580,746,1326,61,26.5,1,Mostly Clear,3.2,2022-06-24 18:00:00,18
586,590,1176,66,25.9,1,Mostly Clear,6.6,2022-06-24 19:00:00,19
503,441,944,74,24.6,1,Mostly Clear,8.4,2022-06-24 20:00:00,20
365,307,672,79,23.2,0,Clear,7.9,2022-06-24 21:00:00,21
298,288,586,84,22.2,0,Clear,6.5,2022-06-24 22:00:00,22
241,217,458,88,21.4,0,Clear,6.1,2022-06-24 23:00:00,23
126,157,283,92,20.5,0,Clear,7.1,2022-06-25 00:00:00,0
149,98,247,93,19.9,0,Clear,8.5,2022-06-25 01:00:00,1
78,62,140,94,19.7,0,Clear,8.4,2022-06-25 02:00:00,2
29,23,52,96,19.3,0,Clear,6.6,2022-06-25 03:00:00,3
8,16,24,97,18.7,0,Clear,6.7,2022-06-25 04:00:00,4
16,31,47,98,18.2,0,Clear,7.4,2022-06-25 05:00:00,5
32,54,86,98,17.9,0,Clear,5.3,2022-06-25 06:00:00,6
86,146,232,97,19.2,0,Clear,5.1,2022-06-25 07:00:00,7
212,229,441,87,22.0,0,Clear,3.6,2022-06-25 08:00:00,8
344,319,663,79,24.0,0,Clear,3.9,2022-06-25 09:00:00,9
509,411,920,70,26.0,0,Clear,4.2,2022-06-25 10:00:00,10
551,471,1022,59,27.7,1,Mostly Clear,5.1,2022-06-25 11:00:00,11
631,492,1123,52,28.7,1,Mostly Clear,5.8,2022-06-25 12:00:00,12
695,483,1178,48,29.6,1,Mostly Clear,6.1,2022-06-25 13:00:00,13
675,524,1199,45,30.2,1,Mostly Clear,6.3,2022-06-25 14:00:00,14
678,527,1205,48,30.3,2,Partly Cloudy,6.6,2022-06-25 15:00:00,15
670,525,1195,47,30.4,1,Mostly Clear,6.9,2022-06-25 16:00:00,16
637,447,1084,50,30.0,1,Mostly Clear,9.9,2022-06-25 17:00:00,17
557,470,1027,55,29.2,1,Mostly Clear,7.6,2022-06-25 18:00:00,18
559,486,1045,62,27.9,1,Mostly Clear,9.0,2022-06-25 19:00:00,19
567,414,981,70,26.3,0,Clear,11.4,2022-06-25 20:00:00,20
441,289,730,73,24.9,0,Clear,10.8,2022-06-25 21:00:00,21
311,225,536,75,23.8,0,Clear,10.0,2022-06-25 22:00:00,22
276,259,535,76,23.0,0,Clear,10.4,2022-06-25 23:00:00,23
224,168,392,75,22.3,0,Clear,11.2,2022-06-26 00:00:00,0
118,103,221,75,21.7,0,Clear,11.5,2022-06-26 01:00:00,1
99,75,174,76,21.3,0,Clear,11.9,2022-06-26 02:00:00,2
44,47,91,83,21.5,0,Clear,10.8,2022-06-26 03:00:00,3
12,14,26,84,21.0,0,Clear,10.1,2022-06-26 04:00:00,4
15,16,31,84,20.7,0,Clear,10.1,2022-06-26 05:00:00,5
36,36,72,85,20.4,1,Mostly Clear,8.3,2022-06-26 06:00:00,6
67,78,145,84,21.0,1,Mostly Clear,10.1,2022-06-26 07:00:00,7
155,176,331,74,23.0,1,Mostly Clear,10.5,2022-06-26 08:00:00,8
315,296,611,69,24.3,1,Mostly Clear,10.7,2022-06-26 09:00:00,9
452,380,832,63,26.4,1,Mostly Clear,10.8,2022-06-26 10:00:00,10
535,445,980,56,28.4,1,Mostly Clear,12.2,2022-06-26 11:00:00,11
543,484,1027,52,29.6,1,Mostly Clear,13.5,2022-06-26 12:00:00,12
522,511,1033,48,30.8,1,Mostly Clear,14.1,2022-06-26 13:00:00,13
541,467,1008,47,31.5,1,Mostly Clear,15.1,2022-06-26 14:00:00,14
477,444,921,50,31.6,0,Clear,16.6,2022-06-26 15:00:00,15
525,429,954,49,31.8,0,Clear,17.7,2022-06-26 16:00:00,16
501,421,922,50,31.3,2,Partly Cloudy,17.3,2022-06-26 17:00:00,17
430,439,869,56,29.8,51,Light Drizzle,10.1,2022-06-26 18:00:00,18
368,289,657,59,28.6,51,Light Drizzle,10.1,2022-06-26 19:00:00,19
234,207,441,64,27.6,2,Partly Cloudy,5.6,2022-06-26 20:00:00,20
202,187,389,66,26.7,1,Mostly Clear,4.7,2022-06-26 21:00:00,21
141,151,292,69,25.8,1,Mostly Clear,5.7,2022-06-26 22:00:00,22
96,61,157,72,25.0,1,Mostly Clear,7.0,2022-06-26 23:00:00,23
45,36,81,74,24.6,1,Mostly Clear,8.6,2022-06-27 00:00:00,0
27,26,53,74,24.3,2,Partly Cloudy,9.0,2022-06-27 01:00:00,1
14,7,21,75,23.9,1,Mostly Clear,9.4,2022-06-27 02:00:00,2
11,8,19,85,23.2,1,Mostly Clear,10.0,2022-06-27 03:00:00,3
12,13,25,86,22.9,1,Mostly Clear,10.5,2022-06-27 04:00:00,4
25,47,72,87,22.7,1,Mostly Clear,10.0,2022-06-27 05:00:00,5
48,160,208,88,22.6,2,Partly Cloudy,8.9,2022-06-27 06:00:00,6
110,361,471,88,23.0,2,Partly Cloudy,9.6,2022-06-27 07:00:00,7
230,585,815,83,24.2,51,Light Drizzle,10.1,2022-06-27 08:00:00,8
209,364,573,80,25.3,53,Heavy Drizzle,8.7,2022-06-27 09:00:00,9
183,141,324,81,25.5,51,Light Drizzle,9.4,2022-06-27 10:00:00,10
223,226,449,83,24.8,63,Rain,11.6,2022-06-27 11:00:00,11
155,162,317,90,23.3,61,Light Rain,12.7,2022-06-27 12:00:00,12
86,98,184,88,22.7,55,Heavy Drizzle,10.7,2022-06-27 13:00:00,13
203,234,437,88,21.8,53,Heavy Drizzle,10.8,2022-06-27 14:00:00,14
321,335,656,68,25.7,2,Partly Cloudy,12.9,2022-06-27 15:00:00,15
373,442,815,56,27.2,2,Partly Cloudy,12.8,2022-06-27 16:00:00,16
511,785,1296,52,27.4,0,Clear,11.5,2022-06-27 17:00:00,17
562,797,1359,48,27.8,0,Clear,11.3,2022-06-27 18:00:00,18
428,569,997,51,27.3,0,Clear,6.8,2022-06-27 19:00:00,19
372,426,798,66,25.7,0,Clear,4.5,2022-06-27 20:00:00,20
255,301,556,65,23.7,0,Clear,7.5,2022-06-27 21:00:00,21
199,245,444,61,22.5,0,Clear,13.2,2022-06-27 22:00:00,22
107,116,223,51,22.3,0,Clear,15.1,2022-06-27 23:00:00,23
40,34,74,45,21.9,0,Clear,14.2,2022-06-28 00:00:00,0
10,9,19,44,21.3,0,Clear,14.8,2022-06-28 01:00:00,1
12,6,18,46,20.5,0,Clear,14.7,2022-06-28 02:00:00,2
7,4,11,49,20.0,0,Clear,13.1,2022-06-28 03:00:00,3
5,13,18,51,19.1,0,Clear,11.4,2022-06-28 04:00:00,4
22,69,91,55,18.2,0,Clear,10.2,2022-06-28 05:00:00,5
79,177,256,63,17.2,0,Clear,7.3,2022-06-28 06:00:00,6
165,458,623,70,17.2,0,Clear,9.0,2022-06-28 07:00:00,7
296,760,1056,58,19.8,0,Clear,7.5,2022-06-28 08:00:00,8
212,443,655,51,21.4,0,Clear,8.8,2022-06-28 09:00:00,9
229,240,469,44,22.7,0,Clear,13.7,2022-06-28 10:00:00,10
247,258,505,42,23.8,0,Clear,11.3,2022-06-28 11:00:00,11
286,337,623,39,24.8,0,Clear,8.9,2022-06-28 12:00:00,12
349,344,693,37,25.8,1,Mostly Clear,7.3,2022-06-28 13:00:00,13
301,290,591,36,26.7,1,Mostly Clear,6.3,2022-06-28 14:00:00,14
375,381,756,36,27.0,1,Mostly Clear,5.8,2022-06-28 15:00:00,15
472,531,1003,35,27.4,0,Clear,5.3,2022-06-28 16:00:00,16
653,938,1591,34,27.6,1,Mostly Clear,4.1,2022-06-28 17:00:00,17
649,893,1542,34,27.4,1,Mostly Clear,6.1,2022-06-28 18:00:00,18
472,639,1111,42,26.6,1,Mostly Clear,4.4,2022-06-28 19:00:00,19
422,463,885,50,25.0,1,Mostly Clear,2.2,2022-06-28 20:00:00,20
277,331,608,55,23.1,1,Mostly Clear,2.5,2022-06-28 21:00:00,21
203,270,473,63,21.9,1,Mostly Clear,6.2,2022-06-28 22:00:00,22
104,130,234,67,21.0,1,Mostly Clear,6.3,2022-06-28 23:00:00,23
29,50,79,71,20.0,1,Mostly Clear,6.5,2022-06-29 00:00:00,0
15,11,26,75,19.2,1,Mostly Clear,7.4,2022-06-29 01:00:00,1
10,8,18,78,18.6,1,Mostly Clear,7.6,2022-06-29 02:00:00,2
3,8,11,85,18.4,1,Mostly Clear,8.4,2022-06-29 03:00:00,3
7,13,20,85,18.2,1,Mostly Clear,8.8,2022-06-29 04:00:00,4
35,70,105,85,17.9,1,Mostly Clear,7.9,2022-06-29 05:00:00,5
92,205,297,86,17.5,0,Clear,4.9,2022-06-29 06:00:00,6
169,450,619,86,18.2,0,Clear,6.2,2022-06-29 07:00:00,7
284,747,1031,68,21.7,0,Clear,5.5,2022-06-29 08:00:00,8
261,457,718,59,23.7,0,Clear,7.1,2022-06-29 09:00:00,9
208,269,477,49,25.7,1,Mostly Clear,8.8,2022-06-29 10:00:00,10
228,286,514,44,27.1,1,Mostly Clear,10.4,2022-06-29 11:00:00,11
260,351,611,42,28.2,0,Clear,11.2,2022-06-29 12:00:00,12
235,309,544,40,29.2,2,Partly Cloudy,11.7,2022-06-29 13:00:00,13
292,291,583,38,29.9,2,Partly Cloudy,11.1,2022-06-29 14:00:00,14
326,354,680,45,29.2,2,Partly Cloudy,9.4,2022-06-29 15:00:00,15
367,517,884,45,29.6,2,Partly Cloudy,8.7,2022-06-29 16:00:00,16
593,933,1526,44,29.8,1,Mostly Clear,7.4,2022-06-29 17:00:00,17
618,793,1411,46,29.2,1,Mostly Clear,8.2,2022-06-29 18:00:00,18
564,621,1185,53,28.5,0,Clear,7.4,2022-06-29 19:00:00,19
385,479,864,56,27.0,0,Clear,5.5,2022-06-29 20:00:00,20
271,345,616,61,25.3,1,Mostly Clear,6.2,2022-06-29 21:00:00,21
212,227,439,67,24.2,1,Mostly Clear,6.2,2022-06-29 22:00:00,22
108,120,228,71,23.7,0,Clear,7.0,2022-06-29 23:00:00,23
52,57,109,73,23.2,1,Mostly Clear,6.8,2022-06-30 00:00:00,0
25,18,43,76,22.6,1,Mostly Clear,6.1,2022-06-30 01:00:00,1
12,8,20,80,21.9,0,Clear,5.4,2022-06-30 02:00:00,2
6,8,14,87,21.7,0,Clear,5.4,2022-06-30 03:00:00,3
6,19,25,90,21.0,0,Clear,4.6,2022-06-30 04:00:00,4
21,58,79,93,20.1,0,Clear,4.3,2022-06-30 05:00:00,5
69,181,250,93,19.8,0,Clear,4.7,2022-06-30 06:00:00,6
128,379,507,90,21.1,0,Clear,5.2,2022-06-30 07:00:00,7
280,698,978,81,23.3,0,Clear,4.0,2022-06-30 08:00:00,8
243,420,663,66,25.8,0,Clear,4.2,2022-06-30 09:00:00,9
214,245,459,52,27.8,0,Clear,6.3,2022-06-30 10:00:00,10
229,272,501,45,29.1,0,Clear,6.5,2022-06-30 11:00:00,11
266,327,593,42,30.1,0,Clear,6.6,2022-06-30 12:00:00,12
239,267,506,41,30.9,0,Clear,7.2,2022-06-30 13:00:00,13
274,306,580,39,31.5,0,Clear,7.0,2022-06-30 14:00:00,14
319,374,693,39,31.8,1,Mostly Clear,7.0,2022-06-30 15:00:00,15
365,450,815,38,32.0,2,Partly Cloudy,8.4,2022-06-30 16:00:00,16
499,813,1312,39,31.9,1,Mostly Clear,11.6,2022-06-30 17:00:00,17
565,751,1316,43,31.2,0,Clear,8.0,2022-06-30 18:00:00,18
444,645,1089,56,29.5,0,Clear,8.9,2022-06-30 19:00:00,19
412,499,911,70,27.6,0,Clear,10.1,2022-06-30 20:00:00,20
304,349,653,75,26.2,0,Clear,12.7,2022-06-30 21:00:00,21
213,267,480,78,25.3,0,Clear,12.7,2022-06-30 22:00:00,22
124,142,266,78,24.7,0,Clear,11.2,2022-06-30 23:00:00,23
72,87,159,77,24.3,0,Clear,9.7,2022-07-01 00:00:00,0
29,39,68,75,24.0,0,Clear,9.0,2022-07-01 01:00:00,1
13,26,39,73,23.8,0,Clear,10.1,2022-07-01 02:00:00,2
12,9,21,89,23.6,0,Clear,10.5,2022-07-01 03:00:00,3
19,14,33,86,23.4,0,Clear,10.5,2022-07-01 04:00:00,4
28,47,75,85,23.2,0,Clear,10.5,2022-07-01 05:00:00,5
59,143,202,85,22.9,0,Clear,8.6,2022-07-01 06:00:00,6
133,275,408,83,23.4,0,Clear,8.7,2022-07-01 07:00:00,7
214,467,681,74,25.4,0,Clear,8.7,2022-07-01 08:00:00,8
248,351,599,67,27.4,0,Clear,8.9,2022-07-01 09:00:00,9
306,271,577,60,29.4,0,Clear,9.1,2022-07-01 10:00:00,10
315,316,631,54,31.3,1,Mostly Clear,10.2,2022-07-01 11:00:00,11
318,366,684,47,32.8,1,Mostly Clear,11.3,2022-07-01 12:00:00,12
347,405,752,43,33.2,1,Mostly Clear,11.2,2022-07-01 13:00:00,13
372,465,837,43,33.2,1,Mostly Clear,11.4,2022-07-01 14:00:00,14
415,505,920,43,33.7,1,Mostly Clear,13.0,2022-07-01 15:00:00,15
456,549,1005,42,33.6,1,Mostly Clear,14.5,2022-07-01 16:00:00,16
508,644,1152,44,32.7,1,Mostly Clear,14.3,2022-07-01 17:00:00,17
405,478,883,51,31.0,51,Light Drizzle,11.6,2022-07-01 18:00:00,18
356,383,739,54,30.3,1,Mostly Clear,11.0,2022-07-01 19:00:00,19
333,333,666,58,29.4,1,Mostly Clear,9.5,2022-07-01 20:00:00,20
242,285,527,60,28.3,1,Mostly Clear,10.0,2022-07-01 21:00:00,21
247,233,480,63,27.7,1,Mostly Clear,11.7,2022-07-01 22:00:00,22
196,175,371,63,27.3,1,Mostly Clear,12.0,2022-07-01 23:00:00,23
122,136,258,64,26.9,1,Mostly Clear,12.1,2022-07-02 00:00:00,0
90,87,177,67,26.5,1,Mostly Clear,14.4,2022-07-02 01:00:00,1
77,58,135,70,26.0,2,Partly Cloudy,15.5,2022-07-02 02:00:00,2
35,17,52,73,25.6,2,Partly Cloudy,14.9,2022-07-02 03:00:00,3
13,19,32,75,25.3,1,Mostly Clear,14.1,2022-07-02 04:00:00,4
11,23,34,75,25.1,1,Mostly Clear,12.7,2022-07-02 05:00:00,5
52,61,113,78,24.6,1,Mostly Clear,8.0,2022-07-02 06:00:00,6
79,159,238,79,24.7,1,Mostly Clear,9.8,2022-07-02 07:00:00,7
192,256,448,76,25.7,1,Mostly Clear,11.2,2022-07-02 08:00:00,8
311,335,646,71,26.9,1,Mostly Clear,10.7,2022-07-02 09:00:00,9
481,406,887,66,28.2,1,Mostly Clear,9.8,2022-07-02 10:00:00,10
591,461,1052,60,29.6,1,Mostly Clear,9.3,2022-07-02 11:00:00,11
541,437,978,55,31.3,1,Mostly Clear,9.7,2022-07-02 12:00:00,12
611,422,1033,53,32.0,1,Mostly Clear,10.4,2022-07-02 13:00:00,13
598,424,1022,50,33.1,1,Mostly Clear,10.9,2022-07-02 14:00:00,14
591,413,1004,58,31.8,51,Light Drizzle,11.8,2022-07-02 15:00:00,15
556,365,921,57,32.1,1,Mostly Clear,11.7,2022-07-02 16:00:00,16
502,378,880,58,31.2,51,Light Drizzle,11.8,2022-07-02 17:00:00,17
378,371,749,67,29.3,63,Rain,5.3,2022-07-02 18:00:00,18
503,322,825,86,26.1,63,Rain,0.8,2022-07-02 19:00:00,19
266,212,478,93,24.6,63,Rain,5.1,2022-07-02 20:00:00,20
56,55,111,97,24.0,53,Heavy Drizzle,4.4,2022-07-02 21:00:00,21
142,123,265,98,23.8,51,Light Drizzle,1.8,2022-07-02 22:00:00,22
94,111,205,97,23.5,2,Partly Cloudy,3.4,2022-07-02 23:00:00,23
73,69,142,97,23.4,2,Partly Cloudy,7.3,2022-07-03 00:00:00,0
70,48,118,98,23.2,51,Light Drizzle,4.0,2022-07-03 01:00:00,1
43,26,69,98,23.0,53,Heavy Drizzle,3.6,2022-07-03 02:00:00,2
29,17,46,97,23.7,51,Light Drizzle,5.9,2022-07-03 03:00:00,3
5,9,14,98,23.4,2,Partly Cloudy,5.5,2022-07-03 04:00:00,4
13,15,28,98,23.2,2,Partly Cloudy,7.9,2022-07-03 05:00:00,5
25,37,62,98,22.9,51,Light Drizzle,6.4,2022-07-03 06:00:00,6
72,60,132,96,23.1,3,Cloudy,5.6,2022-07-03 07:00:00,7
165,155,320,89,23.6,2,Partly Cloudy,6.4,2022-07-03 08:00:00,8
307,216,523,77,24.0,2,Partly Cloudy,8.6,2022-07-03 09:00:00,9
436,319,755,63,25.1,1,Mostly Clear,9.4,2022-07-03 10:00:00,10
601,425,1026,53,26.5,2,Partly Cloudy,10.9,2022-07-03 11:00:00,11
698,382,1080,51,26.8,2,Partly Cloudy,11.0,2022-07-03 12:00:00,12
773,402,1175,46,28.0,2,Partly Cloudy,9.3,2022-07-03 13:00:00,13
685,430,1115,40,29.5,1,Mostly Clear,8.7,2022-07-03 14:00:00,14
764,389,1153,43,30.1,0,Clear,8.3,2022-07-03 15:00:00,15
746,441,1187,40,30.5,0,Clear,7.9,2022-07-03 16:00:00,16
790,390,1180,39,30.7,0,Clear,6.8,2022-07-03 17:00:00,17
720,441,1161,40,30.4,0,Clear,6.6,2022-07-03 18:00:00,18
592,364,956,50,29.4,0,Clear,5.4,2022-07-03 19:00:00,19
508,298,806,67,28.0,0,Clear,1.1,2022-07-03 20:00:00,20
417,260,677,66,26.2,0,Clear,1.3,2022-07-03 21:00:00,21
301,215,516,74,24.2,0,Clear,1.1,2022-07-03 22:00:00,22
220,172,392,76,23.6,0,Clear,3.2,2022-07-03 23:00:00,23
136,89,225,70,24.8,0,Clear,4.8,2022-07-04 00:00:00,0
117,60,177,86,21.2,0,Clear,6.0,2022-07-04 01:00:00,1
49,43,92,84,20.7,0,Clear,6.3,2022-07-04 02:00:00,2
28,17,45,84,20.3,0,Clear,8.8,2022-07-04 03:00:00,3
18,18,36,79,20.0,0,Clear,9.1,2022-07-04 04:00:00,4
21,28,49,69,20.0,0,Clear,10.4,2022-07-04 05:00:00,5
35,71,106,64,19.7,0,Clear,10.6,2022-07-04 06:00:00,6
70,108,178,68,19.9,0,Clear,10.6,2022-07-04 07:00:00,7
207,180,387,61,22.3,0,Clear,7.8,2022-07-04 08:00:00,8
395,302,697,57,24.2,0,Clear,7.7,2022-07-04 09:00:00,9
597,378,975,54,25.8,0,Clear,7.1,2022-07-04 10:00:00,10
714,412,1126,50,27.3,0,Clear,6.2,2022-07-04 11:00:00,11
719,401,1120,44,28.5,1,Mostly Clear,5.9,2022-07-04 12:00:00,12
852,497,1349,40,29.4,1,Mostly Clear,5.0,2022-07-04 13:00:00,13
935,466,1401,38,30.0,1,Mostly Clear,3.6,2022-07-04 14:00:00,14
828,382,1210,35,30.1,0,Clear,4.4,2022-07-04 15:00:00,15
865,453,1318,35,30.4,0,Clear,3.8,2022-07-04 16:00:00,16
917,414,1331,35,30.3,0,Clear,4.3,2022-07-04 17:00:00,17
1029,418,1447,38,29.8,0,Clear,3.3,2022-07-04 18:00:00,18
1083,445,1528,44,28.6,0,Clear,5.2,2022-07-04 19:00:00,19
1048,424,1472,54,26.7,0,Clear,7.9,2022-07-04 20:00:00,20
1042,487,1529,58,25.1,1,Mostly Clear,9.1,2022-07-04 21:00:00,21
788,407,1195,63,24.0,1,Mostly Clear,8.6,2022-07-04 22:00:00,22
346,192,538,65,23.1,1,Mostly Clear,8.5,2022-07-04 23:00:00,23
106,76,182,67,22.5,1,Mostly Clear,7.9,2022-07-05 00:00:00,0
47,27,74,72,22.1,1,Mostly Clear,9.1,2022-07-05 01:00:00,1
19,15,34,79,21.8,1,Mostly Clear,9.8,2022-07-05 02:00:00,2
13,13,26,89,21.3,1,Mostly Clear,9.0,2022-07-05 03:00:00,3
11,14,25,91,21.1,1,Mostly Clear,9.4,2022-07-05 04:00:00,4
26,48,74,91,21.0,2,Partly Cloudy,9.4,2022-07-05 05:00:00,5
66,146,212,90,21.2,2,Partly Cloudy,9.4,2022-07-05 06:00:00,6
148,332,480,88,21.9,2,Partly Cloudy,10.2,2022-07-05 07:00:00,7
254,596,850,79,23.9,2,Partly Cloudy,10.0,2022-07-05 08:00:00,8
278,414,692,75,25.3,1,Mostly Clear,12.3,2022-07-05 09:00:00,9
251,252,503,71,27.1,1,Mostly Clear,14.3,2022-07-05 10:00:00,10
328,274,602,67,28.7,0,Clear,15.7,2022-07-05 11:00:00,11
356,322,678,63,30.1,2,Partly Cloudy,17.4,2022-07-05 12:00:00,12
163,183,346,61,30.6,3,Cloudy,18.5,2022-07-05 13:00:00,13
233,223,456,61,30.8,51,Light Drizzle,18.5,2022-07-05 14:00:00,14
304,312,616,62,31.0,51,Light Drizzle,17.1,2022-07-05 15:00:00,15
380,438,818,73,29.5,63,Rain,12.7,2022-07-05 16:00:00,16
536,738,1274,82,28.1,65,Heavy Rain,12.1,2022-07-05 17:00:00,17
492,693,1185,89,26.7,63,Rain,8.0,2022-07-05 18:00:00,18
404,514,918,90,26.5,51,Light Drizzle,4.6,2022-07-05 19:00:00,19
269,338,607,92,26.1,3,Cloudy,4.5,2022-07-05 20:00:00,20
236,253,489,94,25.3,3,Cloudy,5.4,2022-07-05 21:00:00,21
164,154,318,95,25.0,1,Mostly Clear,8.4,2022-07-05 22:00:00,22
70,102,172,94,25.0,1,Mostly Clear,9.0,2022-07-05 23:00:00,23
30,36,66,94,25.0,1,Mostly Clear,9.4,2022-07-06 00:00:00,0
10,16,26,93,24.8,1,Mostly Clear,10.8,2022-07-06 01:00:00,1
3,12,15,93,24.5,1,Mostly Clear,9.6,2022-07-06 02:00:00,2
2,6,8,90,24.0,0,Clear,9.0,2022-07-06 03:00:00,3
9,18,27,90,23.7,0,Clear,10.0,2022-07-06 04:00:00,4
36,66,102,90,23.4,1,Mostly Clear,10.8,2022-07-06 05:00:00,5
77,208,285,90,23.4,1,Mostly Clear,10.2,2022-07-06 06:00:00,6
171,412,583,88,24.1,2,Partly Cloudy,10.0,2022-07-06 07:00:00,7
341,755,1096,84,25.5,1,Mostly Clear,11.2,2022-07-06 08:00:00,8
294,396,690,76,27.2,1,Mostly Clear,11.3,2022-07-06 09:00:00,9
234,245,479,71,28.6,1,Mostly Clear,12.1,2022-07-06 10:00:00,10
236,271,507,66,30.1,2,Partly Cloudy,9.4,2022-07-06 11:00:00,11
327,303,630,63,31.2,3,Cloudy,8.1,2022-07-06 12:00:00,12
330,267,597,62,31.4,2,Partly Cloudy,8.6,2022-07-06 13:00:00,13
331,270,601,61,32.0,1,Mostly Clear,9.4,2022-07-06 14:00:00,14
316,357,673,50,32.6,1,Mostly Clear,7.9,2022-07-06 15:00:00,15
355,508,863,48,33.4,1,Mostly Clear,7.6,2022-07-06 16:00:00,16
566,846,1412,47,33.5,1,Mostly Clear,6.9,2022-07-06 17:00:00,17
550,758,1308,50,33.1,2,Partly Cloudy,3.1,2022-07-06 18:00:00,18
391,546,937,59,31.3,51,Light Drizzle,1.5,2022-07-06 19:00:00,19
191,304,495,62,29.6,51,Light Drizzle,3.1,2022-07-06 20:00:00,20
157,223,380,70,28.0,3,Cloudy,3.9,2022-07-06 21:00:00,21
109,159,268,77,27.1,2,Partly Cloudy,5.1,2022-07-06 22:00:00,22
54,100,154,82,26.5,3,Cloudy,6.5,2022-07-06 23:00:00,23
32,32,64,86,26.1,51,Light Drizzle,6.5,2022-07-07 00:00:00,0
17,4,21,91,25.3,55,Heavy Drizzle,5.8,2022-07-07 01:00:00,1
4,7,11,96,24.4,51,Light Drizzle,5.4,2022-07-07 02:00:00,2
5,6,11,98,24.8,51,Light Drizzle,4.6,2022-07-07 03:00:00,3
3,18,21,99,24.6,51,Light Drizzle,5.9,2022-07-07 04:00:00,4
21,53,74,98,24.2,53,Heavy Drizzle,7.6,2022-07-07 05:00:00,5
51,170,221,100,23.3,61,Light Rain,10.1,2022-07-07 06:00:00,6
106,284,390,100,23.1,55,Heavy Drizzle,13.1,2022-07-07 07:00:00,7
218,603,821,99,23.1,53,Heavy Drizzle,10.5,2022-07-07 08:00:00,8
244,417,661,97,23.2,51,Light Drizzle,9.0,2022-07-07 09:00:00,9
204,253,457,94,23.3,3,Cloudy,10.5,2022-07-07 10:00:00,10
249,245,494,90,23.9,3,Cloudy,8.7,2022-07-07 11:00:00,11
321,300,621,80,25.3,3,Cloudy,7.4,2022-07-07 12:00:00,12
278,243,521,71,26.7,3,Cloudy,7.4,2022-07-07 13:00:00,13
321,280,601,67,27.4,3,Cloudy,6.9,2022-07-07 14:00:00,14
336,357,693,68,27.2,51,Light Drizzle,6.6,2022-07-07 15:00:00,15
396,494,890,74,26.2,51,Light Drizzle,6.9,2022-07-07 16:00:00,16
580,822,1402,76,25.8,3,Cloudy,7.5,2022-07-07 17:00:00,17
561,756,1317,77,25.6,2,Partly Cloudy,5.7,2022-07-07 18:00:00,18
452,567,1019,78,25.4,3,Cloudy,3.3,2022-07-07 19:00:00,19
379,410,789,80,25.1,2,Partly Cloudy,4.2,2022-07-07 20:00:00,20
264,313,577,85,24.3,1,Mostly Clear,4.1,2022-07-07 21:00:00,21
184,235,419,90,23.5,1,Mostly Clear,4.4,2022-07-07 22:00:00,22
131,114,245,92,22.8,1,Mostly Clear,3.3,2022-07-07 23:00:00,23
58,59,117,94,22.4,1,Mostly Clear,5.1,2022-07-08 00:00:00,0
30,14,44,95,22.2,1,Mostly Clear,5.4,2022-07-08 01:00:00,1
15,13,28,95,22.1,1,Mostly Clear,6.1,2022-07-08 02:00:00,2
7,9,16,98,21.1,1,Mostly Clear,4.3,2022-07-08 03:00:00,3
3,16,19,98,21.1,1,Mostly Clear,4.5,2022-07-08 04:00:00,4
25,46,71,99,21.1,2,Partly Cloudy,4.8,2022-07-08 05:00:00,5
57,164,221,99,21.2,3,Cloudy,2.6,2022-07-08 06:00:00,6
136,336,472,96,22.3,3,Cloudy,4.0,2022-07-08 07:00:00,7
229,497,726,89,23.4,3,Cloudy,3.2,2022-07-08 08:00:00,8
233,393,626,83,24.5,3,Cloudy,3.1,2022-07-08 09:00:00,9
234,263,497,77,25.8,3,Cloudy,2.2,2022-07-08 10:00:00,10
324,248,572,72,26.9,3,Cloudy,2.2,2022-07-08 11:00:00,11
328,341,669,67,27.9,51,Light Drizzle,3.8,2022-07-08 12:00:00,12
357,341,698,66,28.2,51,Light Drizzle,4.9,2022-07-08 13:00:00,13
387,335,722,64,28.7,51,Light Drizzle,6.2,2022-07-08 14:00:00,14
403,421,824,67,28.3,51,Light Drizzle,6.8,2022-07-08 15:00:00,15
466,493,959,65,28.7,51,Light Drizzle,6.9,2022-07-08 16:00:00,16
576,788,1364,63,29.0,51,Light Drizzle,6.8,2022-07-08 17:00:00,17
541,672,1213,65,28.5,2,Partly Cloudy,3.1,2022-07-08 18:00:00,18
451,499,950,67,28.4,2,Partly Cloudy,0.8,2022-07-08 19:00:00,19
401,400,801,74,27.4,2,Partly Cloudy,4.0,2022-07-08 20:00:00,20
273,314,587,78,26.5,3,Cloudy,6.5,2022-07-08 21:00:00,21
196,230,426,81,25.9,3,Cloudy,6.2,2022-07-08 22:00:00,22
174,158,332,84,25.5,3,Cloudy,6.6,2022-07-08 23:00:00,23
83,93,176,86,25.1,51,Light Drizzle,4.7,2022-07-09 00:00:00,0
33,33,66,88,24.8,53,Heavy Drizzle,4.5,2022-07-09 01:00:00,1
16,15,31,94,24.0,61,Light Rain,3.1,2022-07-09 02:00:00,2
5,10,15,98,23.5,63,Rain,0.7,2022-07-09 03:00:00,3
1,4,5,99,23.5,61,Light Rain,5.4,2022-07-09 04:00:00,4
7,7,14,99,23.2,63,Rain,8.5,2022-07-09 05:00:00,5
18,34,52,99,23.0,63,Rain,10.7,2022-07-09 06:00:00,6
40,84,124,99,23.1,63,Rain,12.0,2022-07-09 07:00:00,7
74,155,229,97,23.0,65,Heavy Rain,10.5,2022-07-09 08:00:00,8
88,157,245,96,22.7,65,Heavy Rain,10.3,2022-07-09 09:00:00,9
159,204,363,96,22.3,65,Heavy Rain,12.1,2022-07-09 10:00:00,10
193,289,482,95,22.1,65,Heavy Rain,13.7,2022-07-09 11:00:00,11
180,237,417,95,22.1,63,Rain,14.3,2022-07-09 12:00:00,12
90,112,202,96,22.5,63,Rain,15.1,2022-07-09 13:00:00,13
109,180,289,96,23.0,61,Light Rain,14.1,2022-07-09 14:00:00,14
222,273,495,96,21.6,61,Light Rain,13.0,2022-07-09 15:00:00,15
348,313,661,95,21.6,55,Heavy Drizzle,12.2,2022-07-09 16:00:00,16
406,409,815,96,21.6,53,Heavy Drizzle,10.5,2022-07-09 17:00:00,17
310,350,660,96,21.7,51,Light Drizzle,6.2,2022-07-09 18:00:00,18
337,365,702,95,21.8,51,Light Drizzle,5.3,2022-07-09 19:00:00,19
274,285,559,95,21.8,3,Cloudy,5.0,2022-07-09 20:00:00,20
206,216,422,94,21.7,3,Cloudy,6.2,2022-07-09 21:00:00,21
218,175,393,94,21.7,3,Cloudy,4.8,2022-07-09 22:00:00,22
188,157,345,95,21.6,3,Cloudy,4.8,2022-07-09 23:00:00,23
144,122,266,95,21.4,3,Cloudy,4.1,2022-07-10 00:00:00,0
127,94,221,96,21.0,3,Cloudy,5.1,2022-07-10 01:00:00,1
83,72,155,96,20.6,3,Cloudy,4.7,2022-07-10 02:00:00,2
45,44,89,96,20.8,3,Cloudy,5.5,2022-07-10 03:00:00,3
18,11,29,96,20.7,2,Partly Cloudy,6.9,2022-07-10 04:00:00,4
29,18,47,97,20.3,1,Mostly Clear,7.6,2022-07-10 05:00:00,5
29,46,75,97,19.8,1,Mostly Clear,7.6,2022-07-10 06:00:00,6
58,86,144,96,20.1,1,Mostly Clear,8.1,2022-07-10 07:00:00,7
153,204,357,92,21.0,1,Mostly Clear,6.6,2022-07-10 08:00:00,8
259,306,565,85,22.2,0,Clear,7.8,2022-07-10 09:00:00,9
481,419,900,76,23.6,1,Mostly Clear,8.2,2022-07-10 10:00:00,10
573,462,1035,66,25.1,1,Mostly Clear,7.6,2022-07-10 11:00:00,11
673,490,1163,60,26.1,1,Mostly Clear,8.0,2022-07-10 12:00:00,12
699,547,1246,56,26.8,2,Partly Cloudy,8.4,2022-07-10 13:00:00,13
687,517,1204,53,27.3,2,Partly Cloudy,7.7,2022-07-10 14:00:00,14
662,506,1168,55,26.2,2,Partly Cloudy,7.2,2022-07-10 15:00:00,15
595,540,1135,54,26.4,2,Partly Cloudy,7.2,2022-07-10 16:00:00,16
606,546,1152,54,26.3,2,Partly Cloudy,6.6,2022-07-10 17:00:00,17
471,462,933,57,25.8,3,Cloudy,7.1,2022-07-10 18:00:00,18
486,362,848,61,25.3,2,Partly Cloudy,7.2,2022-07-10 19:00:00,19
382,269,651,71,24.4,0,Clear,6.4,2022-07-10 20:00:00,20
276,217,493,77,22.6,0,Clear,5.6,2022-07-10 21:00:00,21
150,173,323,84,21.2,0,Clear,6.4,2022-07-10 22:00:00,22
80,75,155,87,20.2,0,Clear,8.0,2022-07-10 23:00:00,23
48,32,80,90,19.6,0,Clear,8.4,2022-07-11 00:00:00,0
23,12,35,92,19.1,0,Clear,7.6,2022-07-11 01:00:00,1
4,13,17,94,18.6,0,Clear,5.5,2022-07-11 02:00:00,2
6,7,13,94,19.2,0,Clear,5.8,2022-07-11 03:00:00,3
8,23,31,96,18.9,0,Clear,5.4,2022-07-11 04:00:00,4
30,68,98,98,18.0,0,Clear,5.1,2022-07-11 05:00:00,5
75,176,251,98,18.5,2,Partly Cloudy,4.6,2022-07-11 06:00:00,6
132,385,517,97,19.8,3,Cloudy,1.5,2022-07-11 07:00:00,7
247,621,868,89,21.3,1,Mostly Clear,2.3,2022-07-11 08:00:00,8
253,390,643,72,23.0,0,Clear,2.2,2022-07-11 09:00:00,9
250,224,474,61,24.3,0,Clear,1.5,2022-07-11 10:00:00,10
282,231,513,56,25.4,0,Clear,3.6,2022-07-11 11:00:00,11
333,316,649,53,26.4,0,Clear,5.2,2022-07-11 12:00:00,12
324,342,666,50,27.2,0,Clear,5.8,2022-07-11 13:00:00,13
295,294,589,48,27.6,0,Clear,7.0,2022-07-11 14:00:00,14
385,372,757,45,27.9,0,Clear,6.5,2022-07-11 15:00:00,15
375,440,815,45,28.0,0,Clear,7.9,2022-07-11 16:00:00,16
621,838,1459,45,27.8,0,Clear,9.1,2022-07-11 17:00:00,17
536,809,1345,48,27.2,0,Clear,9.7,2022-07-11 18:00:00,18
496,616,1112,55,26.2,0,Clear,9.5,2022-07-11 19:00:00,19
390,457,847,64,24.7,0,Clear,9.3,2022-07-11 20:00:00,20
267,319,586,66,23.3,0,Clear,10.7,2022-07-11 21:00:00,21
157,175,332,69,22.4,0,Clear,11.6,2022-07-11 22:00:00,22
89,96,185,72,22.1,0,Clear,11.9,2022-07-11 23:00:00,23
46,39,85,79,21.9,0,Clear,11.1,2022-07-12 00:00:00,0
11,18,29,84,21.6,0,Clear,12.0,2022-07-12 01:00:00,1
4,9,13,87,21.4,0,Clear,12.5,2022-07-12 02:00:00,2
2,15,17,85,20.9,0,Clear,12.1,2022-07-12 03:00:00,3
9,10,19,88,20.7,0,Clear,12.0,2022-07-12 04:00:00,4
36,60,96,90,20.6,0,Clear,11.4,2022-07-12 05:00:00,5
68,203,271,92,20.5,0,Clear,8.4,2022-07-12 06:00:00,6
184,447,631,90,21.0,0,Clear,10.5,2022-07-12 07:00:00,7
335,829,1164,84,22.6,0,Clear,9.5,2022-07-12 08:00:00,8
218,438,656,77,24.4,0,Clear,9.5,2022-07-12 09:00:00,9
227,224,451,72,26.3,0,Clear,10.6,2022-07-12 10:00:00,10
249,271,520,67,28.0,0,Clear,13.2,2022-07-12 11:00:00,11
263,292,555,62,29.7,0,Clear,15.1,2022-07-12 12:00:00,12
273,310,583,57,31.1,1,Mostly Clear,15.8,2022-07-12 13:00:00,13
301,295,596,53,32.1,1,Mostly Clear,16.0,2022-07-12 14:00:00,14
289,369,658,54,32.4,1,Mostly Clear,16.4,2022-07-12 15:00:00,15
336,515,851,52,32.8,0,Clear,16.8,2022-07-12 16:00:00,16
495,843,1338,51,32.8,1,Mostly Clear,15.3,2022-07-12 17:00:00,17
119,255,374,55,31.9,1,Mostly Clear,9.6,2022-07-12 18:00:00,18
129,266,395,63,30.1,1,Mostly Clear,7.3,2022-07-12 19:00:00,19
78,189,267,71,28.2,51,Light Drizzle,12.2,2022-07-12 20:00:00,20
103,144,247,78,26.4,55,Heavy Drizzle,12.0,2022-07-12 21:00:00,21
94,140,234,80,25.9,51,Light Drizzle,12.2,2022-07-12 22:00:00,22
72,84,156,84,25.3,1,Mostly Clear,14.2,2022-07-12 23:00:00,23
35,35,70,85,25.0,1,Mostly Clear,14.5,2022-07-13 00:00:00,0
15,18,33,87,24.6,1,Mostly Clear,12.1,2022-07-13 01:00:00,1
8,5,13,89,24.0,1,Mostly Clear,11.2,2022-07-13 02:00:00,2
4,9,13,92,22.5,1,Mostly Clear,9.8,2022-07-13 03:00:00,3
10,18,28,93,22.4,1,Mostly Clear,9.7,2022-07-13 04:00:00,4
27,72,99,93,22.2,1,Mostly Clear,10.3,2022-07-13 05:00:00,5
77,222,299,94,22.0,0,Clear,7.4,2022-07-13 06:00:00,6
192,489,681,93,22.3,1,Mostly Clear,7.6,2022-07-13 07:00:00,7
343,823,1166,88,23.8,0,Clear,5.1,2022-07-13 08:00:00,8
274,438,712,80,25.4,0,Clear,5.8,2022-07-13 09:00:00,9
255,253,508,70,27.0,0,Clear,5.1,2022-07-13 10:00:00,10
244,287,531,60,28.6,2,Partly Cloudy,3.1,2022-07-13 11:00:00,11
278,297,575,53,29.8,2,Partly Cloudy,4.5,2022-07-13 12:00:00,12
276,292,568,49,30.3,1,Mostly Clear,7.9,2022-07-13 13:00:00,13
308,284,592,46,30.9,1,Mostly Clear,7.8,2022-07-13 14:00:00,14
324,368,692,45,31.2,0,Clear,7.8,2022-07-13 15:00:00,15
377,561,938,44,31.2,0,Clear,7.8,2022-07-13 16:00:00,16
608,879,1487,44,31.2,1,Mostly Clear,7.9,2022-07-13 17:00:00,17
658,898,1556,47,30.8,1,Mostly Clear,7.3,2022-07-13 18:00:00,18
531,654,1185,63,29.5,1,Mostly Clear,6.3,2022-07-13 19:00:00,19
381,510,891,62,28.7,1,Mostly Clear,7.0,2022-07-13 20:00:00,20
314,387,701,68,27.2,1,Mostly Clear,8.9,2022-07-13 21:00:00,21
264,274,538,75,26.2,1,Mostly Clear,8.2,2022-07-13 22:00:00,22
90,117,207,80,25.4,1,Mostly Clear,8.2,2022-07-13 23:00:00,23
43,43,86,84,24.6,1,Mostly Clear,7.7,2022-07-14 00:00:00,0
18,13,31,84,24.0,1,Mostly Clear,8.3,2022-07-14 01:00:00,1
13,20,33,77,23.5,0,Clear,10.3,2022-07-14 02:00:00,2
5,14,19,73,23.5,0,Clear,11.5,2022-07-14 03:00:00,3
7,14,21,67,23.2,0,Clear,11.2,2022-07-14 04:00:00,4
29,56,85,64,23.1,0,Clear,10.7,2022-07-14 05:00:00,5
89,179,268,69,22.5,0,Clear,7.5,2022-07-14 06:00:00,6
178,464,642,74,22.3,0,Clear,9.2,2022-07-14 07:00:00,7
313,741,1054,70,24.0,0,Clear,6.9,2022-07-14 08:00:00,8
234,405,639,63,25.9,0,Clear,7.0,2022-07-14 09:00:00,9
245,258,503,57,27.4,0,Clear,7.7,2022-07-14 10:00:00,10
257,262,519,53,28.5,0,Clear,7.9,2022-07-14 11:00:00,11
265,311,576,51,29.5,1,Mostly Clear,9.0,2022-07-14 12:00:00,12
310,302,612,49,30.2,1,Mostly Clear,10.1,2022-07-14 13:00:00,13
315,293,608,47,30.9,1,Mostly Clear,9.7,2022-07-14 14:00:00,14
360,391,751,47,30.2,1,Mostly Clear,9.1,2022-07-14 15:00:00,15
451,567,1018,47,30.7,0,Clear,8.9,2022-07-14 16:00:00,16
665,887,1552,48,30.5,1,Mostly Clear,8.6,2022-07-14 17:00:00,17
606,831,1437,50,29.9,2,Partly Cloudy,8.9,2022-07-14 18:00:00,18
470,570,1040,55,28.5,1,Mostly Clear,8.2,2022-07-14 19:00:00,19
408,405,813,63,27.0,51,Light Drizzle,6.4,2022-07-14 20:00:00,20
334,305,639,69,25.9,0,Clear,5.1,2022-07-14 21:00:00,21
272,278,550,78,24.5,0,Clear,4.9,2022-07-14 22:00:00,22
137,166,303,81,23.8,0,Clear,5.5,2022-07-14 23:00:00,23
56,55,111,84,23.1,0,Clear,5.9,2022-07-15 00:00:00,0
32,29,61,87,22.3,1,Mostly Clear,6.8,2022-07-15 01:00:00,1
18,16,34,87,21.8,1,Mostly Clear,6.3,2022-07-15 02:00:00,2
18,7,25,92,21.6,1,Mostly Clear,5.2,2022-07-15 03:00:00,3
8,20,28,88,21.5,0,Clear,6.1,2022-07-15 04:00:00,4
26,50,76,84,21.2,0,Clear,7.8,2022-07-15 05:00:00,5
59,186,245,84,20.6,1,Mostly Clear,7.9,2022-07-15 06:00:00,6
135,361,496,79,21.4,0,Clear,8.8,2022-07-15 07:00:00,7
240,532,772,71,22.9,1,Mostly Clear,7.2,2022-07-15 08:00:00,8
238,383,621,68,24.5,0,Clear,6.6,2022-07-15 09:00:00,9
324,250,574,66,26.0,0,Clear,6.2,2022-07-15 10:00:00,10
330,296,626,62,27.6,0,Clear,4.3,2022-07-15 11:00:00,11
375,339,714,57,28.7,0,Clear,2.2,2022-07-15 12:00:00,12
427,380,807,53,29.6,0,Clear,0.8,2022-07-15 13:00:00,13
440,375,815,52,30.2,0,Clear,0.7,2022-07-15 14:00:00,14
439,448,887,42,30.6,1,Mostly Clear,1.1,2022-07-15 15:00:00,15
469,555,1024,41,30.4,1,Mostly Clear,1.1,2022-07-15 16:00:00,16
598,751,1349,42,29.8,1,Mostly Clear,3.4,2022-07-15 17:00:00,17
583,675,1258,48,28.8,1,Mostly Clear,3.6,2022-07-15 18:00:00,18
472,513,985,60,27.5,1,Mostly Clear,7.8,2022-07-15 19:00:00,19
411,398,809,73,26.0,1,Mostly Clear,8.7,2022-07-15 20:00:00,20
329,294,623,80,24.8,1,Mostly Clear,8.7,2022-07-15 21:00:00,21
293,247,540,86,24.0,1,Mostly Clear,7.9,2022-07-15 22:00:00,22
196,211,407,91,23.3,1,Mostly Clear,6.3,2022-07-15 23:00:00,23
157,158,315,95,22.4,0,Clear,5.4,2022-07-16 00:00:00,0
133,89,222,97,21.8,1,Mostly Clear,7.4,2022-07-16 01:00:00,1
89,61,150,97,21.6,1,Mostly Clear,7.9,2022-07-16 02:00:00,2
56,22,78,98,21.5,1,Mostly Clear,7.1,2022-07-16 03:00:00,3
11,19,30,99,21.3,1,Mostly Clear,6.6,2022-07-16 04:00:00,4
27,35,62,100,21.3,1,Mostly Clear,4.8,2022-07-16 05:00:00,5
47,88,135,99,21.9,3,Cloudy,1.8,2022-07-16 06:00:00,6
96,151,247,99,22.0,3,Cloudy,4.4,2022-07-16 07:00:00,7
194,243,437,93,23.5,2,Partly Cloudy,5.1,2022-07-16 08:00:00,8
347,364,711,83,25.1,1,Mostly Clear,7.1,2022-07-16 09:00:00,9
521,431,952,76,26.3,51,Light Drizzle,7.6,2022-07-16 10:00:00,10
595,508,1103,72,27.1,2,Partly Cloudy,7.1,2022-07-16 11:00:00,11
695,504,1199,69,27.8,3,Cloudy,7.7,2022-07-16 12:00:00,12
623,416,1039,65,28.6,51,Light Drizzle,6.5,2022-07-16 13:00:00,13
552,401,953,61,29.3,51,Light Drizzle,5.5,2022-07-16 14:00:00,14
609,525,1134,61,28.9,53,Heavy Drizzle,2.9,2022-07-16 15:00:00,15
618,482,1100,67,27.8,63,Rain,3.1,2022-07-16 16:00:00,16
613,402,1015,78,26.6,61,Light Rain,4.0,2022-07-16 17:00:00,17
254,234,488,90,24.9,55,Heavy Drizzle,8.5,2022-07-16 18:00:00,18
242,237,479,94,24.3,51,Light Drizzle,5.4,2022-07-16 19:00:00,19
346,287,633,97,23.7,53,Heavy Drizzle,5.5,2022-07-16 20:00:00,20
253,200,453,98,23.0,61,Light Rain,6.7,2022-07-16 21:00:00,21
230,187,417,98,22.7,53,Heavy Drizzle,7.7,2022-07-16 22:00:00,22
170,196,366,98,22.5,2,Partly Cloudy,7.6,2022-07-16 23:00:00,23
134,107,241,98,22.4,1,Mostly Clear,7.3,2022-07-17 00:00:00,0
99,104,203,99,22.3,1,Mostly Clear,7.4,2022-07-17 01:00:00,1
79,46,125,99,22.2,1,Mostly Clear,7.5,2022-07-17 02:00:00,2
43,26,69,94,22.3,1,Mostly Clear,6.6,2022-07-17 03:00:00,3
15,9,24,95,22.2,1,Mostly Clear,5.9,2022-07-17 04:00:00,4
21,15,36,96,22.1,1,Mostly Clear,4.4,2022-07-17 05:00:00,5
34,46,80,97,21.8,3,Cloudy,3.4,2022-07-17 06:00:00,6
62,72,134,96,22.2,3,Cloudy,3.0,2022-07-17 07:00:00,7
167,165,332,91,23.3,3,Cloudy,3.6,2022-07-17 08:00:00,8
326,260,586,87,24.5,3,Cloudy,5.1,2022-07-17 09:00:00,9
499,365,864,81,25.8,3,Cloudy,4.8,2022-07-17 10:00:00,10
562,476,1038,75,27.2,3,Cloudy,4.4,2022-07-17 11:00:00,11
558,458,1016,69,28.4,3,Cloudy,5.1,2022-07-17 12:00:00,12
588,510,1098,66,29.5,3,Cloudy,5.8,2022-07-17 13:00:00,13
616,454,1070,63,30.3,3,Cloudy,7.1,2022-07-17 14:00:00,14
614,469,1083,73,28.4,51,Light Drizzle,7.7,2022-07-17 15:00:00,15
649,473,1122,73,28.5,51,Light Drizzle,7.7,2022-07-17 16:00:00,16
526,478,1004,72,28.6,1,Mostly Clear,6.6,2022-07-17 17:00:00,17
311,399,710,72,28.9,1,Mostly Clear,5.9,2022-07-17 18:00:00,18
354,330,684,76,28.2,1,Mostly Clear,9.1,2022-07-17 19:00:00,19
320,305,625,81,27.3,2,Partly Cloudy,6.8,2022-07-17 20:00:00,20
240,197,437,83,26.4,2,Partly Cloudy,5.5,2022-07-17 21:00:00,21
143,131,274,86,25.6,2,Partly Cloudy,6.0,2022-07-17 22:00:00,22
66,89,155,87,25.1,1,Mostly Clear,5.8,2022-07-17 23:00:00,23
43,33,76,89,24.6,1,Mostly Clear,5.4,2022-07-18 00:00:00,0
14,18,32,91,24.2,51,Light Drizzle,7.7,2022-07-18 01:00:00,1
13,8,21,92,23.9,51,Light Drizzle,9.0,2022-07-18 02:00:00,2
10,6,16,92,24.0,1,Mostly Clear,9.0,2022-07-18 03:00:00,3
8,22,30,92,23.9,1,Mostly Clear,9.4,2022-07-18 04:00:00,4
29,59,88,92,23.9,1,Mostly Clear,10.5,2022-07-18 05:00:00,5
75,188,263,92,23.9,3,Cloudy,11.2,2022-07-18 06:00:00,6
138,352,490,92,24.0,3,Cloudy,11.6,2022-07-18 07:00:00,7
246,641,887,90,24.6,3,Cloudy,15.6,2022-07-18 08:00:00,8
241,372,613,84,25.9,3,Cloudy,17.6,2022-07-18 09:00:00,9
291,238,529,78,27.4,3,Cloudy,18.1,2022-07-18 10:00:00,10
278,237,515,72,28.9,3,Cloudy,18.2,2022-07-18 11:00:00,11
307,323,630,66,30.2,3,Cloudy,17.0,2022-07-18 12:00:00,12
286,281,567,61,31.4,51,Light Drizzle,16.1,2022-07-18 13:00:00,13
316,299,615,56,32.5,2,Partly Cloudy,15.1,2022-07-18 14:00:00,14
342,387,729,59,32.2,51,Light Drizzle,13.8,2022-07-18 15:00:00,15
329,514,843,72,29.5,61,Light Rain,12.0,2022-07-18 16:00:00,16
336,625,961,74,29.1,61,Light Rain,13.4,2022-07-18 17:00:00,17
319,584,903,77,28.7,61,Light Rain,8.0,2022-07-18 18:00:00,18
342,522,864,85,27.6,55,Heavy Drizzle,7.6,2022-07-18 19:00:00,19
268,400,668,88,26.8,51,Light Drizzle,4.5,2022-07-18 20:00:00,20
198,280,478,91,26.0,1,Mostly Clear,4.7,2022-07-18 21:00:00,21
126,159,285,93,25.5,2,Partly Cloudy,4.1,2022-07-18 22:00:00,22
48,97,145,93,25.1,3,Cloudy,7.0,2022-07-18 23:00:00,23
23,36,59,93,24.8,2,Partly Cloudy,8.3,2022-07-19 00:00:00,0
7,18,25,94,24.4,1,Mostly Clear,8.6,2022-07-19 01:00:00,1
8,5,13,94,24.0,1,Mostly Clear,9.3,2022-07-19 02:00:00,2
10,10,20,88,24.1,1,Mostly Clear,10.1,2022-07-19 03:00:00,3
13,19,32,87,23.7,2,Partly Cloudy,8.8,2022-07-19 04:00:00,4
27,63,90,87,23.2,1,Mostly Clear,8.2,2022-07-19 05:00:00,5
62,225,287,89,22.8,1,Mostly Clear,7.9,2022-07-19 06:00:00,6
171,481,652,89,23.1,2,Partly Cloudy,8.1,2022-07-19 07:00:00,7
289,839,1128,85,24.0,2,Partly Cloudy,7.4,2022-07-19 08:00:00,8
255,432,687,83,24.5,2,Partly Cloudy,6.2,2022-07-19 09:00:00,9
214,298,512,77,25.9,2,Partly Cloudy,7.0,2022-07-19 10:00:00,10
245,292,537,68,27.7,1,Mostly Clear,7.6,2022-07-19 11:00:00,11
301,288,589,61,28.9,1,Mostly Clear,5.9,2022-07-19 12:00:00,12
278,313,591,54,30.3,1,Mostly Clear,5.8,2022-07-19 13:00:00,13
271,322,593,50,31.0,1,Mostly Clear,7.1,2022-07-19 14:00:00,14
292,390,682,55,30.6,1,Mostly Clear,8.2,2022-07-19 15:00:00,15
368,490,858,52,31.1,1,Mostly Clear,8.5,2022-07-19 16:00:00,16
550,958,1508,51,31.0,1,Mostly Clear,8.7,2022-07-19 17:00:00,17
571,890,1461,52,30.9,1,Mostly Clear,8.0,2022-07-19 18:00:00,18
548,639,1187,58,30.0,0,Clear,5.8,2022-07-19 19:00:00,19
382,495,877,65,28.5,0,Clear,5.8,2022-07-19 20:00:00,20
287,300,587,67,27.2,0,Clear,8.3,2022-07-19 21:00:00,21
161,201,362,72,26.2,0,Clear,9.0,2022-07-19 22:00:00,22
115,103,218,75,25.5,0,Clear,9.4,2022-07-19 23:00:00,23
48,47,95,78,25.0,0,Clear,7.9,2022-07-20 00:00:00,0
21,18,39,81,24.4,0,Clear,7.2,2022-07-20 01:00:00,1
11,7,18,84,23.9,0,Clear,7.6,2022-07-20 02:00:00,2
10,13,23,90,23.4,0,Clear,7.2,2022-07-20 03:00:00,3
8,13,21,90,22.9,0,Clear,7.2,2022-07-20 04:00:00,4
39,63,102,91,22.4,0,Clear,6.9,2022-07-20 05:00:00,5
86,221,307,91,22.0,0,Clear,5.8,2022-07-20 06:00:00,6
182,491,673,91,22.6,0,Clear,7.2,2022-07-20 07:00:00,7
313,816,1129,79,25.5,0,Clear,5.4,2022-07-20 08:00:00,8
213,451,664,72,27.4,0,Clear,5.2,2022-07-20 09:00:00,9
247,275,522,65,29.1,0,Clear,5.1,2022-07-20 10:00:00,10
258,239,497,58,30.3,1,Mostly Clear,5.2,2022-07-20 11:00:00,11
268,316,584,54,31.0,0,Clear,5.8,2022-07-20 12:00:00,12
226,287,513,50,31.8,0,Clear,5.9,2022-07-20 13:00:00,13
286,267,553,48,32.4,0,Clear,6.9,2022-07-20 14:00:00,14
325,387,712,48,32.7,0,Clear,9.3,2022-07-20 15:00:00,15
363,503,866,49,32.4,1,Mostly Clear,11.3,2022-07-20 16:00:00,16
601,869,1470,49,32.4,1,Mostly Clear,12.7,2022-07-20 17:00:00,17
573,809,1382,53,31.7,0,Clear,12.2,2022-07-20 18:00:00,18
466,687,1153,58,30.7,0,Clear,10.2,2022-07-20 19:00:00,19
389,486,875,66,29.4,0,Clear,9.5,2022-07-20 20:00:00,20
282,309,591,69,28.3,0,Clear,10.5,2022-07-20 21:00:00,21
230,273,503,69,27.8,0,Clear,9.1,2022-07-20 22:00:00,22
109,127,236,69,27.4,0,Clear,10.4,2022-07-20 23:00:00,23
43,37,80,68,27.1,0,Clear,10.9,2022-07-21 00:00:00,0
35,19,54,67,26.9,0,Clear,11.7,2022-07-21 01:00:00,1
10,8,18,67,26.7,0,Clear,12.6,2022-07-21 02:00:00,2
7,4,11,75,26.6,0,Clear,12.1,2022-07-21 03:00:00,3
9,21,30,77,26.2,0,Clear,11.3,2022-07-21 04:00:00,4
33,57,90,80,25.8,0,Clear,11.8,2022-07-21 05:00:00,5
67,172,239,82,25.5,1,Mostly Clear,9.5,2022-07-21 06:00:00,6
141,433,574,85,25.5,0,Clear,10.8,2022-07-21 07:00:00,7
269,665,934,81,26.8,1,Mostly Clear,10.9,2022-07-21 08:00:00,8
228,458,686,76,28.2,1,Mostly Clear,10.0,2022-07-21 09:00:00,9
213,246,459,69,29.8,1,Mostly Clear,9.3,2022-07-21 10:00:00,10
230,268,498,63,31.2,1,Mostly Clear,10.4,2022-07-21 11:00:00,11
224,295,519,58,32.7,1,Mostly Clear,11.6,2022-07-21 12:00:00,12
204,259,463,53,34.0,1,Mostly Clear,13.0,2022-07-21 13:00:00,13
265,290,555,49,34.7,1,Mostly Clear,13.4,2022-07-21 14:00:00,14
282,335,617,47,34.1,1,Mostly Clear,11.9,2022-07-21 15:00:00,15
254,354,608,47,33.9,2,Partly Cloudy,12.2,2022-07-21 16:00:00,16
400,673,1073,64,30.4,55,Heavy Drizzle,12.8,2022-07-21 17:00:00,17
495,713,1208,66,30.0,1,Mostly Clear,7.9,2022-07-21 18:00:00,18
458,552,1010,67,30.0,1,Mostly Clear,9.7,2022-07-21 19:00:00,19
396,394,790,74,28.9,1,Mostly Clear,12.5,2022-07-21 20:00:00,20
326,278,604,78,27.9,1,Mostly Clear,11.5,2022-07-21 21:00:00,21
229,243,472,81,27.1,0,Clear,10.6,2022-07-21 22:00:00,22
141,138,279,79,26.7,0,Clear,10.9,2022-07-21 23:00:00,23
83,81,164,72,26.4,0,Clear,10.0,2022-07-22 00:00:00,0
32,29,61,68,25.9,0,Clear,10.1,2022-07-22 01:00:00,1
15,14,29,69,25.4,0,Clear,10.0,2022-07-22 02:00:00,2
10,6,16,77,25.0,0,Clear,9.0,2022-07-22 03:00:00,3
16,19,35,78,24.5,0,Clear,8.7,2022-07-22 04:00:00,4
30,45,75,80,24.1,0,Clear,8.3,2022-07-22 05:00:00,5
62,160,222,82,23.7,1,Mostly Clear,9.1,2022-07-22 06:00:00,6
120,343,463,83,23.9,1,Mostly Clear,10.4,2022-07-22 07:00:00,7
202,535,737,76,25.7,1,Mostly Clear,8.9,2022-07-22 08:00:00,8
216,402,618,68,27.6,0,Clear,8.2,2022-07-22 09:00:00,9
252,264,516,58,29.6,1,Mostly Clear,8.0,2022-07-22 10:00:00,10
271,280,551,46,31.3,0,Clear,6.9,2022-07-22 11:00:00,11
294,321,615,40,32.6,0,Clear,4.4,2022-07-22 12:00:00,12
341,299,640,39,32.9,1,Mostly Clear,6.0,2022-07-22 13:00:00,13
324,333,657,38,33.3,1,Mostly Clear,7.9,2022-07-22 14:00:00,14
380,396,776,37,33.6,1,Mostly Clear,8.7,2022-07-22 15:00:00,15
447,522,969,36,33.9,1,Mostly Clear,9.7,2022-07-22 16:00:00,16
473,628,1101,37,34.1,1,Mostly Clear,10.6,2022-07-22 17:00:00,17
498,612,1110,38,33.6,1,Mostly Clear,10.7,2022-07-22 18:00:00,18
417,524,941,44,32.4,1,Mostly Clear,9.4,2022-07-22 19:00:00,19
407,415,822,54,30.2,1,Mostly Clear,11.2,2022-07-22 20:00:00,20
309,276,585,58,28.6,1,Mostly Clear,11.4,2022-07-22 21:00:00,21
265,220,485,65,27.4,0,Clear,11.0,2022-07-22 22:00:00,22
219,220,439,72,26.1,0,Clear,9.4,2022-07-22 23:00:00,23
134,150,284,77,25.0,0,Clear,7.4,2022-07-23 00:00:00,0
133,121,254,76,24.7,0,Clear,7.2,2022-07-23 01:00:00,1
71,66,137,77,24.1,0,Clear,6.8,2022-07-23 02:00:00,2
37,27,64,82,23.8,0,Clear,6.8,2022-07-23 03:00:00,3
15,12,27,84,23.6,0,Clear,7.1,2022-07-23 04:00:00,4
19,18,37,86,23.3,0,Clear,6.4,2022-07-23 05:00:00,5
48,88,136,89,23.1,0,Clear,7.1,2022-07-23 06:00:00,6
86,124,210,90,23.5,0,Clear,8.1,2022-07-23 07:00:00,7
191,241,432,78,26.7,0,Clear,6.1,2022-07-23 08:00:00,8
367,336,703,71,28.5,0,Clear,4.9,2022-07-23 09:00:00,9
508,394,902,63,30.2,0,Clear,2.8,2022-07-23 10:00:00,10
468,395,863,54,31.7,0,Clear,1.3,2022-07-23 11:00:00,11
497,401,898,47,32.9,0,Clear,3.4,2022-07-23 12:00:00,12
483,384,867,42,34.0,0,Clear,6.0,2022-07-23 13:00:00,13
459,396,855,39,34.8,1,Mostly Clear,7.0,2022-07-23 14:00:00,14
487,349,836,38,34.8,1,Mostly Clear,6.6,2022-07-23 15:00:00,15
461,351,812,38,34.7,1,Mostly Clear,6.5,2022-07-23 16:00:00,16
451,377,828,39,34.7,1,Mostly Clear,6.2,2022-07-23 17:00:00,17
414,387,801,41,34.2,0,Clear,8.6,2022-07-23 18:00:00,18
413,368,781,46,33.3,0,Clear,9.5,2022-07-23 19:00:00,19
352,309,661,54,31.3,1,Mostly Clear,15.8,2022-07-23 20:00:00,20
260,224,484,62,29.5,0,Clear,15.6,2022-07-23 21:00:00,21
269,186,455,69,28.5,0,Clear,5.6,2022-07-23 22:00:00,22
219,161,380,74,27.7,0,Clear,6.1,2022-07-23 23:00:00,23
148,142,290,77,27.2,1,Mostly Clear,6.2,2022-07-24 00:00:00,0
132,103,235,79,26.6,2,Partly Cloudy,7.6,2022-07-24 01:00:00,1
113,72,185,82,25.9,2,Partly Cloudy,6.1,2022-07-24 02:00:00,2
38,23,61,73,24.2,1,Mostly Clear,5.6,2022-07-24 03:00:00,3
20,12,32,76,23.5,0,Clear,5.4,2022-07-24 04:00:00,4
28,13,41,76,23.3,0,Clear,5.4,2022-07-24 05:00:00,5
43,55,98,77,23.3,0,Clear,3.3,2022-07-24 06:00:00,6
76,107,183,79,23.5,0,Clear,4.1,2022-07-24 07:00:00,7
174,200,374,66,26.2,0,Clear,4.4,2022-07-24 08:00:00,8
280,251,531,59,28.2,1,Mostly Clear,4.7,2022-07-24 09:00:00,9
412,330,742,54,29.8,2,Partly Cloudy,5.0,2022-07-24 10:00:00,10
462,350,812,49,31.7,2,Partly Cloudy,6.3,2022-07-24 11:00:00,11
443,377,820,45,33.4,1,Mostly Clear,5.5,2022-07-24 12:00:00,12
407,388,795,41,34.9,1,Mostly Clear,5.0,2022-07-24 13:00:00,13
396,358,754,39,35.7,1,Mostly Clear,7.3,2022-07-24 14:00:00,14
386,360,746,40,35.1,1,Mostly Clear,10.1,2022-07-24 15:00:00,15
359,349,708,40,35.2,1,Mostly Clear,11.2,2022-07-24 16:00:00,16
395,369,764,40,35.2,1,Mostly Clear,13.8,2022-07-24 17:00:00,17
360,353,713,47,33.5,1,Mostly Clear,14.0,2022-07-24 18:00:00,18
362,300,662,54,32.3,1,Mostly Clear,10.0,2022-07-24 19:00:00,19
343,274,617,62,31.0,1,Mostly Clear,6.6,2022-07-24 20:00:00,20
220,192,412,66,29.7,1,Mostly Clear,12.3,2022-07-24 21:00:00,21
178,129,307,69,29.0,1,Mostly Clear,15.2,2022-07-24 22:00:00,22
77,69,146,68,28.7,0,Clear,14.9,2022-07-24 23:00:00,23
42,33,75,67,28.3,1,Mostly Clear,15.7,2022-07-25 00:00:00,0
13,20,33,68,28.0,1,Mostly Clear,16.1,2022-07-25 01:00:00,1
16,14,30,69,27.7,1,Mostly Clear,16.3,2022-07-25 02:00:00,2
5,12,17,73,27.8,1,Mostly Clear,16.3,2022-07-25 03:00:00,3
4,16,20,73,27.5,1,Mostly Clear,15.6,2022-07-25 04:00:00,4
22,63,85,74,27.2,1,Mostly Clear,15.0,2022-07-25 05:00:00,5
68,177,245,75,27.0,1,Mostly Clear,12.7,2022-07-25 06:00:00,6
151,386,537,76,27.0,1,Mostly Clear,13.0,2022-07-25 07:00:00,7
231,591,822,74,27.8,0,Clear,14.7,2022-07-25 08:00:00,8
207,388,595,69,29.0,0,Clear,16.1,2022-07-25 09:00:00,9
224,247,471,64,30.6,1,Mostly Clear,15.3,2022-07-25 10:00:00,10
226,246,472,58,32.0,2,Partly Cloudy,14.8,2022-07-25 11:00:00,11
272,265,537,54,32.9,2,Partly Cloudy,14.9,2022-07-25 12:00:00,12
263,273,536,50,34.1,3,Cloudy,14.2,2022-07-25 13:00:00,13
265,271,536,47,34.6,51,Light Drizzle,14.5,2022-07-25 14:00:00,14
235,326,561,75,28.6,63,Rain,9.4,2022-07-25 15:00:00,15
92,125,217,70,29.9,2,Partly Cloudy,9.7,2022-07-25 16:00:00,16
345,579,924,67,31.0,1,Mostly Clear,11.0,2022-07-25 17:00:00,17
366,620,986,68,30.9,51,Light Drizzle,5.5,2022-07-25 18:00:00,18
352,497,849,88,27.1,65,Heavy Rain,12.4,2022-07-25 19:00:00,19
226,368,594,93,26.0,63,Rain,10.4,2022-07-25 20:00:00,20
163,248,411,94,25.7,51,Light Drizzle,8.8,2022-07-25 21:00:00,21
82,166,248,94,25.4,1,Mostly Clear,10.3,2022-07-25 22:00:00,22
53,86,139,95,25.3,1,Mostly Clear,9.8,2022-07-25 23:00:00,23
23,32,55,95,25.2,1,Mostly Clear,8.2,2022-07-26 00:00:00,0
13,12,25,96,25.0,1,Mostly Clear,7.9,2022-07-26 01:00:00,1
6,10,16,95,24.9,1,Mostly Clear,7.8,2022-07-26 02:00:00,2
1,5,6,91,24.2,2,Partly Cloudy,6.8,2022-07-26 03:00:00,3
9,15,24,91,24.3,3,Cloudy,6.3,2022-07-26 04:00:00,4
28,84,112,89,24.4,3,Cloudy,8.4,2022-07-26 05:00:00,5
74,207,281,85,24.0,2,Partly Cloudy,4.7,2022-07-26 06:00:00,6
158,446,604,80,23.7,2,Partly Cloudy,8.7,2022-07-26 07:00:00,7
282,777,1059,72,24.2,3,Cloudy,7.6,2022-07-26 08:00:00,8
242,426,668,68,24.4,2,Partly Cloudy,7.6,2022-07-26 09:00:00,9
230,218,448,63,25.2,3,Cloudy,8.4,2022-07-26 10:00:00,10
265,254,519,64,25.1,3,Cloudy,8.2,2022-07-26 11:00:00,11
231,309,540,66,25.0,3,Cloudy,7.6,2022-07-26 12:00:00,12
231,238,469,63,25.6,3,Cloudy,5.5,2022-07-26 13:00:00,13
241,250,491,71,24.5,51,Light Drizzle,4.3,2022-07-26 14:00:00,14
319,368,687,70,26.6,51,Light Drizzle,3.5,2022-07-26 15:00:00,15
346,464,810,72,26.3,3,Cloudy,3.0,2022-07-26 16:00:00,16
520,871,1391,78,25.4,51,Light Drizzle,2.7,2022-07-26 17:00:00,17
535,780,1315,80,25.0,51,Light Drizzle,2.6,2022-07-26 18:00:00,18
379,565,944,82,24.7,51,Light Drizzle,2.4,2022-07-26 19:00:00,19
281,415,696,85,24.4,51,Light Drizzle,0.7,2022-07-26 20:00:00,20
201,273,474,88,24.1,51,Light Drizzle,2.2,2022-07-26 21:00:00,21
144,190,334,92,23.7,51,Light Drizzle,3.4,2022-07-26 22:00:00,22
89,106,195,96,23.4,51,Light Drizzle,1.9,2022-07-26 23:00:00,23
26,39,65,97,23.4,51,Light Drizzle,3.6,2022-07-27 00:00:00,0
12,12,24,98,23.4,55,Heavy Drizzle,3.2,2022-07-27 01:00:00,1
10,6,16,98,23.4,61,Light Rain,2.4,2022-07-27 02:00:00,2
2,9,11,96,22.7,51,Light Drizzle,3.1,2022-07-27 03:00:00,3
8,13,21,97,22.5,2,Partly Cloudy,3.3,2022-07-27 04:00:00,4
39,79,118,97,22.3,1,Mostly Clear,3.1,2022-07-27 05:00:00,5
82,231,313,97,22.3,2,Partly Cloudy,1.9,2022-07-27 06:00:00,6
174,453,627,98,22.3,1,Mostly Clear,1.6,2022-07-27 07:00:00,7
288,748,1036,94,23.0,2,Partly Cloudy,1.5,2022-07-27 08:00:00,8
247,427,674,88,24.2,2,Partly Cloudy,3.1,2022-07-27 09:00:00,9
220,243,463,81,25.5,2,Partly Cloudy,3.1,2022-07-27 10:00:00,10
289,291,580,71,27.3,2,Partly Cloudy,2.9,2022-07-27 11:00:00,11
324,329,653,65,28.5,2,Partly Cloudy,3.7,2022-07-27 12:00:00,12
281,313,594,61,29.3,51,Light Drizzle,5.8,2022-07-27 13:00:00,13
282,311,593,61,29.5,51,Light Drizzle,7.1,2022-07-27 14:00:00,14
338,367,705,63,30.6,2,Partly Cloudy,7.9,2022-07-27 15:00:00,15
376,471,847,59,31.2,2,Partly Cloudy,6.7,2022-07-27 16:00:00,16
515,843,1358,64,29.5,53,Heavy Drizzle,9.3,2022-07-27 17:00:00,17
569,878,1447,74,28.0,51,Light Drizzle,8.2,2022-07-27 18:00:00,18
420,595,1015,78,27.6,2,Partly Cloudy,6.4,2022-07-27 19:00:00,19
350,464,814,81,27.1,2,Partly Cloudy,7.6,2022-07-27 20:00:00,20
246,339,585,84,26.5,1,Mostly Clear,8.7,2022-07-27 21:00:00,21
231,207,438,86,26.1,1,Mostly Clear,7.4,2022-07-27 22:00:00,22
87,126,213,88,25.8,51,Light Drizzle,7.9,2022-07-27 23:00:00,23
48,48,96,90,25.4,51,Light Drizzle,9.2,2022-07-28 00:00:00,0
18,20,38,91,25.0,51,Light Drizzle,9.4,2022-07-28 01:00:00,1
11,12,23,93,24.5,51,Light Drizzle,8.7,2022-07-28 02:00:00,2
5,11,16,94,24.5,1,Mostly Clear,8.6,2022-07-28 03:00:00,3
13,15,28,94,24.3,1,Mostly Clear,7.6,2022-07-28 04:00:00,4
34,53,87,95,24.1,1,Mostly Clear,6.9,2022-07-28 05:00:00,5
72,198,270,95,24.0,1,Mostly Clear,5.4,2022-07-28 06:00:00,6
152,428,580,96,24.0,1,Mostly Clear,5.1,2022-07-28 07:00:00,7
281,701,982,92,25.3,2,Partly Cloudy,4.6,2022-07-28 08:00:00,8
243,397,640,87,26.4,1,Mostly Clear,3.4,2022-07-28 09:00:00,9
216,223,439,78,27.7,1,Mostly Clear,3.1,2022-07-28 10:00:00,10
289,225,514,72,28.7,1,Mostly Clear,4.3,2022-07-28 11:00:00,11
267,317,584,69,29.2,1,Mostly Clear,7.4,2022-07-28 12:00:00,12
267,325,592,66,30.3,1,Mostly Clear,9.0,2022-07-28 13:00:00,13
282,280,562,65,30.7,1,Mostly Clear,10.7,2022-07-28 14:00:00,14
332,304,636,70,29.6,51,Light Drizzle,13.0,2022-07-28 15:00:00,15
381,445,826,74,29.0,51,Light Drizzle,13.0,2022-07-28 16:00:00,16
599,826,1425,69,30.0,1,Mostly Clear,13.6,2022-07-28 17:00:00,17
622,776,1398,64,30.4,2,Partly Cloudy,9.4,2022-07-28 18:00:00,18
426,597,1023,70,29.3,55,Heavy Drizzle,8.6,2022-07-28 19:00:00,19
211,269,480,78,28.1,51,Light Drizzle,8.4,2022-07-28 20:00:00,20
217,284,501,78,27.3,0,Clear,10.2,2022-07-28 21:00:00,21
214,236,450,79,26.5,0,Clear,10.7,2022-07-28 22:00:00,22
123,152,275,80,26.1,1,Mostly Clear,10.4,2022-07-28 23:00:00,23
70,62,132,80,25.7,1,Mostly Clear,9.1,2022-07-29 00:00:00,0
26,28,54,79,25.2,1,Mostly Clear,8.7,2022-07-29 01:00:00,1
24,12,36,79,24.6,0,Clear,8.5,2022-07-29 02:00:00,2
9,7,16,87,23.6,1,Mostly Clear,7.8,2022-07-29 03:00:00,3
6,17,23,90,22.9,1,Mostly Clear,6.3,2022-07-29 04:00:00,4
46,48,94,90,22.5,1,Mostly Clear,5.4,2022-07-29 05:00:00,5
62,182,244,84,23.6,0,Clear,3.6,2022-07-29 06:00:00,6
121,280,401,84,23.9,1,Mostly Clear,1.8,2022-07-29 07:00:00,7
226,534,760,86,24.6,2,Partly Cloudy,3.1,2022-07-29 08:00:00,8
223,372,595,82,25.7,51,Light Drizzle,2.5,2022-07-29 09:00:00,9
237,248,485,79,26.5,2,Partly Cloudy,1.8,2022-07-29 10:00:00,10
316,286,602,74,27.5,2,Partly Cloudy,2.2,2022-07-29 11:00:00,11
339,320,659,72,27.9,2,Partly Cloudy,2.6,2022-07-29 12:00:00,12
354,329,683,74,27.5,51,Light Drizzle,0.8,2022-07-29 13:00:00,13
352,332,684,69,28.1,51,Light Drizzle,2.3,2022-07-29 14:00:00,14
401,416,817,74,28.5,53,Heavy Drizzle,2.5,2022-07-29 15:00:00,15
354,431,785,79,27.7,61,Light Rain,4.1,2022-07-29 16:00:00,16
368,510,878,83,27.2,51,Light Drizzle,4.5,2022-07-29 17:00:00,17
412,539,951,82,27.3,51,Light Drizzle,5.2,2022-07-29 18:00:00,18
356,466,822,86,26.5,53,Heavy Drizzle,7.9,2022-07-29 19:00:00,19
215,237,452,94,25.5,53,Heavy Drizzle,7.0,2022-07-29 20:00:00,20
193,189,382,96,24.6,53,Heavy Drizzle,4.6,2022-07-29 21:00:00,21
171,179,350,98,23.9,53,Heavy Drizzle,4.8,2022-07-29 22:00:00,22
105,126,231,98,23.7,51,Light Drizzle,7.9,2022-07-29 23:00:00,23
76,126,202,96,23.4,2,Partly Cloudy,8.9,2022-07-30 00:00:00,0
91,75,166,96,23.1,1,Mostly Clear,8.5,2022-07-30 01:00:00,1
64,73,137,94,22.8,1,Mostly Clear,9.2,2022-07-30 02:00:00,2
44,21,65,94,22.5,2,Partly Cloudy,11.4,2022-07-30 03:00:00,3
13,15,28,92,22.3,1,Mostly Clear,12.9,2022-07-30 04:00:00,4
19,30,49,90,22.0,0,Clear,12.7,2022-07-30 05:00:00,5
33,65,98,89,21.5,1,Mostly Clear,10.0,2022-07-30 06:00:00,6
75,139,214,88,21.3,1,Mostly Clear,10.5,2022-07-30 07:00:00,7
216,212,428,83,22.3,1,Mostly Clear,9.2,2022-07-30 08:00:00,8
367,363,730,72,23.9,0,Clear,8.2,2022-07-30 09:00:00,9
566,469,1035,62,25.3,1,Mostly Clear,9.2,2022-07-30 10:00:00,10
626,487,1113,54,26.7,1,Mostly Clear,11.4,2022-07-30 11:00:00,11
743,435,1178,48,28.0,1,Mostly Clear,10.3,2022-07-30 12:00:00,12
756,483,1239,44,29.0,1,Mostly Clear,9.4,2022-07-30 13:00:00,13
745,453,1198,41,29.8,1,Mostly Clear,9.0,2022-07-30 14:00:00,14
685,487,1172,39,30.1,1,Mostly Clear,8.0,2022-07-30 15:00:00,15
678,451,1129,39,30.3,2,Partly Cloudy,7.8,2022-07-30 16:00:00,16
666,437,1103,41,30.0,2,Partly Cloudy,6.6,2022-07-30 17:00:00,17
559,425,984,43,29.8,0,Clear,8.4,2022-07-30 18:00:00,18
522,387,909,50,28.6,0,Clear,6.8,2022-07-30 19:00:00,19
391,320,711,57,26.9,0,Clear,6.4,2022-07-30 20:00:00,20
324,270,594,59,25.6,1,Mostly Clear,7.4,2022-07-30 21:00:00,21
278,217,495,63,24.7,1,Mostly Clear,5.8,2022-07-30 22:00:00,22
250,205,455,66,24.2,1,Mostly Clear,4.7,2022-07-30 23:00:00,23
163,170,333,68,23.7,1,Mostly Clear,4.3,2022-07-31 00:00:00,0
164,119,283,70,23.1,1,Mostly Clear,4.4,2022-07-31 01:00:00,1
77,68,145,72,22.4,1,Mostly Clear,4.5,2022-07-31 02:00:00,2
63,36,99,91,21.6,1,Mostly Clear,5.0,2022-07-31 03:00:00,3
8,16,24,91,21.5,1,Mostly Clear,5.3,2022-07-31 04:00:00,4
23,19,42,86,22.7,1,Mostly Clear,2.8,2022-07-31 05:00:00,5
50,55,105,87,22.7,1,Mostly Clear,2.6,2022-07-31 06:00:00,6
97,87,184,90,22.5,1,Mostly Clear,2.2,2022-07-31 07:00:00,7
142,190,332,85,23.7,1,Mostly Clear,0.4,2022-07-31 08:00:00,8
337,315,652,76,25.3,1,Mostly Clear,0.5,2022-07-31 09:00:00,9
491,356,847,70,26.4,1,Mostly Clear,1.5,2022-07-31 10:00:00,10
563,454,1017,66,27.3,1,Mostly Clear,4.0,2022-07-31 11:00:00,11
673,490,1163,61,28.0,2,Partly Cloudy,8.8,2022-07-31 12:00:00,12
621,477,1098,60,27.8,3,Cloudy,11.7,2022-07-31 13:00:00,13
462,425,887,69,26.5,51,Light Drizzle,11.2,2022-07-31 14:00:00,14
435,402,837,75,26.0,55,Heavy Drizzle,8.7,2022-07-31 15:00:00,15
462,416,878,87,25.0,55,Heavy Drizzle,7.4,2022-07-31 16:00:00,16
282,244,526,85,25.3,61,Light Rain,4.0,2022-07-31 17:00:00,17
155,187,342,96,24.1,61,Light Rain,2.3,2022-07-31 18:00:00,18
82,108,190,97,23.9,61,Light Rain,3.1,2022-07-31 19:00:00,19
80,116,196,96,23.6,61,Light Rain,5.2,2022-07-31 20:00:00,20
101,144,245,96,23.1,55,Heavy Drizzle,7.1,2022-07-31 21:00:00,21
88,100,188,96,22.9,53,Heavy Drizzle,8.6,2022-07-31 22:00:00,22
61,55,116,97,22.6,53,Heavy Drizzle,6.1,2022-07-31 23:00:00,23
28,27,55,96,22.5,53,Heavy Drizzle,4.5,2022-08-01 00:00:00,0
14,13,27,97,22.6,51,Light Drizzle,3.6,2022-08-01 01:00:00,1
8,13,21,96,22.7,3,Cloudy,4.3,2022-08-01 02:00:00,2
7,8,15,97,22.4,51,Light Drizzle,2.9,2022-08-01 03:00:00,3
7,16,23,98,22.1,1,Mostly Clear,3.7,2022-08-01 04:00:00,4
35,56,91,99,21.8,2,Partly Cloudy,6.5,2022-08-01 05:00:00,5
67,186,253,99,21.4,3,Cloudy,4.0,2022-08-01 06:00:00,6
128,386,514,98,21.5,3,Cloudy,5.9,2022-08-01 07:00:00,7
209,624,833,93,22.2,1,Mostly Clear,6.6,2022-08-01 08:00:00,8
232,337,569,87,23.2,2,Partly Cloudy,8.4,2022-08-01 09:00:00,9
259,246,505,78,24.6,3,Cloudy,8.4,2022-08-01 10:00:00,10
252,248,500,69,26.0,51,Light Drizzle,8.9,2022-08-01 11:00:00,11
314,308,622,64,26.8,3,Cloudy,10.1,2022-08-01 12:00:00,12
318,302,620,60,27.8,3,Cloudy,11.3,2022-08-01 13:00:00,13
267,320,587,56,28.4,3,Cloudy,10.6,2022-08-01 14:00:00,14
357,405,762,58,28.3,3,Cloudy,9.4,2022-08-01 15:00:00,15
400,447,847,55,29.3,2,Partly Cloudy,8.3,2022-08-01 16:00:00,16
573,769,1342,56,29.6,3,Cloudy,8.6,2022-08-01 17:00:00,17
580,756,1336,60,29.1,2,Partly Cloudy,4.3,2022-08-01 18:00:00,18
422,557,979,66,28.2,1,Mostly Clear,4.9,2022-08-01 19:00:00,19
320,436,756,74,26.9,1,Mostly Clear,5.4,2022-08-01 20:00:00,20
250,313,563,79,25.9,1,Mostly Clear,7.1,2022-08-01 21:00:00,21
182,193,375,85,25.1,1,Mostly Clear,8.0,2022-08-01 22:00:00,22
69,81,150,90,24.4,1,Mostly Clear,5.8,2022-08-01 23:00:00,23
10,21,31,93,24.0,1,Mostly Clear,4.6,2022-08-02 00:00:00,0
14,14,28,94,23.7,0,Clear,5.6,2022-08-02 01:00:00,1
3,3,6,96,23.4,0,Clear,6.6,2022-08-02 02:00:00,2
3,8,11,98,23.7,0,Clear,8.2,2022-08-02 03:00:00,3
6,13,19,97,23.6,0,Clear,9.4,2022-08-02 04:00:00,4
27,65,92,96,23.4,0,Clear,9.0,2022-08-02 05:00:00,5
67,189,256,94,23.3,1,Mostly Clear,6.2,2022-08-02 06:00:00,6
142,416,558,91,23.4,1,Mostly Clear,7.2,2022-08-02 07:00:00,7
235,751,986,86,24.7,1,Mostly Clear,5.4,2022-08-02 08:00:00,8
203,421,624,79,26.2,1,Mostly Clear,6.2,2022-08-02 09:00:00,9
213,281,494,73,27.4,0,Clear,9.2,2022-08-02 10:00:00,10
279,282,561,67,28.7,0,Clear,11.4,2022-08-02 11:00:00,11
292,333,625,63,29.6,0,Clear,11.7,2022-08-02 12:00:00,12
275,288,563,61,30.5,51,Light Drizzle,11.8,2022-08-02 13:00:00,13
253,280,533,58,31.0,1,Mostly Clear,12.1,2022-08-02 14:00:00,14
266,348,614,50,31.5,1,Mostly Clear,12.7,2022-08-02 15:00:00,15
346,512,858,49,31.4,1,Mostly Clear,13.1,2022-08-02 16:00:00,16
554,902,1456,48,31.2,0,Clear,11.4,2022-08-02 17:00:00,17
541,909,1450,50,30.7,0,Clear,9.2,2022-08-02 18:00:00,18
489,618,1107,62,29.4,0,Clear,6.9,2022-08-02 19:00:00,19
342,465,807,63,28.5,0,Clear,6.7,2022-08-02 20:00:00,20
261,309,570,66,26.9,0,Clear,8.2,2022-08-02 21:00:00,21
228,259,487,69,25.8,0,Clear,8.7,2022-08-02 22:00:00,22
107,146,253,68,25.2,0,Clear,8.4,2022-08-02 23:00:00,23
48,44,92,67,24.7,0,Clear,8.4,2022-08-03 00:00:00,0
14,18,32,68,24.2,0,Clear,8.9,2022-08-03 01:00:00,1
12,11,23,71,23.6,0,Clear,9.1,2022-08-03 02:00:00,2
3,8,11,75,23.4,0,Clear,9.4,2022-08-03 03:00:00,3
15,14,29,78,22.9,0,Clear,8.9,2022-08-03 04:00:00,4
35,63,98,81,22.5,0,Clear,7.2,2022-08-03 05:00:00,5
72,208,280,84,22.1,0,Clear,5.1,2022-08-03 06:00:00,6
170,458,628,85,22.0,0,Clear,6.2,2022-08-03 07:00:00,7
276,717,993,76,24.2,0,Clear,3.5,2022-08-03 08:00:00,8
224,469,693,67,25.9,0,Clear,1.5,2022-08-03 09:00:00,9
258,223,481,60,27.6,0,Clear,1.3,2022-08-03 10:00:00,10
272,264,536,54,29.2,0,Clear,2.7,2022-08-03 11:00:00,11
268,320,588,50,30.4,0,Clear,3.8,2022-08-03 12:00:00,12
300,287,587,47,31.4,3,Cloudy,5.6,2022-08-03 13:00:00,13
286,335,621,45,31.9,3,Cloudy,5.3,2022-08-03 14:00:00,14
327,374,701,45,31.9,2,Partly Cloudy,5.9,2022-08-03 15:00:00,15
327,517,844,45,32.0,1,Mostly Clear,7.7,2022-08-03 16:00:00,16
539,828,1367,45,32.1,2,Partly Cloudy,7.6,2022-08-03 17:00:00,17
497,846,1343,48,31.5,0,Clear,7.7,2022-08-03 18:00:00,18
528,593,1121,55,30.5,0,Clear,7.3,2022-08-03 19:00:00,19
399,433,832,63,28.9,0,Clear,7.6,2022-08-03 20:00:00,20
253,306,559,69,27.4,0,Clear,8.9,2022-08-03 21:00:00,21
192,227,419,74,26.5,0,Clear,8.1,2022-08-03 22:00:00,22
124,120,244,78,25.9,0,Clear,8.4,2022-08-03 23:00:00,23
42,46,88,80,25.4,0,Clear,8.8,2022-08-04 00:00:00,0
14,27,41,83,25.0,0,Clear,8.7,2022-08-04 01:00:00,1
13,27,40,85,24.7,0,Clear,9.4,2022-08-04 02:00:00,2
0,4,4,85,24.5,0,Clear,10.0,2022-08-04 03:00:00,3
9,13,22,86,24.2,0,Clear,9.6,2022-08-04 04:00:00,4
38,54,92,87,23.9,0,Clear,8.5,2022-08-04 05:00:00,5
73,156,229,88,23.5,0,Clear,6.3,2022-08-04 06:00:00,6
156,393,549,90,23.4,0,Clear,5.0,2022-08-04 07:00:00,7
279,694,973,81,25.6,0,Clear,3.4,2022-08-04 08:00:00,8
244,360,604,73,27.4,0,Clear,3.1,2022-08-04 09:00:00,9
233,226,459,68,29.3,0,Clear,3.3,2022-08-04 10:00:00,10
265,255,520,62,31.1,0,Clear,2.7,2022-08-04 11:00:00,11
295,297,592,55,32.7,0,Clear,3.6,2022-08-04 12:00:00,12
237,265,502,48,34.0,0,Clear,5.9,2022-08-04 13:00:00,13
258,267,525,43,34.9,0,Clear,7.2,2022-08-04 14:00:00,14
235,339,574,55,33.6,1,Mostly Clear,7.9,2022-08-04 15:00:00,15
322,473,795,67,31.0,53,Heavy Drizzle,10.8,2022-08-04 16:00:00,16
480,717,1197,68,31.0,55,Heavy Drizzle,9.4,2022-08-04 17:00:00,17
264,487,751,69,31.0,1,Mostly Clear,7.4,2022-08-04 18:00:00,18
163,270,433,72,30.1,1,Mostly Clear,7.6,2022-08-04 19:00:00,19
165,249,414,76,29.2,2,Partly Cloudy,5.9,2022-08-04 20:00:00,20
88,149,237,79,28.2,3,Cloudy,4.3,2022-08-04 21:00:00,21
34,61,95,81,27.6,3,Cloudy,1.3,2022-08-04 22:00:00,22
41,73,114,83,26.9,3,Cloudy,0.4,2022-08-04 23:00:00,23
24,33,57,85,26.4,3,Cloudy,0.5,2022-08-05 00:00:00,0
10,18,28,87,25.8,3,Cloudy,3.1,2022-08-05 01:00:00,1
12,8,20,89,25.5,3,Cloudy,5.8,2022-08-05 02:00:00,2
8,14,22,99,23.9,51,Light Drizzle,6.9,2022-08-05 03:00:00,3
9,17,26,99,23.9,51,Light Drizzle,7.6,2022-08-05 04:00:00,4
32,41,73,99,23.9,3,Cloudy,5.9,2022-08-05 05:00:00,5
62,148,210,99,23.8,3,Cloudy,4.1,2022-08-05 06:00:00,6
132,322,454,99,24.0,3,Cloudy,5.0,2022-08-05 07:00:00,7
225,463,688,94,24.8,3,Cloudy,5.0,2022-08-05 08:00:00,8
238,327,565,91,25.9,3,Cloudy,3.6,2022-08-05 09:00:00,9
275,283,558,84,27.3,3,Cloudy,3.1,2022-08-05 10:00:00,10
335,289,624,75,28.7,3,Cloudy,2.5,2022-08-05 11:00:00,11
342,296,638,70,30.0,51,Light Drizzle,2.4,2022-08-05 12:00:00,12
334,371,705,68,30.9,51,Light Drizzle,1.4,2022-08-05 13:00:00,13
364,337,701,68,31.5,51,Light Drizzle,3.6,2022-08-05 14:00:00,14
347,390,737,65,31.1,51,Light Drizzle,6.2,2022-08-05 15:00:00,15
256,345,601,65,31.3,1,Mostly Clear,8.0,2022-08-05 16:00:00,16
149,232,381,70,30.2,61,Light Rain,8.7,2022-08-05 17:00:00,17
180,254,434,81,27.2,63,Rain,5.6,2022-08-05 18:00:00,18
200,293,493,91,25.1,63,Rain,7.5,2022-08-05 19:00:00,19
218,237,455,92,25.0,51,Light Drizzle,4.7,2022-08-05 20:00:00,20
171,192,363,94,24.8,51,Light Drizzle,6.8,2022-08-05 21:00:00,21
161,182,343,96,24.7,3,Cloudy,7.9,2022-08-05 22:00:00,22
114,148,262,96,24.6,3,Cloudy,8.5,2022-08-05 23:00:00,23
119,123,242,96,24.5,3,Cloudy,8.2,2022-08-06 00:00:00,0
108,100,208,97,24.3,3,Cloudy,8.4,2022-08-06 01:00:00,1
80,56,136,98,24.3,3,Cloudy,9.5,2022-08-06 02:00:00,2
48,37,85,98,23.3,2,Partly Cloudy,9.8,2022-08-06 03:00:00,3
16,16,32,98,23.2,3,Cloudy,8.3,2022-08-06 04:00:00,4
21,31,52,98,22.9,3,Cloudy,9.0,2022-08-06 05:00:00,5
55,64,119,97,23.0,3,Cloudy,7.9,2022-08-06 06:00:00,6
108,155,263,96,23.1,3,Cloudy,10.8,2022-08-06 07:00:00,7
205,265,470,93,23.6,3,Cloudy,10.9,2022-08-06 08:00:00,8
357,317,674,88,24.7,3,Cloudy,10.9,2022-08-06 09:00:00,9
556,400,956,83,26.0,3,Cloudy,10.7,2022-08-06 10:00:00,10
537,482,1019,78,27.1,3,Cloudy,9.8,2022-08-06 11:00:00,11
691,527,1218,72,28.4,3,Cloudy,8.9,2022-08-06 12:00:00,12
625,485,1110,70,29.3,3,Cloudy,11.4,2022-08-06 13:00:00,13
637,515,1152,71,29.8,3,Cloudy,13.6,2022-08-06 14:00:00,14
613,473,1086,86,26.6,51,Light Drizzle,8.3,2022-08-06 15:00:00,15
556,425,981,80,27.8,51,Light Drizzle,12.2,2022-08-06 16:00:00,16
627,432,1059,75,28.8,3,Cloudy,13.1,2022-08-06 17:00:00,17
487,442,929,73,28.9,3,Cloudy,8.8,2022-08-06 18:00:00,18
518,356,874,77,28.4,1,Mostly Clear,8.1,2022-08-06 19:00:00,19
346,284,630,82,27.5,1,Mostly Clear,10.1,2022-08-06 20:00:00,20
300,215,515,85,26.7,1,Mostly Clear,11.2,2022-08-06 21:00:00,21
255,226,481,88,26.2,1,Mostly Clear,9.8,2022-08-06 22:00:00,22
213,182,395,90,25.9,1,Mostly Clear,8.7,2022-08-06 23:00:00,23
148,110,258,91,25.6,3,Cloudy,8.4,2022-08-07 00:00:00,0
96,108,204,91,25.4,3,Cloudy,9.8,2022-08-07 01:00:00,1
98,51,149,91,25.2,2,Partly Cloudy,10.8,2022-08-07 02:00:00,2
35,29,64,90,24.9,1,Mostly Clear,10.4,2022-08-07 03:00:00,3
21,8,29,90,24.7,1,Mostly Clear,9.7,2022-08-07 04:00:00,4
16,11,27,90,24.5,2,Partly Cloudy,8.9,2022-08-07 05:00:00,5
49,46,95,91,24.3,1,Mostly Clear,8.2,2022-08-07 06:00:00,6
72,95,167,91,24.3,1,Mostly Clear,8.5,2022-08-07 07:00:00,7
154,201,355,89,25.1,2,Partly Cloudy,8.6,2022-08-07 08:00:00,8
324,264,588,84,26.3,1,Mostly Clear,10.4,2022-08-07 09:00:00,9
452,335,787,78,27.6,0,Clear,10.5,2022-08-07 10:00:00,10
482,382,864,73,28.9,0,Clear,9.3,2022-08-07 11:00:00,11
512,432,944,69,30.0,51,Light Drizzle,10.4,2022-08-07 12:00:00,12
566,408,974,65,30.7,1,Mostly Clear,12.1,2022-08-07 13:00:00,13
498,383,881,63,31.3,1,Mostly Clear,13.1,2022-08-07 14:00:00,14
482,374,856,61,31.8,1,Mostly Clear,12.7,2022-08-07 15:00:00,15
479,395,874,58,31.1,55,Heavy Drizzle,11.8,2022-08-07 16:00:00,16
450,403,853,59,31.0,1,Mostly Clear,11.9,2022-08-07 17:00:00,17
397,377,774,62,30.5,2,Partly Cloudy,7.8,2022-08-07 18:00:00,18
400,321,721,64,29.9,2,Partly Cloudy,6.5,2022-08-07 19:00:00,19
299,282,581,70,28.7,1,Mostly Clear,7.6,2022-08-07 20:00:00,20
225,164,389,73,27.7,1,Mostly Clear,8.3,2022-08-07 21:00:00,21
161,159,320,76,27.2,0,Clear,9.1,2022-08-07 22:00:00,22
90,56,146,78,26.7,0,Clear,10.5,2022-08-07 23:00:00,23
47,32,79,78,26.5,0,Clear,11.1,2022-08-08 00:00:00,0
29,23,52,80,26.1,0,Clear,11.3,2022-08-08 01:00:00,1
6,14,20,82,25.7,0,Clear,10.5,2022-08-08 02:00:00,2
5,12,17,85,25.5,0,Clear,10.5,2022-08-08 03:00:00,3
13,12,25,85,25.2,0,Clear,9.8,2022-08-08 04:00:00,4
26,60,86,86,24.9,0,Clear,9.3,2022-08-08 05:00:00,5
74,157,231,87,24.7,0,Clear,8.3,2022-08-08 06:00:00,6
128,361,489,89,24.6,0,Clear,8.7,2022-08-08 07:00:00,7
210,532,742,85,25.6,0,Clear,7.9,2022-08-08 08:00:00,8
216,307,523,80,27.1,0,Clear,8.2,2022-08-08 09:00:00,9
246,215,461,75,28.5,0,Clear,7.9,2022-08-08 10:00:00,10
235,232,467,69,30.1,0,Clear,7.8,2022-08-08 11:00:00,11
266,273,539,63,31.5,1,Mostly Clear,7.2,2022-08-08 12:00:00,12
249,274,523,60,32.4,1,Mostly Clear,8.1,2022-08-08 13:00:00,13
291,280,571,58,33.1,1,Mostly Clear,10.1,2022-08-08 14:00:00,14
308,363,671,56,33.1,2,Partly Cloudy,11.9,2022-08-08 15:00:00,15
291,399,690,55,33.3,1,Mostly Clear,12.5,2022-08-08 16:00:00,16
401,680,1081,55,33.1,51,Light Drizzle,11.7,2022-08-08 17:00:00,17
383,631,1014,55,32.5,1,Mostly Clear,9.7,2022-08-08 18:00:00,18
363,458,821,61,30.8,51,Light Drizzle,6.6,2022-08-08 19:00:00,19
263,351,614,69,29.6,1,Mostly Clear,7.3,2022-08-08 20:00:00,20
164,264,428,73,28.6,0,Clear,8.6,2022-08-08 21:00:00,21
133,168,301,77,27.8,0,Clear,10.6,2022-08-08 22:00:00,22
225,213,438,81,27.4,0,Clear,11.4,2022-08-08 23:00:00,23
114,75,189,80,27.1,0,Clear,10.3,2022-08-09 00:00:00,0
19,22,41,78,26.9,0,Clear,10.1,2022-08-09 01:00:00,1
7,7,14,77,26.6,0,Clear,10.4,2022-08-09 02:00:00,2
3,21,24,87,26.3,0,Clear,10.2,2022-08-09 03:00:00,3
9,14,23,87,25.9,0,Clear,9.0,2022-08-09 04:00:00,4
32,51,83,88,25.5,0,Clear,9.0,2022-08-09 05:00:00,5
76,194,270,90,25.2,0,Clear,6.6,2022-08-09 06:00:00,6
131,414,545,91,25.1,0,Clear,8.2,2022-08-09 07:00:00,7
264,694,958,85,26.5,0,Clear,7.6,2022-08-09 08:00:00,8
204,376,580,78,28.2,0,Clear,7.8,2022-08-09 09:00:00,9
270,222,492,68,30.2,0,Clear,8.9,2022-08-09 10:00:00,10
278,239,517,60,31.8,0,Clear,9.6,2022-08-09 11:00:00,11
289,314,603,55,33.0,0,Clear,9.3,2022-08-09 12:00:00,12
256,247,503,50,34.1,0,Clear,9.2,2022-08-09 13:00:00,13
233,222,455,47,34.8,1,Mostly Clear,9.9,2022-08-09 14:00:00,14
274,276,550,49,34.6,0,Clear,10.5,2022-08-09 15:00:00,15
333,446,779,48,34.4,0,Clear,11.3,2022-08-09 16:00:00,16
452,756,1208,48,33.9,0,Clear,11.2,2022-08-09 17:00:00,17
460,778,1238,48,33.6,2,Partly Cloudy,8.8,2022-08-09 18:00:00,18
409,545,954,65,32.1,1,Mostly Clear,6.9,2022-08-09 19:00:00,19
309,421,730,57,31.7,1,Mostly Clear,5.2,2022-08-09 20:00:00,20
179,219,398,69,29.8,1,Mostly Clear,5.4,2022-08-09 21:00:00,21
141,186,327,61,30.2,1,Mostly Clear,6.6,2022-08-09 22:00:00,22
55,100,155,74,28.1,0,Clear,7.1,2022-08-09 23:00:00,23
28,24,52,74,27.4,0,Clear,6.8,2022-08-10 00:00:00,0
14,13,27,76,27.0,0,Clear,5.2,2022-08-10 01:00:00,1
11,10,21,81,26.4,0,Clear,6.4,2022-08-10 02:00:00,2
2,6,8,91,25.6,0,Clear,6.4,2022-08-10 03:00:00,3
6,12,18,93,25.3,0,Clear,5.6,2022-08-10 04:00:00,4
25,69,94,94,24.9,0,Clear,6.1,2022-08-10 05:00:00,5
82,191,273,94,24.7,2,Partly Cloudy,4.1,2022-08-10 06:00:00,6
149,438,587,94,24.8,3,Cloudy,2.8,2022-08-10 07:00:00,7
261,728,989,84,26.7,2,Partly Cloudy,1.3,2022-08-10 08:00:00,8
202,394,596,75,28.0,2,Partly Cloudy,0.8,2022-08-10 09:00:00,9
202,227,429,68,29.4,1,Mostly Clear,1.5,2022-08-10 10:00:00,10
276,275,551,64,30.4,0,Clear,3.1,2022-08-10 11:00:00,11
251,282,533,61,31.4,0,Clear,3.9,2022-08-10 12:00:00,12
218,318,536,59,32.2,0,Clear,3.8,2022-08-10 13:00:00,13
239,305,544,57,32.8,1,Mostly Clear,3.4,2022-08-10 14:00:00,14
295,365,660,69,31.0,63,Rain,2.9,2022-08-10 15:00:00,15
189,286,475,77,28.6,65,Heavy Rain,4.3,2022-08-10 16:00:00,16
69,154,223,82,27.6,65,Heavy Rain,1.3,2022-08-10 17:00:00,17
64,185,249,90,26.1,65,Heavy Rain,9.0,2022-08-10 18:00:00,18
46,100,146,94,25.5,61,Light Rain,7.9,2022-08-10 19:00:00,19
32,111,143,96,24.9,53,Heavy Drizzle,4.0,2022-08-10 20:00:00,20
70,156,226,96,24.8,51,Light Drizzle,5.2,2022-08-10 21:00:00,21
94,148,242,96,24.7,3,Cloudy,8.2,2022-08-10 22:00:00,22
62,87,149,98,24.4,3,Cloudy,10.0,2022-08-10 23:00:00,23
25,26,51,98,24.3,3,Cloudy,9.7,2022-08-11 00:00:00,0
19,8,27,97,24.1,3,Cloudy,9.8,2022-08-11 01:00:00,1
2,5,7,97,23.8,3,Cloudy,9.7,2022-08-11 02:00:00,2
6,6,12,95,23.1,61,Light Rain,9.4,2022-08-11 03:00:00,3
6,13,19,97,22.9,63,Rain,9.4,2022-08-11 04:00:00,4
26,65,91,97,22.9,63,Rain,8.6,2022-08-11 05:00:00,5
98,166,264,97,22.8,55,Heavy Drizzle,6.0,2022-08-11 06:00:00,6
134,402,536,97,22.7,53,Heavy Drizzle,8.7,2022-08-11 07:00:00,7
257,605,862,97,22.8,53,Heavy Drizzle,9.5,2022-08-11 08:00:00,8
226,383,609,95,23.2,51,Light Drizzle,11.2,2022-08-11 09:00:00,9
258,252,510,93,23.2,53,Heavy Drizzle,11.5,2022-08-11 10:00:00,10
270,294,564,89,23.0,51,Light Drizzle,12.7,2022-08-11 11:00:00,11
318,319,637,79,24.0,1,Mostly Clear,11.7,2022-08-11 12:00:00,12
298,322,620,68,25.3,1,Mostly Clear,10.7,2022-08-11 13:00:00,13
286,324,610,56,27.1,0,Clear,8.9,2022-08-11 14:00:00,14
292,385,677,45,29.3,0,Clear,8.7,2022-08-11 15:00:00,15
416,541,957,42,29.9,0,Clear,8.4,2022-08-11 16:00:00,16
570,838,1408,42,30.1,0,Clear,6.6,2022-08-11 17:00:00,17
609,811,1420,45,29.7,0,Clear,6.5,2022-08-11 18:00:00,18
489,658,1147,54,28.6,0,Clear,5.7,2022-08-11 19:00:00,19
383,406,789,60,26.9,0,Clear,6.2,2022-08-11 20:00:00,20
267,299,566,62,25.7,0,Clear,7.8,2022-08-11 21:00:00,21
170,254,424,64,24.9,1,Mostly Clear,10.1,2022-08-11 22:00:00,22
98,139,237,62,24.5,1,Mostly Clear,11.4,2022-08-11 23:00:00,23
73,94,167,59,24.4,2,Partly Cloudy,12.0,2022-08-12 00:00:00,0
41,28,69,56,24.4,3,Cloudy,13.3,2022-08-12 01:00:00,1
24,13,37,53,24.2,3,Cloudy,13.3,2022-08-12 02:00:00,2
6,10,16,61,23.5,51,Light Drizzle,10.2,2022-08-12 03:00:00,3
15,8,23,62,23.0,1,Mostly Clear,9.2,2022-08-12 04:00:00,4
30,42,72,61,22.5,1,Mostly Clear,9.5,2022-08-12 05:00:00,5
54,159,213,61,21.9,1,Mostly Clear,10.0,2022-08-12 06:00:00,6
130,330,460,64,21.4,1,Mostly Clear,10.6,2022-08-12 07:00:00,7
221,490,711,67,21.7,1,Mostly Clear,11.2,2022-08-12 08:00:00,8
196,362,558,62,22.6,1,Mostly Clear,12.3,2022-08-12 09:00:00,9
272,239,511,59,23.5,1,Mostly Clear,11.5,2022-08-12 10:00:00,10
290,309,599,56,24.7,0,Clear,10.4,2022-08-12 11:00:00,11
329,377,706,50,26.0,1,Mostly Clear,10.1,2022-08-12 12:00:00,12
361,370,731,45,26.6,0,Clear,10.1,2022-08-12 13:00:00,13
389,343,732,41,27.3,0,Clear,10.1,2022-08-12 14:00:00,14
451,422,873,40,27.4,0,Clear,9.7,2022-08-12 15:00:00,15
498,531,1029,39,27.7,0,Clear,10.1,2022-08-12 16:00:00,16
639,732,1371,39,27.4,0,Clear,9.7,2022-08-12 17:00:00,17
537,627,1164,43,26.9,0,Clear,10.9,2022-08-12 18:00:00,18
494,539,1033,63,25.9,0,Clear,6.6,2022-08-12 19:00:00,19
335,380,715,44,26.5,0,Clear,4.3,2022-08-12 20:00:00,20
285,281,566,50,25.5,0,Clear,5.6,2022-08-12 21:00:00,21
255,254,509,57,24.5,0,Clear,6.9,2022-08-12 22:00:00,22
250,238,488,75,21.0,0,Clear,7.7,2022-08-12 23:00:00,23
149,132,281,75,19.5,0,Clear,9.4,2022-08-13 00:00:00,0
106,83,189,59,19.4,0,Clear,10.4,2022-08-13 01:00:00,1
97,54,151,52,19.1,0,Clear,11.2,2022-08-13 02:00:00,2
51,28,79,60,18.4,0,Clear,11.7,2022-08-13 03:00:00,3
20,16,36,60,18.1,0,Clear,11.8,2022-08-13 04:00:00,4
23,28,51,60,17.7,0,Clear,11.4,2022-08-13 05:00:00,5
38,54,92,64,17.1,0,Clear,9.8,2022-08-13 06:00:00,6
84,160,244,71,16.7,0,Clear,9.8,2022-08-13 07:00:00,7
165,219,384,66,18.7,0,Clear,9.0,2022-08-13 08:00:00,8
296,365,661,58,20.7,0,Clear,8.3,2022-08-13 09:00:00,9
477,380,857,52,22.3,0,Clear,8.8,2022-08-13 10:00:00,10
567,449,1016,45,23.6,0,Clear,9.0,2022-08-13 11:00:00,11
667,505,1172,41,24.8,0,Clear,7.5,2022-08-13 12:00:00,12
722,452,1174,37,25.8,0,Clear,6.1,2022-08-13 13:00:00,13
678,529,1207,35,26.6,0,Clear,4.3,2022-08-13 14:00:00,14
706,503,1209,36,26.9,0,Clear,3.5,2022-08-13 15:00:00,15
699,468,1167,35,27.1,0,Clear,1.3,2022-08-13 16:00:00,16
616,494,1110,35,27.0,0,Clear,2.3,2022-08-13 17:00:00,17
519,438,957,38,26.6,1,Mostly Clear,1.4,2022-08-13 18:00:00,18
440,357,797,47,25.4,1,Mostly Clear,3.9,2022-08-13 19:00:00,19
344,305,649,56,23.6,1,Mostly Clear,6.5,2022-08-13 20:00:00,20
279,204,483,59,22.2,1,Mostly Clear,6.7,2022-08-13 21:00:00,21
290,231,521,65,21.2,1,Mostly Clear,8.6,2022-08-13 22:00:00,22
198,175,373,70,20.4,1,Mostly Clear,8.7,2022-08-13 23:00:00,23
132,110,242,76,19.5,1,Mostly Clear,7.9,2022-08-14 00:00:00,0
106,83,189,81,19.1,1,Mostly Clear,7.2,2022-08-14 01:00:00,1
66,51,117,84,18.6,1,Mostly Clear,6.8,2022-08-14 02:00:00,2
37,23,60,90,19.0,2,Partly Cloudy,6.5,2022-08-14 03:00:00,3
7,12,19,88,19.0,3,Cloudy,6.8,2022-08-14 04:00:00,4
21,13,34,87,19.1,2,Partly Cloudy,5.9,2022-08-14 05:00:00,5
35,43,78,87,19.2,1,Mostly Clear,5.0,2022-08-14 06:00:00,6
90,106,196,87,19.2,0,Clear,4.8,2022-08-14 07:00:00,7
167,184,351,80,20.9,0,Clear,4.1,2022-08-14 08:00:00,8
279,291,570,69,22.6,0,Clear,4.9,2022-08-14 09:00:00,9
458,440,898,59,24.3,0,Clear,6.2,2022-08-14 10:00:00,10
590,463,1053,48,25.7,0,Clear,9.3,2022-08-14 11:00:00,11
586,452,1038,42,26.5,1,Mostly Clear,10.9,2022-08-14 12:00:00,12
650,460,1110,40,26.6,1,Mostly Clear,11.6,2022-08-14 13:00:00,13
632,416,1048,39,26.9,2,Partly Cloudy,11.9,2022-08-14 14:00:00,14
676,410,1086,44,26.5,2,Partly Cloudy,12.1,2022-08-14 15:00:00,15
593,437,1030,45,26.4,2,Partly Cloudy,12.4,2022-08-14 16:00:00,16
496,452,948,48,25.9,2,Partly Cloudy,10.7,2022-08-14 17:00:00,17
241,249,490,54,25.1,3,Cloudy,10.4,2022-08-14 18:00:00,18
248,235,483,59,24.2,3,Cloudy,5.6,2022-08-14 19:00:00,19
114,144,258,62,23.3,51,Light Drizzle,4.6,2022-08-14 20:00:00,20
116,108,224,72,22.1,51,Light Drizzle,4.3,2022-08-14 21:00:00,21
61,70,131,73,21.4,53,Heavy Drizzle,4.0,2022-08-14 22:00:00,22
26,40,66,79,20.6,51,Light Drizzle,2.9,2022-08-14 23:00:00,23
10,11,21,86,20.0,61,Light Rain,3.8,2022-08-15 00:00:00,0
6,10,16,90,19.5,61,Light Rain,6.6,2022-08-15 01:00:00,1
4,10,14,90,19.3,61,Light Rain,8.5,2022-08-15 02:00:00,2
6,10,16,91,19.6,53,Heavy Drizzle,7.4,2022-08-15 03:00:00,3
10,16,26,92,19.5,53,Heavy Drizzle,7.0,2022-08-15 04:00:00,4
22,48,70,91,19.7,51,Light Drizzle,5.4,2022-08-15 05:00:00,5
60,159,219,93,19.4,2,Partly Cloudy,3.4,2022-08-15 06:00:00,6
109,330,439,91,19.7,51,Light Drizzle,2.6,2022-08-15 07:00:00,7
211,539,750,93,19.9,51,Light Drizzle,2.7,2022-08-15 08:00:00,8
169,346,515,92,20.3,2,Partly Cloudy,4.5,2022-08-15 09:00:00,9
223,218,441,84,21.3,2,Partly Cloudy,4.8,2022-08-15 10:00:00,10
277,295,572,78,21.7,3,Cloudy,5.8,2022-08-15 11:00:00,11
297,294,591,72,22.5,3,Cloudy,5.9,2022-08-15 12:00:00,12
288,303,591,64,23.2,3,Cloudy,7.2,2022-08-15 13:00:00,13
290,268,558,61,23.7,3,Cloudy,6.7,2022-08-15 14:00:00,14
320,319,639,69,23.2,51,Light Drizzle,6.5,2022-08-15 15:00:00,15
283,408,691,73,22.7,51,Light Drizzle,5.9,2022-08-15 16:00:00,16
450,743,1193,78,22.0,51,Light Drizzle,4.6,2022-08-15 17:00:00,17
513,710,1223,80,21.8,51,Light Drizzle,6.2,2022-08-15 18:00:00,18
322,472,794,84,21.1,51,Light Drizzle,7.9,2022-08-15 19:00:00,19
255,336,591,88,20.3,51,Light Drizzle,7.8,2022-08-15 20:00:00,20
164,223,387,91,19.6,2,Partly Cloudy,9.1,2022-08-15 21:00:00,21
180,180,360,92,19.3,2,Partly Cloudy,8.4,2022-08-15 22:00:00,22
69,72,141,92,19.0,2,Partly Cloudy,8.4,2022-08-15 23:00:00,23
29,35,64,91,19.0,2,Partly Cloudy,8.0,2022-08-16 00:00:00,0
4,7,11,92,18.8,1,Mostly Clear,8.4,2022-08-16 01:00:00,1
6,8,14,93,18.7,1,Mostly Clear,8.0,2022-08-16 02:00:00,2
6,12,18,95,18.4,1,Mostly Clear,7.6,2022-08-16 03:00:00,3
7,19,26,94,18.2,2,Partly Cloudy,7.6,2022-08-16 04:00:00,4
30,66,96,94,18.1,2,Partly Cloudy,8.6,2022-08-16 05:00:00,5
65,207,272,92,18.0,1,Mostly Clear,7.3,2022-08-16 06:00:00,6
163,421,584,91,18.2,1,Mostly Clear,8.0,2022-08-16 07:00:00,7
257,715,972,88,19.2,1,Mostly Clear,8.5,2022-08-16 08:00:00,8
225,432,657,81,21.0,1,Mostly Clear,7.1,2022-08-16 09:00:00,9
236,277,513,73,22.6,1,Mostly Clear,9.2,2022-08-16 10:00:00,10
273,294,567,62,23.8,51,Light Drizzle,10.2,2022-08-16 11:00:00,11
304,324,628,56,24.7,1,Mostly Clear,11.4,2022-08-16 12:00:00,12
291,301,592,51,25.7,1,Mostly Clear,12.4,2022-08-16 13:00:00,13
321,317,638,49,26.0,1,Mostly Clear,13.4,2022-08-16 14:00:00,14
339,399,738,48,26.2,0,Clear,11.0,2022-08-16 15:00:00,15
434,533,967,46,26.4,1,Mostly Clear,10.0,2022-08-16 16:00:00,16
626,935,1561,46,26.3,1,Mostly Clear,9.6,2022-08-16 17:00:00,17
613,891,1504,50,25.7,1,Mostly Clear,9.3,2022-08-16 18:00:00,18
515,573,1088,57,24.8,1,Mostly Clear,8.0,2022-08-16 19:00:00,19
356,424,780,66,23.4,0,Clear,7.4,2022-08-16 20:00:00,20
238,301,539,70,22.1,0,Clear,7.5,2022-08-16 21:00:00,21
181,208,389,77,21.0,0,Clear,7.6,2022-08-16 22:00:00,22
115,136,251,84,20.1,0,Clear,4.9,2022-08-16 23:00:00,23
45,52,97,83,20.2,1,Mostly Clear,6.1,2022-08-17 00:00:00,0
16,17,33,80,21.0,1,Mostly Clear,5.9,2022-08-17 01:00:00,1
3,13,16,87,19.4,1,Mostly Clear,4.5,2022-08-17 02:00:00,2
7,11,18,86,20.0,1,Mostly Clear,3.8,2022-08-17 03:00:00,3
10,11,21,93,18.3,0,Clear,3.7,2022-08-17 04:00:00,4
26,61,87,96,17.5,0,Clear,3.2,2022-08-17 05:00:00,5
75,196,271,96,17.3,0,Clear,5.0,2022-08-17 06:00:00,6
153,438,591,96,17.5,0,Clear,6.1,2022-08-17 07:00:00,7
284,755,1039,89,20.2,0,Clear,4.5,2022-08-17 08:00:00,8
264,447,711,79,22.4,1,Mostly Clear,2.6,2022-08-17 09:00:00,9
248,300,548,66,23.9,1,Mostly Clear,2.3,2022-08-17 10:00:00,10
266,309,575,58,25.1,1,Mostly Clear,2.3,2022-08-17 11:00:00,11
297,389,686,55,25.8,1,Mostly Clear,3.8,2022-08-17 12:00:00,12
355,344,699,54,26.2,51,Light Drizzle,4.6,2022-08-17 13:00:00,13
295,313,608,53,26.5,1,Mostly Clear,5.2,2022-08-17 14:00:00,14
344,401,745,51,27.2,1,Mostly Clear,4.3,2022-08-17 15:00:00,15
424,508,932,50,26.9,1,Mostly Clear,4.5,2022-08-17 16:00:00,16
521,822,1343,48,26.7,1,Mostly Clear,3.3,2022-08-17 17:00:00,17
489,747,1236,47,26.6,1,Mostly Clear,6.6,2022-08-17 18:00:00,18
423,575,998,58,24.7,1,Mostly Clear,6.1,2022-08-17 19:00:00,19
222,326,548,68,23.6,1,Mostly Clear,4.5,2022-08-17 20:00:00,20
214,265,479,76,22.4,1,Mostly Clear,4.3,2022-08-17 21:00:00,21
164,192,356,85,21.2,1,Mostly Clear,3.4,2022-08-17 22:00:00,22
80,105,185,89,20.5,0,Clear,3.5,2022-08-17 23:00:00,23
48,41,89,91,19.8,0,Clear,4.0,2022-08-18 00:00:00,0
22,19,41,93,19.3,0,Clear,4.3,2022-08-18 01:00:00,1
18,7,25,95,18.8,0,Clear,5.4,2022-08-18 02:00:00,2
2,13,15,90,17.9,0,Clear,6.1,2022-08-18 03:00:00,3
15,14,29,90,17.5,0,Clear,7.1,2022-08-18 04:00:00,4
19,48,67,91,17.2,0,Clear,7.7,2022-08-18 05:00:00,5
72,190,262,91,16.9,0,Clear,6.1,2022-08-18 06:00:00,6
121,425,546,92,16.7,0,Clear,6.8,2022-08-18 07:00:00,7
266,687,953,83,19.0,0,Clear,4.1,2022-08-18 08:00:00,8
247,392,639,73,21.3,0,Clear,3.7,2022-08-18 09:00:00,9
242,262,504,62,23.4,0,Clear,4.5,2022-08-18 10:00:00,10
290,288,578,55,25.1,0,Clear,5.5,2022-08-18 11:00:00,11
294,335,629,50,26.4,0,Clear,6.3,2022-08-18 12:00:00,12
309,297,606,46,27.4,0,Clear,8.0,2022-08-18 13:00:00,13
395,322,717,44,28.0,0,Clear,8.6,2022-08-18 14:00:00,14
382,397,779,44,28.1,0,Clear,8.6,2022-08-18 15:00:00,15
485,526,1011,43,28.2,0,Clear,9.0,2022-08-18 16:00:00,16
595,899,1494,43,28.1,0,Clear,9.0,2022-08-18 17:00:00,17
556,871,1427,46,27.6,0,Clear,7.2,2022-08-18 18:00:00,18
471,621,1092,56,26.5,0,Clear,4.3,2022-08-18 19:00:00,19
350,447,797,60,25.2,0,Clear,5.2,2022-08-18 20:00:00,20
264,331,595,63,23.8,0,Clear,7.1,2022-08-18 21:00:00,21
228,236,464,68,22.8,0,Clear,8.4,2022-08-18 22:00:00,22
93,115,208,72,22.1,0,Clear,8.5,2022-08-18 23:00:00,23
59,63,122,77,21.5,0,Clear,7.6,2022-08-19 00:00:00,0
24,47,71,82,20.9,0,Clear,9.0,2022-08-19 01:00:00,1
17,21,38,86,20.3,0,Clear,8.5,2022-08-19 02:00:00,2
8,8,16,89,20.1,0,Clear,8.9,2022-08-19 03:00:00,3
8,13,21,91,19.8,0,Clear,7.4,2022-08-19 04:00:00,4
22,56,78,93,19.3,0,Clear,6.3,2022-08-19 05:00:00,5
63,162,225,94,18.9,0,Clear,4.9,2022-08-19 06:00:00,6
129,333,462,94,19.0,0,Clear,2.7,2022-08-19 07:00:00,7
200,553,753,88,21.4,0,Clear,1.5,2022-08-19 08:00:00,8
231,360,591,79,23.7,0,Clear,1.8,2022-08-19 09:00:00,9
234,274,508,70,25.7,0,Clear,2.6,2022-08-19 10:00:00,10
329,275,604,62,27.4,0,Clear,4.0,2022-08-19 11:00:00,11
366,358,724,56,28.6,51,Light Drizzle,5.8,2022-08-19 12:00:00,12
344,372,716,54,28.9,1,Mostly Clear,7.6,2022-08-19 13:00:00,13
360,396,756,52,29.2,1,Mostly Clear,9.1,2022-08-19 14:00:00,14
397,471,868,51,29.6,2,Partly Cloudy,10.0,2022-08-19 15:00:00,15
448,504,952,66,26.6,51,Light Drizzle,10.2,2022-08-19 16:00:00,16
506,654,1160,71,26.3,51,Light Drizzle,12.4,2022-08-19 17:00:00,17
451,669,1120,72,26.4,2,Partly Cloudy,8.7,2022-08-19 18:00:00,18
437,537,974,74,25.9,2,Partly Cloudy,8.0,2022-08-19 19:00:00,19
339,343,682,77,24.9,1,Mostly Clear,7.6,2022-08-19 20:00:00,20
238,257,495,80,24.1,1,Mostly Clear,5.9,2022-08-19 21:00:00,21
235,202,437,82,23.6,2,Partly Cloudy,7.1,2022-08-19 22:00:00,22
169,197,366,82,23.0,2,Partly Cloudy,6.6,2022-08-19 23:00:00,23
139,138,277,81,22.6,2,Partly Cloudy,6.2,2022-08-20 00:00:00,0
104,100,204,81,22.3,1,Mostly Clear,6.3,2022-08-20 01:00:00,1
69,57,126,82,22.0,1,Mostly Clear,6.6,2022-08-20 02:00:00,2
35,24,59,91,21.6,0,Clear,5.9,2022-08-20 03:00:00,3
19,19,38,94,20.9,0,Clear,5.9,2022-08-20 04:00:00,4
18,23,41,95,20.4,0,Clear,5.6,2022-08-20 05:00:00,5
35,58,93,95,20.2,0,Clear,2.3,2022-08-20 06:00:00,6
89,146,235,94,20.7,0,Clear,1.0,2022-08-20 07:00:00,7
166,233,399,93,22.1,0,Clear,0.8,2022-08-20 08:00:00,8
295,371,666,86,23.7,0,Clear,1.5,2022-08-20 09:00:00,9
422,404,826,77,25.2,0,Clear,1.6,2022-08-20 10:00:00,10
566,489,1055,68,26.5,0,Clear,4.9,2022-08-20 11:00:00,11
580,478,1058,60,27.8,0,Clear,8.0,2022-08-20 12:00:00,12
641,491,1132,55,28.8,0,Clear,9.2,2022-08-20 13:00:00,13
630,451,1081,53,29.5,1,Mostly Clear,9.5,2022-08-20 14:00:00,14
622,404,1026,50,30.1,1,Mostly Clear,9.8,2022-08-20 15:00:00,15
604,445,1049,50,30.1,0,Clear,10.8,2022-08-20 16:00:00,16
552,486,1038,50,29.6,1,Mostly Clear,12.1,2022-08-20 17:00:00,17
492,480,972,54,28.6,2,Partly Cloudy,10.2,2022-08-20 18:00:00,18
522,429,951,60,27.5,2,Partly Cloudy,6.7,2022-08-20 19:00:00,19
267,310,577,67,26.1,1,Mostly Clear,6.6,2022-08-20 20:00:00,20
284,263,547,70,25.1,1,Mostly Clear,5.6,2022-08-20 21:00:00,21
216,217,433,73,24.2,1,Mostly Clear,7.1,2022-08-20 22:00:00,22
162,173,335,76,23.3,1,Mostly Clear,7.7,2022-08-20 23:00:00,23
157,123,280,79,22.5,1,Mostly Clear,7.3,2022-08-21 00:00:00,0
105,96,201,82,21.7,0,Clear,6.2,2022-08-21 01:00:00,1
61,71,132,86,21.0,0,Clear,6.2,2022-08-21 02:00:00,2
36,30,66,93,21.0,1,Mostly Clear,7.3,2022-08-21 03:00:00,3
11,15,26,94,20.9,1,Mostly Clear,7.8,2022-08-21 04:00:00,4
23,10,33,95,20.8,1,Mostly Clear,7.9,2022-08-21 05:00:00,5
29,46,75,97,20.8,3,Cloudy,6.5,2022-08-21 06:00:00,6
57,132,189,98,20.9,3,Cloudy,6.8,2022-08-21 07:00:00,7
133,207,340,91,22.8,3,Cloudy,6.5,2022-08-21 08:00:00,8
244,299,543,83,24.3,3,Cloudy,9.4,2022-08-21 09:00:00,9
435,367,802,76,25.5,3,Cloudy,8.8,2022-08-21 10:00:00,10
485,439,924,69,26.6,3,Cloudy,8.8,2022-08-21 11:00:00,11
449,433,882,64,27.6,2,Partly Cloudy,10.5,2022-08-21 12:00:00,12
314,321,635,61,28.3,3,Cloudy,11.7,2022-08-21 13:00:00,13
309,255,564,58,28.5,3,Cloudy,12.6,2022-08-21 14:00:00,14
370,360,730,76,26.1,55,Heavy Drizzle,7.9,2022-08-21 15:00:00,15
379,334,713,76,26.2,51,Light Drizzle,9.1,2022-08-21 16:00:00,16
380,429,809,80,25.6,61,Light Rain,9.1,2022-08-21 17:00:00,17
307,412,719,89,23.9,63,Rain,6.4,2022-08-21 18:00:00,18
185,238,423,94,23.1,61,Light Rain,3.9,2022-08-21 19:00:00,19
108,159,267,95,22.7,53,Heavy Drizzle,6.0,2022-08-21 20:00:00,20
112,112,224,97,22.2,61,Light Rain,6.8,2022-08-21 21:00:00,21
73,83,156,98,22.0,63,Rain,7.7,2022-08-21 22:00:00,22
53,51,104,98,22.0,63,Rain,7.6,2022-08-21 23:00:00,23
20,20,40,98,22.0,61,Light Rain,6.8,2022-08-22 00:00:00,0
14,10,24,98,21.9,61,Light Rain,7.2,2022-08-22 01:00:00,1
15,11,26,99,21.8,61,Light Rain,7.7,2022-08-22 02:00:00,2
3,7,10,98,22.1,2,Partly Cloudy,8.2,2022-08-22 03:00:00,3
8,10,18,99,22.1,3,Cloudy,7.6,2022-08-22 04:00:00,4
20,59,79,99,22.0,3,Cloudy,6.4,2022-08-22 05:00:00,5
48,148,196,99,22.2,3,Cloudy,5.2,2022-08-22 06:00:00,6
87,392,479,99,22.3,3,Cloudy,4.7,2022-08-22 07:00:00,7
182,541,723,98,22.5,53,Heavy Drizzle,4.3,2022-08-22 08:00:00,8
173,334,507,98,22.9,55,Heavy Drizzle,3.1,2022-08-22 09:00:00,9
197,228,425,92,23.6,61,Light Rain,4.0,2022-08-22 10:00:00,10
197,209,406,93,24.1,53,Heavy Drizzle,4.8,2022-08-22 11:00:00,11
296,315,611,91,25.1,51,Light Drizzle,4.7,2022-08-22 12:00:00,12
292,320,612,85,26.7,51,Light Drizzle,5.8,2022-08-22 13:00:00,13
281,281,562,81,27.7,51,Light Drizzle,5.4,2022-08-22 14:00:00,14
324,402,726,82,27.8,53,Heavy Drizzle,4.9,2022-08-22 15:00:00,15
376,488,864,78,28.1,51,Light Drizzle,6.8,2022-08-22 16:00:00,16
458,790,1248,75,26.7,63,Rain,7.4,2022-08-22 17:00:00,17
401,732,1133,86,24.8,63,Rain,5.9,2022-08-22 18:00:00,18
147,294,441,88,24.1,1,Mostly Clear,1.5,2022-08-22 19:00:00,19
168,253,421,91,23.7,1,Mostly Clear,4.6,2022-08-22 20:00:00,20
98,180,278,94,23.2,0,Clear,5.2,2022-08-22 21:00:00,21
65,120,185,96,22.6,1,Mostly Clear,6.8,2022-08-22 22:00:00,22
50,74,124,97,22.2,2,Partly Cloudy,8.6,2022-08-22 23:00:00,23
19,28,47,96,22.0,1,Mostly Clear,4.6,2022-08-23 00:00:00,0
16,18,34,94,21.9,0,Clear,6.8,2022-08-23 01:00:00,1
7,6,13,92,21.5,0,Clear,9.6,2022-08-23 02:00:00,2
3,8,11,95,21.0,0,Clear,9.7,2022-08-23 03:00:00,3
3,13,16,93,20.6,0,Clear,10.0,2022-08-23 04:00:00,4
25,62,87,93,20.0,0,Clear,11.0,2022-08-23 05:00:00,5
76,196,272,94,19.6,0,Clear,11.4,2022-08-23 06:00:00,6
154,512,666,94,19.5,0,Clear,10.6,2022-08-23 07:00:00,7
269,769,1038,92,20.5,0,Clear,9.3,2022-08-23 08:00:00,8
233,411,644,85,22.0,0,Clear,7.6,2022-08-23 09:00:00,9
206,282,488,78,23.5,0,Clear,9.5,2022-08-23 10:00:00,10
225,293,518,68,25.3,1,Mostly Clear,11.8,2022-08-23 11:00:00,11
266,362,628,62,26.4,1,Mostly Clear,11.4,2022-08-23 12:00:00,12
256,313,569,57,27.5,1,Mostly Clear,11.6,2022-08-23 13:00:00,13
300,282,582,54,28.2,1,Mostly Clear,12.2,2022-08-23 14:00:00,14
277,378,655,53,28.5,0,Clear,12.0,2022-08-23 15:00:00,15
367,567,934,51,28.8,0,Clear,12.4,2022-08-23 16:00:00,16
565,930,1495,50,29.0,0,Clear,10.8,2022-08-23 17:00:00,17
543,882,1425,55,28.4,0,Clear,9.0,2022-08-23 18:00:00,18
443,649,1092,71,27.2,0,Clear,5.4,2022-08-23 19:00:00,19
311,464,775,75,25.8,0,Clear,4.6,2022-08-23 20:00:00,20
204,286,490,78,24.1,0,Clear,5.6,2022-08-23 21:00:00,21
152,204,356,78,22.9,0,Clear,6.5,2022-08-23 22:00:00,22
174,127,301,75,22.3,0,Clear,7.6,2022-08-23 23:00:00,23
53,43,96,75,21.6,0,Clear,8.2,2022-08-24 00:00:00,0
12,13,25,79,20.8,0,Clear,8.4,2022-08-24 01:00:00,1
10,11,21,83,19.9,0,Clear,8.7,2022-08-24 02:00:00,2
5,11,16,80,20.5,0,Clear,8.6,2022-08-24 03:00:00,3
8,11,19,80,20.6,0,Clear,8.9,2022-08-24 04:00:00,4
19,73,92,81,20.4,0,Clear,8.7,2022-08-24 05:00:00,5
68,168,236,83,20.0,0,Clear,8.3,2022-08-24 06:00:00,6
136,529,665,86,19.7,0,Clear,8.4,2022-08-24 07:00:00,7
286,783,1069,82,21.5,1,Mostly Clear,7.1,2022-08-24 08:00:00,8
221,462,683,72,24.1,0,Clear,5.6,2022-08-24 09:00:00,9
240,249,489,64,26.0,1,Mostly Clear,5.4,2022-08-24 10:00:00,10
195,265,460,53,27.5,1,Mostly Clear,4.8,2022-08-24 11:00:00,11
256,317,573,48,28.7,0,Clear,5.1,2022-08-24 12:00:00,12
242,296,538,45,29.5,1,Mostly Clear,6.3,2022-08-24 13:00:00,13
243,302,545,43,30.0,1,Mostly Clear,7.1,2022-08-24 14:00:00,14
316,389,705,45,30.1,0,Clear,8.2,2022-08-24 15:00:00,15
356,555,911,43,30.5,0,Clear,8.2,2022-08-24 16:00:00,16
565,926,1491,45,30.0,1,Mostly Clear,7.9,2022-08-24 17:00:00,17
559,880,1439,54,29.1,1,Mostly Clear,7.5,2022-08-24 18:00:00,18
440,659,1099,68,28.0,0,Clear,5.2,2022-08-24 19:00:00,19
303,416,719,65,27.4,0,Clear,4.4,2022-08-24 20:00:00,20
238,292,530,76,25.8,0,Clear,3.2,2022-08-24 21:00:00,21
141,215,356,80,24.6,0,Clear,3.6,2022-08-24 22:00:00,22
90,124,214,83,24.0,0,Clear,4.3,2022-08-24 23:00:00,23
47,48,95,87,23.2,0,Clear,4.7,2022-08-25 00:00:00,0
13,23,36,90,22.7,0,Clear,4.4,2022-08-25 01:00:00,1
17,14,31,93,22.1,0,Clear,4.4,2022-08-25 02:00:00,2
6,10,16,92,21.0,0,Clear,4.6,2022-08-25 03:00:00,3
5,16,21,92,20.7,0,Clear,4.6,2022-08-25 04:00:00,4
28,56,84,91,20.7,0,Clear,4.6,2022-08-25 05:00:00,5
64,190,254,91,20.5,1,Mostly Clear,3.4,2022-08-25 06:00:00,6
149,459,608,90,20.8,1,Mostly Clear,4.3,2022-08-25 07:00:00,7
250,699,949,86,22.5,1,Mostly Clear,5.0,2022-08-25 08:00:00,8
226,460,686,72,25.2,1,Mostly Clear,1.8,2022-08-25 09:00:00,9
214,243,457,59,27.5,1,Mostly Clear,0.5,2022-08-25 10:00:00,10
235,257,492,52,29.0,1,Mostly Clear,0.8,2022-08-25 11:00:00,11
230,341,571,49,29.9,1,Mostly Clear,0.8,2022-08-25 12:00:00,12
234,333,567,47,30.0,1,Mostly Clear,3.3,2022-08-25 13:00:00,13
253,297,550,46,30.2,2,Partly Cloudy,4.0,2022-08-25 14:00:00,14
275,318,593,56,30.2,2,Partly Cloudy,5.4,2022-08-25 15:00:00,15
327,499,826,57,29.8,51,Light Drizzle,7.2,2022-08-25 16:00:00,16
531,831,1362,62,28.4,51,Light Drizzle,7.9,2022-08-25 17:00:00,17
525,791,1316,70,27.5,51,Light Drizzle,7.5,2022-08-25 18:00:00,18
394,612,1006,73,26.8,1,Mostly Clear,7.1,2022-08-25 19:00:00,19
244,411,655,77,26.0,1,Mostly Clear,7.2,2022-08-25 20:00:00,20
218,328,546,79,25.3,1,Mostly Clear,8.0,2022-08-25 21:00:00,21
166,258,424,81,24.9,1,Mostly Clear,8.9,2022-08-25 22:00:00,22
109,153,262,82,24.5,1,Mostly Clear,9.8,2022-08-25 23:00:00,23
67,67,134,82,24.0,1,Mostly Clear,10.5,2022-08-26 00:00:00,0
39,19,58,82,23.6,0,Clear,10.9,2022-08-26 01:00:00,1
21,15,36,82,23.3,0,Clear,10.2,2022-08-26 02:00:00,2
11,8,19,83,23.4,0,Clear,10.0,2022-08-26 03:00:00,3
8,14,22,84,23.1,0,Clear,10.7,2022-08-26 04:00:00,4
30,60,90,86,22.8,0,Clear,10.1,2022-08-26 05:00:00,5
68,149,217,88,22.3,0,Clear,5.0,2022-08-26 06:00:00,6
146,352,498,90,22.0,0,Clear,6.1,2022-08-26 07:00:00,7
216,549,765,87,23.1,0,Clear,5.8,2022-08-26 08:00:00,8
203,369,572,80,24.9,0,Clear,4.7,2022-08-26 09:00:00,9
237,291,528,74,26.7,0,Clear,4.1,2022-08-26 10:00:00,10
252,316,568,65,28.6,0,Clear,4.0,2022-08-26 11:00:00,11
318,361,679,54,29.9,1,Mostly Clear,6.9,2022-08-26 12:00:00,12
297,386,683,50,30.5,1,Mostly Clear,7.2,2022-08-26 13:00:00,13
346,360,706,48,30.7,1,Mostly Clear,7.5,2022-08-26 14:00:00,14
400,435,835,48,31.0,0,Clear,8.4,2022-08-26 15:00:00,15
467,542,1009,46,31.2,0,Clear,8.6,2022-08-26 16:00:00,16
505,696,1201,47,31.0,0,Clear,8.1,2022-08-26 17:00:00,17
453,658,1111,51,30.4,1,Mostly Clear,6.6,2022-08-26 18:00:00,18
396,558,954,69,28.7,51,Light Drizzle,5.9,2022-08-26 19:00:00,19
305,353,658,74,27.5,1,Mostly Clear,4.1,2022-08-26 20:00:00,20
266,305,571,71,26.6,0,Clear,6.5,2022-08-26 21:00:00,21
200,257,457,61,27.4,1,Mostly Clear,5.5,2022-08-26 22:00:00,22
194,190,384,64,26.8,1,Mostly Clear,4.9,2022-08-26 23:00:00,23
162,150,312,73,25.2,1,Mostly Clear,5.6,2022-08-27 00:00:00,0
117,113,230,82,23.3,1,Mostly Clear,8.1,2022-08-27 01:00:00,1
68,52,120,81,22.9,1,Mostly Clear,9.3,2022-08-27 02:00:00,2
43,27,70,86,23.0,1,Mostly Clear,9.2,2022-08-27 03:00:00,3
9,18,27,86,22.7,0,Clear,8.4,2022-08-27 04:00:00,4
15,10,25,86,22.4,0,Clear,8.4,2022-08-27 05:00:00,5
33,69,102,87,22.1,0,Clear,8.4,2022-08-27 06:00:00,6
82,172,254,87,21.9,0,Clear,9.5,2022-08-27 07:00:00,7
163,308,471,84,23.0,0,Clear,8.9,2022-08-27 08:00:00,8
253,398,651,77,24.7,0,Clear,9.0,2022-08-27 09:00:00,9
468,452,920,71,26.4,0,Clear,7.9,2022-08-27 10:00:00,10
532,480,1012,65,27.8,0,Clear,6.2,2022-08-27 11:00:00,11
617,529,1146,59,28.9,1,Mostly Clear,5.5,2022-08-27 12:00:00,12
599,489,1088,56,29.6,1,Mostly Clear,5.5,2022-08-27 13:00:00,13
612,478,1090,55,29.8,2,Partly Cloudy,4.7,2022-08-27 14:00:00,14
559,484,1043,56,29.9,51,Light Drizzle,4.0,2022-08-27 15:00:00,15
523,454,977,55,29.8,1,Mostly Clear,4.1,2022-08-27 16:00:00,16
572,498,1070,55,29.8,1,Mostly Clear,4.3,2022-08-27 17:00:00,17
507,502,1009,57,29.1,2,Partly Cloudy,3.6,2022-08-27 18:00:00,18
452,394,846,65,28.2,1,Mostly Clear,1.3,2022-08-27 19:00:00,19
292,300,592,78,26.8,1,Mostly Clear,2.9,2022-08-27 20:00:00,20
282,220,502,78,25.9,1,Mostly Clear,3.2,2022-08-27 21:00:00,21
203,237,440,84,24.6,1,Mostly Clear,4.7,2022-08-27 22:00:00,22
196,176,372,87,24.1,1,Mostly Clear,5.6,2022-08-27 23:00:00,23
149,139,288,86,24.1,1,Mostly Clear,4.5,2022-08-28 00:00:00,0
126,109,235,83,25.0,1,Mostly Clear,3.4,2022-08-28 01:00:00,1
90,63,153,86,24.5,1,Mostly Clear,4.2,2022-08-28 02:00:00,2
36,34,70,95,22.4,0,Clear,4.2,2022-08-28 03:00:00,3
9,11,20,97,22.1,0,Clear,4.2,2022-08-28 04:00:00,4
11,16,27,98,22.0,0,Clear,4.6,2022-08-28 05:00:00,5
25,51,76,98,21.7,0,Clear,5.8,2022-08-28 06:00:00,6
45,107,152,99,21.5,0,Clear,7.8,2022-08-28 07:00:00,7
148,225,373,96,24.0,0,Clear,7.2,2022-08-28 08:00:00,8
265,319,584,87,26.1,0,Clear,8.7,2022-08-28 09:00:00,9
465,427,892,83,27.2,51,Light Drizzle,10.1,2022-08-28 10:00:00,10
506,432,938,73,28.5,51,Light Drizzle,8.8,2022-08-28 11:00:00,11
481,465,946,65,29.6,2,Partly Cloudy,7.8,2022-08-28 12:00:00,12
549,511,1060,62,30.0,1,Mostly Clear,8.0,2022-08-28 13:00:00,13
469,442,911,64,29.9,51,Light Drizzle,7.7,2022-08-28 14:00:00,14
475,465,940,64,30.3,51,Light Drizzle,7.0,2022-08-28 15:00:00,15
448,463,911,63,30.3,1,Mostly Clear,8.1,2022-08-28 16:00:00,16
425,449,874,63,29.7,51,Light Drizzle,9.2,2022-08-28 17:00:00,17
386,442,828,64,29.2,51,Light Drizzle,4.3,2022-08-28 18:00:00,18
324,399,723,69,28.1,1,Mostly Clear,4.0,2022-08-28 19:00:00,19
229,275,504,74,27.1,1,Mostly Clear,4.7,2022-08-28 20:00:00,20
145,197,342,78,26.1,0,Clear,7.2,2022-08-28 21:00:00,21
93,139,232,82,25.3,0,Clear,8.9,2022-08-28 22:00:00,22
57,76,133,86,24.7,0,Clear,9.2,2022-08-28 23:00:00,23
29,26,55,89,24.2,0,Clear,8.0,2022-08-29 00:00:00,0
9,10,19,93,23.6,0,Clear,6.7,2022-08-29 01:00:00,1
9,6,15,95,23.1,0,Clear,5.9,2022-08-29 02:00:00,2
7,6,13,98,22.9,0,Clear,6.2,2022-08-29 03:00:00,3
8,10,18,98,22.6,0,Clear,5.9,2022-08-29 04:00:00,4
25,65,90,99,22.4,0,Clear,5.7,2022-08-29 05:00:00,5
66,185,251,99,22.2,3,Cloudy,5.2,2022-08-29 06:00:00,6
137,453,590,100,22.0,3,Cloudy,5.1,2022-08-29 07:00:00,7
203,659,862,91,24.3,2,Partly Cloudy,5.8,2022-08-29 08:00:00,8
164,421,585,83,25.6,1,Mostly Clear,4.7,2022-08-29 09:00:00,9
177,260,437,75,26.8,1,Mostly Clear,3.1,2022-08-29 10:00:00,10
187,278,465,69,28.0,1,Mostly Clear,3.4,2022-08-29 11:00:00,11
228,349,577,63,29.3,1,Mostly Clear,5.2,2022-08-29 12:00:00,12
232,305,537,59,30.2,0,Clear,7.3,2022-08-29 13:00:00,13
183,260,443,55,30.9,1,Mostly Clear,8.7,2022-08-29 14:00:00,14
246,403,649,59,30.7,51,Light Drizzle,9.8,2022-08-29 15:00:00,15
327,515,842,58,30.9,51,Light Drizzle,11.3,2022-08-29 16:00:00,16
399,834,1233,59,30.6,0,Clear,12.3,2022-08-29 17:00:00,17
430,792,1222,62,30.0,0,Clear,11.9,2022-08-29 18:00:00,18
373,592,965,67,28.9,0,Clear,9.4,2022-08-29 19:00:00,19
181,412,593,73,27.6,0,Clear,8.9,2022-08-29 20:00:00,20
137,247,384,77,26.7,0,Clear,10.1,2022-08-29 21:00:00,21
115,168,283,80,26.0,0,Clear,10.7,2022-08-29 22:00:00,22
60,82,142,83,25.4,0,Clear,11.7,2022-08-29 23:00:00,23
31,26,57,86,24.9,0,Clear,10.5,2022-08-30 00:00:00,0
11,8,19,88,24.4,0,Clear,9.4,2022-08-30 01:00:00,1
6,9,15,91,24.0,0,Clear,9.1,2022-08-30 02:00:00,2
4,7,11,95,23.8,0,Clear,8.8,2022-08-30 03:00:00,3
8,14,22,96,23.6,0,Clear,8.6,2022-08-30 04:00:00,4
35,59,94,97,23.4,0,Clear,9.0,2022-08-30 05:00:00,5
80,212,292,97,23.3,0,Clear,8.1,2022-08-30 06:00:00,6
186,531,717,97,23.0,1,Mostly Clear,8.0,2022-08-30 07:00:00,7
275,786,1061,92,24.1,1,Mostly Clear,9.7,2022-08-30 08:00:00,8
180,451,631,83,26.1,1,Mostly Clear,8.6,2022-08-30 09:00:00,9
151,299,450,73,28.0,0,Clear,10.0,2022-08-30 10:00:00,10
171,267,438,64,29.9,0,Clear,11.6,2022-08-30 11:00:00,11
194,338,532,55,31.3,0,Clear,13.6,2022-08-30 12:00:00,12
204,298,502,49,32.3,1,Mostly Clear,15.5,2022-08-30 13:00:00,13
169,305,474,46,32.8,1,Mostly Clear,17.2,2022-08-30 14:00:00,14
282,438,720,45,33.1,1,Mostly Clear,18.4,2022-08-30 15:00:00,15
180,417,597,44,32.5,2,Partly Cloudy,17.5,2022-08-30 16:00:00,16
73,228,301,52,30.2,51,Light Drizzle,15.3,2022-08-30 17:00:00,17
235,581,816,59,28.7,1,Mostly Clear,12.6,2022-08-30 18:00:00,18
231,565,796,69,27.1,51,Light Drizzle,8.7,2022-08-30 19:00:00,19
186,372,558,76,26.1,51,Light Drizzle,7.6,2022-08-30 20:00:00,20
152,273,425,81,25.4,51,Light Drizzle,7.9,2022-08-30 21:00:00,21
123,207,330,85,24.8,1,Mostly Clear,8.0,2022-08-30 22:00:00,22
46,104,150,88,24.1,0,Clear,9.0,2022-08-30 23:00:00,23
30,18,48,89,23.5,0,Clear,10.3,2022-08-31 00:00:00,0
12,15,27,88,22.9,0,Clear,12.3,2022-08-31 01:00:00,1
3,8,11,88,22.4,0,Clear,12.9,2022-08-31 02:00:00,2
4,4,8,79,22.4,0,Clear,12.8,2022-08-31 03:00:00,3
7,11,18,78,21.9,0,Clear,13.0,2022-08-31 04:00:00,4
28,85,113,78,21.4,0,Clear,12.2,2022-08-31 05:00:00,5
69,223,292,79,20.9,0,Clear,9.4,2022-08-31 06:00:00,6
166,543,709,81,20.5,0,Clear,9.4,2022-08-31 07:00:00,7
273,819,1092,79,21.4,0,Clear,9.7,2022-08-31 08:00:00,8
182,452,634,70,23.3,0,Clear,11.8,2022-08-31 09:00:00,9
190,283,473,62,24.8,0,Clear,15.0,2022-08-31 10:00:00,10
182,322,504,54,26.0,0,Clear,15.5,2022-08-31 11:00:00,11
188,399,587,50,26.6,2,Partly Cloudy,15.3,2022-08-31 12:00:00,12
221,322,543,47,26.8,3,Cloudy,14.7,2022-08-31 13:00:00,13
227,344,571,46,27.1,3,Cloudy,14.2,2022-08-31 14:00:00,14
293,405,698,46,27.1,3,Cloudy,12.8,2022-08-31 15:00:00,15
339,573,912,44,27.2,2,Partly Cloudy,12.5,2022-08-31 16:00:00,16
526,1008,1534,44,27.3,2,Partly Cloudy,11.7,2022-08-31 17:00:00,17
539,914,1453,44,27.5,0,Clear,10.5,2022-08-31 18:00:00,18
415,689,1104,59,26.1,0,Clear,5.8,2022-08-31 19:00:00,19
299,451,750,62,24.8,0,Clear,6.3,2022-08-31 20:00:00,20
241,332,573,62,23.2,0,Clear,7.8,2022-08-31 21:00:00,21
167,249,416,60,22.2,0,Clear,10.2,2022-08-31 22:00:00,22
77,118,195,59,21.6,0,Clear,10.2,2022-08-31 23:00:00,23
29,58,87,59,21.3,0,Clear,9.7,2022-09-01 00:00:00,0
16,21,37,61,21.0,0,Clear,9.5,2022-09-01 01:00:00,1
4,6,10,66,20.5,0,Clear,8.7,2022-09-01 02:00:00,2
2,6,8,75,19.4,0,Clear,7.5,2022-09-01 03:00:00,3
4,16,20,80,18.7,0,Clear,6.9,2022-09-01 04:00:00,4
27,61,88,83,18.2,0,Clear,7.6,2022-09-01 05:00:00,5
44,186,230,84,17.9,0,Clear,8.7,2022-09-01 06:00:00,6
163,466,629,84,17.9,0,Clear,9.8,2022-09-01 07:00:00,7
237,727,964,79,20.0,0,Clear,10.1,2022-09-01 08:00:00,8
189,443,632,64,23.1,0,Clear,9.8,2022-09-01 09:00:00,9
177,302,479,57,25.1,0,Clear,10.2,2022-09-01 10:00:00,10
198,345,543,51,26.8,0,Clear,8.7,2022-09-01 11:00:00,11
217,353,570,45,28.1,0,Clear,7.9,2022-09-01 12:00:00,12
242,354,596,41,29.1,0,Clear,8.7,2022-09-01 13:00:00,13
248,371,619,37,29.9,0,Clear,9.4,2022-09-01 14:00:00,14
309,399,708,36,30.4,0,Clear,9.6,2022-09-01 15:00:00,15
372,576,948,35,30.8,0,Clear,9.9,2022-09-01 16:00:00,16
518,915,1433,36,30.7,0,Clear,9.6,2022-09-01 17:00:00,17
538,803,1341,40,30.1,0,Clear,8.9,2022-09-01 18:00:00,18
394,603,997,54,28.7,0,Clear,5.5,2022-09-01 19:00:00,19
272,435,707,56,27.2,0,Clear,5.4,2022-09-01 20:00:00,20
203,339,542,45,27.5,0,Clear,5.2,2022-09-01 21:00:00,21
140,227,367,63,23.9,0,Clear,5.2,2022-09-01 22:00:00,22
89,134,223,67,22.5,0,Clear,5.4,2022-09-01 23:00:00,23
69,87,156,60,22.3,0,Clear,5.9,2022-09-02 00:00:00,0
46,35,81,58,21.7,0,Clear,6.9,2022-09-02 01:00:00,1
24,13,37,58,21.1,0,Clear,7.2,2022-09-02 02:00:00,2
9,8,17,72,20.3,0,Clear,7.4,2022-09-02 03:00:00,3
9,14,23,72,19.8,0,Clear,7.8,2022-09-02 04:00:00,4
19,38,57,69,19.6,0,Clear,8.9,2022-09-02 05:00:00,5
55,137,192,67,19.5,0,Clear,10.4,2022-09-02 06:00:00,6
103,339,442,68,19.6,0,Clear,11.5,2022-09-02 07:00:00,7
209,456,665,68,20.6,0,Clear,11.2,2022-09-02 08:00:00,8
264,363,627,61,22.5,1,Mostly Clear,12.4,2022-09-02 09:00:00,9
211,274,485,58,24.0,1,Mostly Clear,11.3,2022-09-02 10:00:00,10
267,337,604,54,25.6,1,Mostly Clear,10.2,2022-09-02 11:00:00,11
316,402,718,51,27.0,1,Mostly Clear,9.0,2022-09-02 12:00:00,12
380,408,788,48,28.2,0,Clear,8.6,2022-09-02 13:00:00,13
426,434,860,47,29.0,1,Mostly Clear,8.8,2022-09-02 14:00:00,14
439,473,912,47,29.2,3,Cloudy,8.5,2022-09-02 15:00:00,15
444,582,1026,47,29.1,3,Cloudy,9.2,2022-09-02 16:00:00,16
486,649,1135,50,28.5,3,Cloudy,10.0,2022-09-02 17:00:00,17
485,650,1135,53,28.1,2,Partly Cloudy,7.9,2022-09-02 18:00:00,18
357,517,874,57,27.0,2,Partly Cloudy,8.5,2022-09-02 19:00:00,19
293,336,629,63,25.8,2,Partly Cloudy,10.2,2022-09-02 20:00:00,20
226,238,464,68,24.9,1,Mostly Clear,12.4,2022-09-02 21:00:00,21
178,226,404,72,24.2,2,Partly Cloudy,13.0,2022-09-02 22:00:00,22
144,161,305,76,23.5,1,Mostly Clear,12.2,2022-09-02 23:00:00,23
106,102,208,80,22.9,1,Mostly Clear,11.0,2022-09-03 00:00:00,0
105,78,183,83,22.3,1,Mostly Clear,10.3,2022-09-03 01:00:00,1
51,51,102,87,21.9,1,Mostly Clear,9.6,2022-09-03 02:00:00,2
39,27,66,89,21.5,1,Mostly Clear,8.6,2022-09-03 03:00:00,3
21,11,32,90,21.3,1,Mostly Clear,7.2,2022-09-03 04:00:00,4
17,23,40,91,21.2,1,Mostly Clear,6.8,2022-09-03 05:00:00,5
35,71,106,91,21.1,3,Cloudy,4.0,2022-09-03 06:00:00,6
92,159,251,92,21.0,3,Cloudy,5.8,2022-09-03 07:00:00,7
156,215,371,86,22.3,3,Cloudy,5.4,2022-09-03 08:00:00,8
299,302,601,78,23.9,3,Cloudy,4.9,2022-09-03 09:00:00,9
487,322,809,72,25.4,1,Mostly Clear,3.6,2022-09-03 10:00:00,10
560,381,941,66,26.5,51,Light Drizzle,3.6,2022-09-03 11:00:00,11
558,436,994,60,27.6,2,Partly Cloudy,5.1,2022-09-03 12:00:00,12
586,391,977,55,28.8,1,Mostly Clear,7.0,2022-09-03 13:00:00,13
629,395,1024,52,29.6,2,Partly Cloudy,7.9,2022-09-03 14:00:00,14
533,423,956,54,29.3,3,Cloudy,8.8,2022-09-03 15:00:00,15
567,403,970,54,29.1,3,Cloudy,9.0,2022-09-03 16:00:00,16
608,412,1020,55,28.8,3,Cloudy,9.7,2022-09-03 17:00:00,17
573,428,1001,57,28.1,2,Partly Cloudy,9.4,2022-09-03 18:00:00,18
446,405,851,61,27.1,2,Partly Cloudy,8.2,2022-09-03 19:00:00,19
301,245,546,66,26.1,1,Mostly Clear,8.3,2022-09-03 20:00:00,20
310,224,534,70,25.3,0,Clear,7.7,2022-09-03 21:00:00,21
223,175,398,75,24.5,1,Mostly Clear,8.4,2022-09-03 22:00:00,22
174,128,302,78,23.8,0,Clear,8.8,2022-09-03 23:00:00,23
134,100,234,82,23.3,0,Clear,9.0,2022-09-04 00:00:00,0
107,82,189,86,22.8,1,Mostly Clear,8.2,2022-09-04 01:00:00,1
71,57,128,89,22.3,1,Mostly Clear,7.9,2022-09-04 02:00:00,2
33,29,62,89,21.9,1,Mostly Clear,8.4,2022-09-04 03:00:00,3
8,12,20,91,21.6,1,Mostly Clear,8.1,2022-09-04 04:00:00,4
10,17,27,91,21.6,1,Mostly Clear,7.8,2022-09-04 05:00:00,5
25,37,62,93,21.4,1,Mostly Clear,7.8,2022-09-04 06:00:00,6
62,89,151,95,21.0,1,Mostly Clear,6.3,2022-09-04 07:00:00,7
159,188,347,90,22.6,1,Mostly Clear,5.2,2022-09-04 08:00:00,8
325,278,603,81,24.5,1,Mostly Clear,5.5,2022-09-04 09:00:00,9
482,353,835,74,26.2,1,Mostly Clear,6.0,2022-09-04 10:00:00,10
579,397,976,67,27.9,1,Mostly Clear,4.2,2022-09-04 11:00:00,11
560,402,962,61,28.9,51,Light Drizzle,5.2,2022-09-04 12:00:00,12
663,391,1054,57,29.4,51,Light Drizzle,7.3,2022-09-04 13:00:00,13
621,335,956,55,29.8,2,Partly Cloudy,8.3,2022-09-04 14:00:00,14
640,330,970,51,30.5,1,Mostly Clear,9.4,2022-09-04 15:00:00,15
700,368,1068,51,30.2,1,Mostly Clear,10.3,2022-09-04 16:00:00,16
592,399,991,52,29.7,1,Mostly Clear,11.3,2022-09-04 17:00:00,17
527,429,956,56,29.0,2,Partly Cloudy,8.1,2022-09-04 18:00:00,18
472,356,828,60,27.9,2,Partly Cloudy,7.4,2022-09-04 19:00:00,19
336,248,584,65,26.6,2,Partly Cloudy,7.9,2022-09-04 20:00:00,20
331,230,561,68,25.9,2,Partly Cloudy,8.1,2022-09-04 21:00:00,21
254,183,437,70,25.3,2,Partly Cloudy,8.4,2022-09-04 22:00:00,22
141,139,280,71,24.7,2,Partly Cloudy,10.1,2022-09-04 23:00:00,23
72,71,143,73,24.1,3,Cloudy,10.9,2022-09-05 00:00:00,0
64,49,113,75,23.7,2,Partly Cloudy,10.5,2022-09-05 01:00:00,1
46,36,82,77,23.4,3,Cloudy,10.9,2022-09-05 02:00:00,2
23,17,40,80,22.9,2,Partly Cloudy,10.1,2022-09-05 03:00:00,3
15,13,28,80,22.8,51,Light Drizzle,9.4,2022-09-05 04:00:00,4
21,25,46,81,22.7,51,Light Drizzle,7.4,2022-09-05 05:00:00,5
39,52,91,82,22.6,3,Cloudy,6.6,2022-09-05 06:00:00,6
50,111,161,84,22.4,2,Partly Cloudy,8.4,2022-09-05 07:00:00,7
147,194,341,86,22.7,53,Heavy Drizzle,8.4,2022-09-05 08:00:00,8
271,319,590,85,23.5,53,Heavy Drizzle,6.8,2022-09-05 09:00:00,9
406,377,783,85,23.9,55,Heavy Drizzle,7.0,2022-09-05 10:00:00,10
540,401,941,81,24.8,51,Light Drizzle,7.8,2022-09-05 11:00:00,11
583,455,1038,77,25.6,51,Light Drizzle,8.4,2022-09-05 12:00:00,12
519,447,966,73,26.5,2,Partly Cloudy,8.2,2022-09-05 13:00:00,13
525,400,925,73,26.7,2,Partly Cloudy,9.1,2022-09-05 14:00:00,14
440,439,879,62,29.1,3,Cloudy,11.2,2022-09-05 15:00:00,15
442,429,871,59,28.5,3,Cloudy,10.8,2022-09-05 16:00:00,16
292,350,642,65,27.2,51,Light Drizzle,8.9,2022-09-05 17:00:00,17
139,235,374,69,26.5,51,Light Drizzle,4.9,2022-09-05 18:00:00,18
142,202,344,72,26.0,51,Light Drizzle,7.4,2022-09-05 19:00:00,19
117,179,296,75,25.4,51,Light Drizzle,8.1,2022-09-05 20:00:00,20
91,147,238,78,24.8,51,Light Drizzle,7.6,2022-09-05 21:00:00,21
72,110,182,84,23.9,55,Heavy Drizzle,7.6,2022-09-05 22:00:00,22
38,62,100,91,23.0,53,Heavy Drizzle,7.9,2022-09-05 23:00:00,23
14,17,31,94,22.7,53,Heavy Drizzle,7.8,2022-09-06 00:00:00,0
8,6,14,95,22.6,51,Light Drizzle,7.2,2022-09-06 01:00:00,1
1,2,3,96,22.5,51,Light Drizzle,5.5,2022-09-06 02:00:00,2
1,6,7,97,22.9,63,Rain,5.5,2022-09-06 03:00:00,3
5,6,11,97,22.8,63,Rain,4.3,2022-09-06 04:00:00,4
11,29,40,98,22.7,63,Rain,5.3,2022-09-06 05:00:00,5
21,62,83,98,22.5,63,Rain,4.7,2022-09-06 06:00:00,6
40,204,244,98,22.4,65,Heavy Rain,2.5,2022-09-06 07:00:00,7
46,235,281,99,22.4,65,Heavy Rain,4.3,2022-09-06 08:00:00,8
71,196,267,99,22.6,63,Rain,11.0,2022-09-06 09:00:00,9
130,250,380,99,22.7,61,Light Rain,13.9,2022-09-06 10:00:00,10
167,286,453,92,23.4,53,Heavy Drizzle,17.4,2022-09-06 11:00:00,11
187,296,483,87,24.6,51,Light Drizzle,16.0,2022-09-06 12:00:00,12
200,339,539,84,25.3,51,Light Drizzle,16.2,2022-09-06 13:00:00,13
220,303,523,78,26.4,51,Light Drizzle,14.9,2022-09-06 14:00:00,14
247,434,681,64,27.7,2,Partly Cloudy,13.8,2022-09-06 15:00:00,15
312,645,957,61,28.3,51,Light Drizzle,11.9,2022-09-06 16:00:00,16
540,961,1501,61,28.0,2,Partly Cloudy,11.0,2022-09-06 17:00:00,17
389,734,1123,67,27.0,3,Cloudy,7.1,2022-09-06 18:00:00,18
321,573,894,75,25.4,2,Partly Cloudy,10.5,2022-09-06 19:00:00,19
219,429,648,81,24.2,1,Mostly Clear,9.8,2022-09-06 20:00:00,20
170,304,474,85,23.4,1,Mostly Clear,8.4,2022-09-06 21:00:00,21
128,166,294,87,22.9,1,Mostly Clear,7.6,2022-09-06 22:00:00,22
64,96,160,88,22.5,1,Mostly Clear,7.1,2022-09-06 23:00:00,23
31,41,72,89,22.0,1,Mostly Clear,6.9,2022-09-07 00:00:00,0
16,15,31,90,21.7,2,Partly Cloudy,7.4,2022-09-07 01:00:00,1
7,15,22,89,21.4,2,Partly Cloudy,8.4,2022-09-07 02:00:00,2
5,12,17,91,21.7,51,Light Drizzle,7.8,2022-09-07 03:00:00,3
11,10,21,91,21.5,53,Heavy Drizzle,7.7,2022-09-07 04:00:00,4
20,63,83,92,21.3,51,Light Drizzle,7.1,2022-09-07 05:00:00,5
69,199,268,92,21.1,51,Light Drizzle,4.6,2022-09-07 06:00:00,6
149,503,652,94,20.9,51,Light Drizzle,6.5,2022-09-07 07:00:00,7
272,827,1099,94,21.0,53,Heavy Drizzle,6.4,2022-09-07 08:00:00,8
183,468,651,94,21.1,51,Light Drizzle,7.9,2022-09-07 09:00:00,9
182,271,453,92,21.4,51,Light Drizzle,7.1,2022-09-07 10:00:00,10
146,267,413,88,22.1,51,Light Drizzle,6.6,2022-09-07 11:00:00,11
155,317,472,82,23.1,51,Light Drizzle,7.6,2022-09-07 12:00:00,12
171,289,460,79,24.0,51,Light Drizzle,8.9,2022-09-07 13:00:00,13
206,331,537,78,24.1,51,Light Drizzle,10.6,2022-09-07 14:00:00,14
255,414,669,94,21.5,61,Light Rain,9.9,2022-09-07 15:00:00,15
318,534,852,94,21.5,55,Heavy Drizzle,8.9,2022-09-07 16:00:00,16
403,906,1309,95,21.2,55,Heavy Drizzle,10.7,2022-09-07 17:00:00,17
223,499,722,91,21.3,53,Heavy Drizzle,10.5,2022-09-07 18:00:00,18
206,488,694,94,20.8,53,Heavy Drizzle,9.2,2022-09-07 19:00:00,19
175,316,491,95,20.6,51,Light Drizzle,8.9,2022-09-07 20:00:00,20
147,257,404,96,20.3,51,Light Drizzle,9.4,2022-09-07 21:00:00,21
92,171,263,95,20.3,51,Light Drizzle,8.4,2022-09-07 22:00:00,22
70,103,173,95,20.2,51,Light Drizzle,9.0,2022-09-07 23:00:00,23
46,39,85,96,20.1,51,Light Drizzle,9.2,2022-09-08 00:00:00,0
12,11,23,96,19.9,3,Cloudy,9.2,2022-09-08 01:00:00,1
7,11,18,96,19.8,3,Cloudy,8.3,2022-09-08 02:00:00,2
6,11,17,96,20.0,3,Cloudy,7.6,2022-09-08 03:00:00,3
8,20,28,96,19.9,3,Cloudy,7.9,2022-09-08 04:00:00,4
21,49,70,97,19.5,3,Cloudy,8.6,2022-09-08 05:00:00,5
67,179,246,97,19.3,3,Cloudy,5.9,2022-09-08 06:00:00,6
146,506,652,96,19.4,3,Cloudy,7.4,2022-09-08 07:00:00,7
267,868,1135,94,19.8,3,Cloudy,7.6,2022-09-08 08:00:00,8
223,489,712,89,20.5,3,Cloudy,7.5,2022-09-08 09:00:00,9
200,296,496,82,21.5,1,Mostly Clear,7.6,2022-09-08 10:00:00,10
182,323,505,74,22.8,51,Light Drizzle,10.6,2022-09-08 11:00:00,11
236,360,596,70,23.7,51,Light Drizzle,10.9,2022-09-08 12:00:00,12
241,350,591,65,24.7,51,Light Drizzle,10.3,2022-09-08 13:00:00,13
245,343,588,63,25.0,51,Light Drizzle,9.5,2022-09-08 14:00:00,14
347,417,764,59,25.5,3,Cloudy,9.3,2022-09-08 15:00:00,15
374,590,964,58,25.4,3,Cloudy,8.9,2022-09-08 16:00:00,16
573,990,1563,59,25.3,3,Cloudy,8.4,2022-09-08 17:00:00,17
545,898,1443,61,24.9,2,Partly Cloudy,7.7,2022-09-08 18:00:00,18
392,637,1029,66,24.0,2,Partly Cloudy,5.5,2022-09-08 19:00:00,19
254,447,701,78,22.7,3,Cloudy,3.6,2022-09-08 20:00:00,20
199,355,554,73,22.8,1,Mostly Clear,3.1,2022-09-08 21:00:00,21
222,249,471,76,22.2,1,Mostly Clear,3.8,2022-09-08 22:00:00,22
182,223,405,87,20.3,0,Clear,4.0,2022-09-08 23:00:00,23
76,88,164,90,19.5,0,Clear,5.0,2022-09-09 00:00:00,0
29,32,61,92,18.9,0,Clear,6.3,2022-09-09 01:00:00,1
13,16,29,92,18.3,0,Clear,6.6,2022-09-09 02:00:00,2
5,15,20,93,18.1,0,Clear,5.8,2022-09-09 03:00:00,3
8,15,23,94,17.8,0,Clear,5.2,2022-09-09 04:00:00,4
27,42,69,95,17.5,0,Clear,4.8,2022-09-09 05:00:00,5
69,176,245,96,17.2,2,Partly Cloudy,4.0,2022-09-09 06:00:00,6
110,410,520,97,16.9,2,Partly Cloudy,5.1,2022-09-09 07:00:00,7
235,600,835,96,18.5,0,Clear,5.2,2022-09-09 08:00:00,8
214,430,644,84,21.8,0,Clear,4.1,2022-09-09 09:00:00,9
228,322,550,74,23.4,0,Clear,4.9,2022-09-09 10:00:00,10
252,361,613,65,24.7,0,Clear,7.7,2022-09-09 11:00:00,11
304,384,688,59,25.6,1,Mostly Clear,9.2,2022-09-09 12:00:00,12
302,428,730,55,26.0,0,Clear,10.4,2022-09-09 13:00:00,13
375,402,777,51,26.4,0,Clear,10.9,2022-09-09 14:00:00,14
380,537,917,46,26.7,0,Clear,10.4,2022-09-09 15:00:00,15
494,627,1121,45,26.5,0,Clear,10.1,2022-09-09 16:00:00,16
590,816,1406,46,26.1,0,Clear,9.8,2022-09-09 17:00:00,17
576,843,1419,52,25.2,0,Clear,7.1,2022-09-09 18:00:00,18
484,625,1109,59,23.9,0,Clear,6.5,2022-09-09 19:00:00,19
332,373,705,66,22.3,0,Clear,7.6,2022-09-09 20:00:00,20
234,291,525,72,21.1,0,Clear,8.0,2022-09-09 21:00:00,21
209,259,468,77,20.2,0,Clear,9.0,2022-09-09 22:00:00,22
222,214,436,83,19.5,0,Clear,9.5,2022-09-09 23:00:00,23
128,170,298,88,18.8,1,Mostly Clear,8.8,2022-09-10 00:00:00,0
102,126,228,92,18.2,0,Clear,7.0,2022-09-10 01:00:00,1
78,62,140,94,17.6,0,Clear,6.5,2022-09-10 02:00:00,2
24,37,61,95,17.5,1,Mostly Clear,6.6,2022-09-10 03:00:00,3
14,9,23,97,17.0,1,Mostly Clear,5.8,2022-09-10 04:00:00,4
13,24,37,97,16.6,1,Mostly Clear,5.1,2022-09-10 05:00:00,5
59,70,129,97,16.8,3,Cloudy,3.9,2022-09-10 06:00:00,6
100,154,254,98,16.6,3,Cloudy,5.5,2022-09-10 07:00:00,7
178,280,458,96,18.4,3,Cloudy,5.6,2022-09-10 08:00:00,8
369,369,738,83,21.4,2,Partly Cloudy,4.3,2022-09-10 09:00:00,9
506,524,1030,74,22.4,2,Partly Cloudy,5.9,2022-09-10 10:00:00,10
625,608,1233,66,23.3,2,Partly Cloudy,6.1,2022-09-10 11:00:00,11
660,581,1241,62,24.0,3,Cloudy,6.9,2022-09-10 12:00:00,12
743,496,1239,60,24.3,3,Cloudy,7.4,2022-09-10 13:00:00,13
705,461,1166,59,24.5,3,Cloudy,6.6,2022-09-10 14:00:00,14
730,580,1310,60,25.7,3,Cloudy,6.4,2022-09-10 15:00:00,15
646,595,1241,60,25.9,3,Cloudy,7.9,2022-09-10 16:00:00,16
540,497,1037,64,25.5,3,Cloudy,9.1,2022-09-10 17:00:00,17
526,520,1046,69,24.8,3,Cloudy,7.1,2022-09-10 18:00:00,18
434,458,892,74,23.9,3,Cloudy,4.4,2022-09-10 19:00:00,19
274,293,567,78,23.3,2,Partly Cloudy,4.7,2022-09-10 20:00:00,20
222,237,459,80,22.8,3,Cloudy,4.8,2022-09-10 21:00:00,21
214,240,454,81,22.5,3,Cloudy,4.6,2022-09-10 22:00:00,22
169,201,370,82,22.4,2,Partly Cloudy,5.4,2022-09-10 23:00:00,23
146,144,290,82,22.2,51,Light Drizzle,5.6,2022-09-11 00:00:00,0
116,101,217,83,21.8,51,Light Drizzle,5.4,2022-09-11 01:00:00,1
87,61,148,86,21.2,55,Heavy Drizzle,5.1,2022-09-11 02:00:00,2
37,41,78,95,21.1,61,Light Rain,5.4,2022-09-11 03:00:00,3
15,14,29,96,21.1,61,Light Rain,5.4,2022-09-11 04:00:00,4
6,17,23,96,21.1,61,Light Rain,7.9,2022-09-11 05:00:00,5
15,11,26,96,21.1,61,Light Rain,10.1,2022-09-11 06:00:00,6
9,17,26,96,21.1,55,Heavy Drizzle,11.2,2022-09-11 07:00:00,7
23,62,85,96,21.2,61,Light Rain,12.0,2022-09-11 08:00:00,8
34,72,106,97,21.4,61,Light Rain,11.8,2022-09-11 09:00:00,9
101,183,284,98,21.7,61,Light Rain,11.0,2022-09-11 10:00:00,10
143,237,380,99,22.2,53,Heavy Drizzle,10.1,2022-09-11 11:00:00,11
259,351,610,99,22.5,53,Heavy Drizzle,9.5,2022-09-11 12:00:00,12
252,354,606,96,22.9,51,Light Drizzle,8.9,2022-09-11 13:00:00,13
326,389,715,94,23.4,51,Light Drizzle,5.1,2022-09-11 14:00:00,14
385,482,867,93,25.3,51,Light Drizzle,4.8,2022-09-11 15:00:00,15
394,498,892,93,25.4,51,Light Drizzle,4.8,2022-09-11 16:00:00,16
377,511,888,94,24.6,61,Light Rain,2.9,2022-09-11 17:00:00,17
314,485,799,94,24.6,51,Light Drizzle,0.8,2022-09-11 18:00:00,18
230,362,592,95,24.1,51,Light Drizzle,2.7,2022-09-11 19:00:00,19
148,256,404,98,23.6,3,Cloudy,4.5,2022-09-11 20:00:00,20
136,166,302,99,23.0,3,Cloudy,5.4,2022-09-11 21:00:00,21
94,153,247,100,22.3,1,Mostly Clear,5.4,2022-09-11 22:00:00,22
50,89,139,100,21.8,3,Cloudy,4.3,2022-09-11 23:00:00,23
37,44,81,99,21.5,3,Cloudy,4.9,2022-09-12 00:00:00,0
15,16,31,100,21.4,3,Cloudy,4.3,2022-09-12 01:00:00,1
8,13,21,99,21.2,51,Light Drizzle,4.3,2022-09-12 02:00:00,2
4,11,15,100,21.6,3,Cloudy,5.4,2022-09-12 03:00:00,3
10,22,32,100,22.0,3,Cloudy,6.6,2022-09-12 04:00:00,4
20,67,87,100,22.0,3,Cloudy,6.1,2022-09-12 05:00:00,5
66,178,244,100,22.0,3,Cloudy,3.3,2022-09-12 06:00:00,6
116,470,586,99,22.1,3,Cloudy,3.3,2022-09-12 07:00:00,7
258,720,978,99,22.4,3,Cloudy,5.3,2022-09-12 08:00:00,8
189,435,624,94,22.6,3,Cloudy,5.9,2022-09-12 09:00:00,9
206,235,441,89,24.1,2,Partly Cloudy,3.1,2022-09-12 10:00:00,10
236,298,534,84,25.2,3,Cloudy,1.5,2022-09-12 11:00:00,11
255,348,603,80,26.2,3,Cloudy,1.8,2022-09-12 12:00:00,12
197,374,571,80,26.6,3,Cloudy,2.6,2022-09-12 13:00:00,13
252,315,567,78,27.4,51,Light Drizzle,5.5,2022-09-12 14:00:00,14
275,439,714,77,27.3,55,Heavy Drizzle,6.6,2022-09-12 15:00:00,15
256,469,725,85,25.7,63,Rain,5.9,2022-09-12 16:00:00,16
232,509,741,86,25.8,61,Light Rain,6.0,2022-09-12 17:00:00,17
113,273,386,91,24.8,63,Rain,4.5,2022-09-12 18:00:00,18
142,425,567,95,23.3,63,Rain,2.3,2022-09-12 19:00:00,19
137,317,454,97,22.3,63,Rain,3.4,2022-09-12 20:00:00,20
88,220,308,97,22.3,51,Light Drizzle,0.7,2022-09-12 21:00:00,21
67,168,235,98,22.1,3,Cloudy,1.8,2022-09-12 22:00:00,22
92,122,214,99,21.6,3,Cloudy,1.8,2022-09-12 23:00:00,23
26,23,49,99,21.6,3,Cloudy,1.1,2022-09-13 00:00:00,0
8,15,23,99,21.5,3,Cloudy,10.5,2022-09-13 01:00:00,1
4,6,10,98,21.2,3,Cloudy,16.1,2022-09-13 02:00:00,2
7,8,15,96,20.8,2,Partly Cloudy,13.9,2022-09-13 03:00:00,3
8,12,20,93,20.3,51,Light Drizzle,11.5,2022-09-13 04:00:00,4
21,63,84,93,20.0,0,Clear,9.2,2022-09-13 05:00:00,5
67,218,285,93,19.7,1,Mostly Clear,8.9,2022-09-13 06:00:00,6
163,587,750,92,19.4,1,Mostly Clear,9.2,2022-09-13 07:00:00,7
316,870,1186,90,19.6,1,Mostly Clear,10.6,2022-09-13 08:00:00,8
222,493,715,84,20.0,1,Mostly Clear,10.7,2022-09-13 09:00:00,9
191,301,492,77,20.6,1,Mostly Clear,11.5,2022-09-13 10:00:00,10
179,313,492,68,21.5,0,Clear,12.6,2022-09-13 11:00:00,11
209,376,585,59,22.7,0,Clear,12.1,2022-09-13 12:00:00,12
232,367,599,49,24.5,1,Mostly Clear,10.7,2022-09-13 13:00:00,13
255,367,622,44,25.5,2,Partly Cloudy,12.4,2022-09-13 14:00:00,14
318,454,772,48,25.9,2,Partly Cloudy,14.6,2022-09-13 15:00:00,15
336,637,973,47,26.0,0,Clear,13.4,2022-09-13 16:00:00,16
592,1124,1716,47,26.0,0,Clear,12.1,2022-09-13 17:00:00,17
590,1018,1608,53,25.3,0,Clear,8.2,2022-09-13 18:00:00,18
403,775,1178,61,23.9,0,Clear,6.3,2022-09-13 19:00:00,19
260,440,700,64,22.3,0,Clear,6.8,2022-09-13 20:00:00,20
229,380,609,58,21.8,1,Mostly Clear,9.7,2022-09-13 21:00:00,21
165,274,439,56,20.9,1,Mostly Clear,14.0,2022-09-13 22:00:00,22
69,116,185,58,20.2,0,Clear,14.0,2022-09-13 23:00:00,23
34,49,83,61,19.5,0,Clear,13.2,2022-09-14 00:00:00,0
19,10,29,65,18.7,0,Clear,12.0,2022-09-14 01:00:00,1
7,7,14,69,17.9,0,Clear,10.9,2022-09-14 02:00:00,2
2,7,9,72,17.1,0,Clear,9.7,2022-09-14 03:00:00,3
10,12,22,76,16.4,0,Clear,8.5,2022-09-14 04:00:00,4
29,77,106,79,15.7,0,Clear,8.4,2022-09-14 05:00:00,5
80,228,308,81,15.3,0,Clear,9.4,2022-09-14 06:00:00,6
195,559,754,83,14.9,0,Clear,9.2,2022-09-14 07:00:00,7
344,975,1319,82,16.1,0,Clear,9.3,2022-09-14 08:00:00,8
220,522,742,71,18.5,0,Clear,9.6,2022-09-14 09:00:00,9
185,316,501,66,20.2,0,Clear,10.0,2022-09-14 10:00:00,10
210,346,556,61,21.9,0,Clear,9.7,2022-09-14 11:00:00,11
239,391,630,56,23.3,0,Clear,9.9,2022-09-14 12:00:00,12
210,384,594,50,24.5,0,Clear,10.4,2022-09-14 13:00:00,13
255,340,595,46,25.2,2,Partly Cloudy,12.7,2022-09-14 14:00:00,14
312,490,802,46,25.7,2,Partly Cloudy,13.5,2022-09-14 15:00:00,15
348,672,1020,45,25.8,2,Partly Cloudy,13.3,2022-09-14 16:00:00,16
613,1094,1707,48,25.6,1,Mostly Clear,11.6,2022-09-14 17:00:00,17
616,988,1604,52,25.2,1,Mostly Clear,9.7,2022-09-14 18:00:00,18
466,752,1218,57,23.8,0,Clear,7.4,2022-09-14 19:00:00,19
233,462,695,64,22.1,0,Clear,6.7,2022-09-14 20:00:00,20
200,380,580,69,20.9,0,Clear,6.4,2022-09-14 21:00:00,21
177,289,466,73,20.0,0,Clear,7.1,2022-09-14 22:00:00,22
121,140,261,76,19.5,0,Clear,8.4,2022-09-14 23:00:00,23
35,59,94,78,19.2,0,Clear,10.4,2022-09-15 00:00:00,0
13,12,25,79,18.9,0,Clear,12.0,2022-09-15 01:00:00,1
9,4,13,80,18.7,0,Clear,12.2,2022-09-15 02:00:00,2
3,10,13,85,18.3,0,Clear,12.2,2022-09-15 03:00:00,3
6,14,20,85,18.2,0,Clear,12.5,2022-09-15 04:00:00,4
28,53,81,86,18.1,0,Clear,12.2,2022-09-15 05:00:00,5
84,211,295,87,17.9,0,Clear,9.7,2022-09-15 06:00:00,6
158,528,686,89,17.6,0,Clear,10.1,2022-09-15 07:00:00,7
282,866,1148,88,18.3,0,Clear,10.8,2022-09-15 08:00:00,8
208,537,745,81,20.4,0,Clear,9.5,2022-09-15 09:00:00,9
217,313,530,74,21.9,0,Clear,11.1,2022-09-15 10:00:00,10
211,281,492,66,23.3,0,Clear,12.7,2022-09-15 11:00:00,11
213,412,625,63,23.9,0,Clear,10.9,2022-09-15 12:00:00,12
225,355,580,59,24.8,1,Mostly Clear,11.0,2022-09-15 13:00:00,13
253,311,564,56,25.3,1,Mostly Clear,10.9,2022-09-15 14:00:00,14
324,444,768,53,25.9,1,Mostly Clear,9.4,2022-09-15 15:00:00,15
348,642,990,51,25.9,0,Clear,8.7,2022-09-15 16:00:00,16
603,1046,1649,50,25.5,0,Clear,9.0,2022-09-15 17:00:00,17
596,947,1543,52,24.7,0,Clear,7.8,2022-09-15 18:00:00,18
375,692,1067,58,23.1,0,Clear,7.6,2022-09-15 19:00:00,19
317,503,820,63,21.4,0,Clear,7.6,2022-09-15 20:00:00,20
191,385,576,67,19.9,0,Clear,7.5,2022-09-15 21:00:00,21
188,272,460,71,18.7,0,Clear,7.3,2022-09-15 22:00:00,22
113,186,299,73,17.7,0,Clear,6.6,2022-09-15 23:00:00,23
56,65,121,75,16.7,0,Clear,6.3,2022-09-16 00:00:00,0
32,39,71,78,15.8,0,Clear,5.8,2022-09-16 01:00:00,1
21,25,46,80,15.1,0,Clear,5.6,2022-09-16 02:00:00,2
8,12,20,86,14.5,0,Clear,5.4,2022-09-16 03:00:00,3
7,13,20,87,14.0,0,Clear,5.4,2022-09-16 04:00:00,4
19,60,79,87,13.6,0,Clear,5.5,2022-09-16 05:00:00,5
77,180,257,88,13.2,0,Clear,4.5,2022-09-16 06:00:00,6
168,425,593,88,13.0,0,Clear,4.7,2022-09-16 07:00:00,7
253,626,879,87,14.5,0,Clear,5.0,2022-09-16 08:00:00,8
226,415,641,70,18.2,0,Clear,2.9,2022-09-16 09:00:00,9
227,328,555,59,20.5,0,Clear,0.8,2022-09-16 10:00:00,10
252,357,609,51,22.2,0,Clear,1.8,2022-09-16 11:00:00,11
319,419,738,49,23.5,0,Clear,3.3,2022-09-16 12:00:00,12
313,459,772,48,24.5,0,Clear,3.7,2022-09-16 13:00:00,13
372,379,751,47,25.3,0,Clear,3.6,2022-09-16 14:00:00,14
386,533,919,47,25.9,0,Clear,2.4,2022-09-16 15:00:00,15
454,704,1158,46,26.1,0,Clear,2.2,2022-09-16 16:00:00,16
644,850,1494,46,26.0,0,Clear,2.2,2022-09-16 17:00:00,17
621,805,1426,52,25.2,0,Clear,3.6,2022-09-16 18:00:00,18
486,592,1078,60,23.9,0,Clear,4.1,2022-09-16 19:00:00,19
253,396,649,68,22.1,0,Clear,4.5,2022-09-16 20:00:00,20
204,296,500,75,20.7,0,Clear,4.7,2022-09-16 21:00:00,21
254,298,552,81,19.7,0,Clear,4.3,2022-09-16 22:00:00,22
205,236,441,87,18.7,0,Clear,3.3,2022-09-16 23:00:00,23
177,192,369,89,18.2,0,Clear,3.0,2022-09-17 00:00:00,0
110,107,217,87,18.8,0,Clear,4.0,2022-09-17 01:00:00,1
105,69,174,87,19.1,0,Clear,3.7,2022-09-17 02:00:00,2
36,22,58,95,18.2,0,Clear,2.2,2022-09-17 03:00:00,3
12,13,25,98,17.7,0,Clear,1.5,2022-09-17 04:00:00,4
21,28,49,98,17.6,0,Clear,1.5,2022-09-17 05:00:00,5
44,60,104,98,17.4,3,Cloudy,3.6,2022-09-17 06:00:00,6
70,130,200,98,17.1,3,Cloudy,3.3,2022-09-17 07:00:00,7
176,260,436,96,17.6,3,Cloudy,1.8,2022-09-17 08:00:00,8
342,392,734,87,20.0,2,Partly Cloudy,0.8,2022-09-17 09:00:00,9
536,516,1052,71,22.7,0,Clear,0.8,2022-09-17 10:00:00,10
595,551,1146,60,24.3,0,Clear,3.3,2022-09-17 11:00:00,11
606,600,1206,55,25.3,0,Clear,5.7,2022-09-17 12:00:00,12
696,588,1284,53,26.0,0,Clear,7.0,2022-09-17 13:00:00,13
716,553,1269,51,26.4,0,Clear,8.1,2022-09-17 14:00:00,14
698,634,1332,50,26.6,0,Clear,8.9,2022-09-17 15:00:00,15
633,537,1170,50,26.6,0,Clear,9.2,2022-09-17 16:00:00,16
657,498,1155,51,26.1,0,Clear,9.8,2022-09-17 17:00:00,17
607,585,1192,57,25.0,0,Clear,8.3,2022-09-17 18:00:00,18
502,505,1007,63,23.3,0,Clear,8.1,2022-09-17 19:00:00,19
352,331,683,69,21.8,0,Clear,8.7,2022-09-17 20:00:00,20
247,275,522,73,20.8,0,Clear,9.3,2022-09-17 21:00:00,21
261,220,481,76,19.9,0,Clear,9.9,2022-09-17 22:00:00,22
196,172,368,79,19.2,0,Clear,10.4,2022-09-17 23:00:00,23
149,148,297,83,18.6,0,Clear,10.2,2022-09-18 00:00:00,0
126,116,242,88,18.0,0,Clear,9.7,2022-09-18 01:00:00,1
84,51,135,91,17.6,0,Clear,9.8,2022-09-18 02:00:00,2
43,40,83,93,17.3,0,Clear,9.4,2022-09-18 03:00:00,3
20,13,33,94,17.1,0,Clear,8.7,2022-09-18 04:00:00,4
15,19,34,96,16.8,0,Clear,8.6,2022-09-18 05:00:00,5
100,104,204,96,16.5,0,Clear,6.8,2022-09-18 06:00:00,6
62,109,171,97,16.2,1,Mostly Clear,5.6,2022-09-18 07:00:00,7
164,216,380,94,17.1,2,Partly Cloudy,7.2,2022-09-18 08:00:00,8
357,401,758,81,19.9,0,Clear,7.2,2022-09-18 09:00:00,9
456,517,973,70,22.1,0,Clear,7.1,2022-09-18 10:00:00,10
592,548,1140,61,24.2,0,Clear,7.4,2022-09-18 11:00:00,11
591,563,1154,55,25.9,0,Clear,8.7,2022-09-18 12:00:00,12
609,494,1103,51,27.1,0,Clear,7.9,2022-09-18 13:00:00,13
598,557,1155,49,28.0,0,Clear,7.1,2022-09-18 14:00:00,14
530,479,1009,48,28.2,0,Clear,7.2,2022-09-18 15:00:00,15
587,540,1127,47,28.1,1,Mostly Clear,8.1,2022-09-18 16:00:00,16
497,526,1023,49,27.8,1,Mostly Clear,7.4,2022-09-18 17:00:00,17
476,468,944,56,26.8,2,Partly Cloudy,6.4,2022-09-18 18:00:00,18
373,448,821,61,25.1,0,Clear,6.9,2022-09-18 19:00:00,19
183,275,458,65,23.5,0,Clear,8.6,2022-09-18 20:00:00,20
157,221,378,69,22.4,0,Clear,7.9,2022-09-18 21:00:00,21
107,165,272,72,21.7,0,Clear,8.2,2022-09-18 22:00:00,22
70,98,168,77,21.0,1,Mostly Clear,8.6,2022-09-18 23:00:00,23
23,34,57,82,20.7,0,Clear,9.2,2022-09-19 00:00:00,0
17,16,33,85,20.2,0,Clear,8.9,2022-09-19 01:00:00,1
6,7,13,86,20.1,0,Clear,8.1,2022-09-19 02:00:00,2
11,7,18,85,19.2,0,Clear,6.4,2022-09-19 03:00:00,3
8,16,24,88,18.6,0,Clear,6.4,2022-09-19 04:00:00,4
19,65,84,90,18.2,0,Clear,5.5,2022-09-19 05:00:00,5
71,206,277,92,17.9,0,Clear,5.5,2022-09-19 06:00:00,6
129,482,611,93,17.6,0,Clear,5.6,2022-09-19 07:00:00,7
245,691,936,93,18.8,0,Clear,4.8,2022-09-19 08:00:00,8
195,409,604,78,22.3,0,Clear,4.0,2022-09-19 09:00:00,9
185,265,450,70,24.7,0,Clear,3.9,2022-09-19 10:00:00,10
198,289,487,61,26.7,0,Clear,6.3,2022-09-19 11:00:00,11
231,366,597,54,28.1,0,Clear,8.7,2022-09-19 12:00:00,12
220,335,555,49,28.8,1,Mostly Clear,13.3,2022-09-19 13:00:00,13
257,328,585,45,29.4,2,Partly Cloudy,15.3,2022-09-19 14:00:00,14
272,438,710,48,28.4,2,Partly Cloudy,12.5,2022-09-19 15:00:00,15
344,629,973,51,28.1,1,Mostly Clear,7.6,2022-09-19 16:00:00,16
486,938,1424,56,27.5,0,Clear,6.2,2022-09-19 17:00:00,17
457,889,1346,60,27.1,2,Partly Cloudy,8.6,2022-09-19 18:00:00,18
341,617,958,64,25.9,2,Partly Cloudy,7.2,2022-09-19 19:00:00,19
231,402,633,69,24.5,1,Mostly Clear,6.9,2022-09-19 20:00:00,20
170,298,468,73,23.6,1,Mostly Clear,7.7,2022-09-19 21:00:00,21
109,164,273,75,23.0,0,Clear,8.3,2022-09-19 22:00:00,22
57,106,163,77,22.5,0,Clear,9.6,2022-09-19 23:00:00,23
25,27,52,78,22.4,0,Clear,10.4,2022-09-20 00:00:00,0
11,14,25,80,22.2,0,Clear,10.6,2022-09-20 01:00:00,1
4,6,10,81,22.0,0,Clear,11.0,2022-09-20 02:00:00,2
4,3,7,87,20.9,0,Clear,11.5,2022-09-20 03:00:00,3
8,16,24,89,20.5,0,Clear,12.5,2022-09-20 04:00:00,4
24,77,101,90,20.3,0,Clear,11.5,2022-09-20 05:00:00,5
80,230,310,92,19.8,0,Clear,9.2,2022-09-20 06:00:00,6
186,568,754,93,19.2,0,Clear,7.9,2022-09-20 07:00:00,7
337,913,1250,92,19.6,0,Clear,7.8,2022-09-20 08:00:00,8
228,456,684,78,21.7,0,Clear,6.4,2022-09-20 09:00:00,9
172,299,471,65,23.3,0,Clear,8.7,2022-09-20 10:00:00,10
215,310,525,56,24.6,0,Clear,10.5,2022-09-20 11:00:00,11
273,378,651,51,25.7,0,Clear,13.5,2022-09-20 12:00:00,12
220,347,567,47,26.7,0,Clear,13.5,2022-09-20 13:00:00,13
273,376,649,45,27.4,0,Clear,13.3,2022-09-20 14:00:00,14
309,443,752,43,28.3,0,Clear,13.3,2022-09-20 15:00:00,15
428,608,1036,42,28.4,0,Clear,13.2,2022-09-20 16:00:00,16
632,1061,1693,43,28.0,0,Clear,13.0,2022-09-20 17:00:00,17
626,1009,1635,48,27.0,0,Clear,10.0,2022-09-20 18:00:00,18
456,724,1180,52,25.3,0,Clear,7.3,2022-09-20 19:00:00,19
276,468,744,57,23.7,0,Clear,6.4,2022-09-20 20:00:00,20
197,306,503,63,22.3,0,Clear,8.5,2022-09-20 21:00:00,21
149,237,386,70,20.9,0,Clear,6.4,2022-09-20 22:00:00,22
78,112,190,76,19.8,0,Clear,6.9,2022-09-20 23:00:00,23
35,34,69,78,19.2,0,Clear,7.9,2022-09-21 00:00:00,0
6,21,27,83,18.4,0,Clear,8.2,2022-09-21 01:00:00,1
7,6,13,85,17.9,0,Clear,8.9,2022-09-21 02:00:00,2
5,6,11,79,17.6,0,Clear,9.2,2022-09-21 03:00:00,3
5,10,15,79,17.4,0,Clear,9.7,2022-09-21 04:00:00,4
32,54,86,81,17.0,0,Clear,8.3,2022-09-21 05:00:00,5
74,237,311,85,16.5,1,Mostly Clear,5.1,2022-09-21 06:00:00,6
193,547,740,86,16.3,0,Clear,5.2,2022-09-21 07:00:00,7
352,936,1288,86,17.4,0,Clear,5.4,2022-09-21 08:00:00,8
225,464,689,70,21.0,0,Clear,2.9,2022-09-21 09:00:00,9
189,305,494,61,23.4,0,Clear,1.4,2022-09-21 10:00:00,10
185,372,557,54,25.2,0,Clear,0.8,2022-09-21 11:00:00,11
206,420,626,48,26.6,0,Clear,3.3,2022-09-21 12:00:00,12
193,331,524,45,27.6,0,Clear,5.4,2022-09-21 13:00:00,13
254,339,593,43,28.3,1,Mostly Clear,6.9,2022-09-21 14:00:00,14
273,467,740,44,28.8,0,Clear,8.7,2022-09-21 15:00:00,15
348,592,940,43,29.0,0,Clear,9.7,2022-09-21 16:00:00,16
594,1000,1594,43,28.9,0,Clear,9.5,2022-09-21 17:00:00,17
556,1018,1574,49,27.8,0,Clear,7.7,2022-09-21 18:00:00,18
438,752,1190,54,25.9,0,Clear,8.0,2022-09-21 19:00:00,19
283,460,743,59,24.4,0,Clear,9.7,2022-09-21 20:00:00,20
188,356,544,62,23.6,0,Clear,11.5,2022-09-21 21:00:00,21
181,257,438,64,23.0,0,Clear,11.5,2022-09-21 22:00:00,22
85,127,212,67,22.6,0,Clear,12.2,2022-09-21 23:00:00,23
29,58,87,69,22.4,0,Clear,12.5,2022-09-22 00:00:00,0
17,8,25,70,22.3,1,Mostly Clear,12.1,2022-09-22 01:00:00,1
10,5,15,70,22.0,1,Mostly Clear,11.9,2022-09-22 02:00:00,2
4,7,11,66,22.2,0,Clear,11.8,2022-09-22 03:00:00,3
8,17,25,67,21.9,1,Mostly Clear,11.8,2022-09-22 04:00:00,4
29,48,77,68,21.8,0,Clear,11.8,2022-09-22 05:00:00,5
68,208,276,68,21.7,1,Mostly Clear,11.3,2022-09-22 06:00:00,6
179,482,661,70,21.5,1,Mostly Clear,10.6,2022-09-22 07:00:00,7
312,850,1162,72,21.8,0,Clear,11.6,2022-09-22 08:00:00,8
194,486,680,68,23.6,1,Mostly Clear,11.8,2022-09-22 09:00:00,9
139,280,419,65,25.3,3,Cloudy,13.6,2022-09-22 10:00:00,10
112,251,363,66,26.2,2,Partly Cloudy,11.5,2022-09-22 11:00:00,11
97,187,284,74,25.2,53,Heavy Drizzle,18.0,2022-09-22 12:00:00,12
144,291,435,79,23.7,53,Heavy Drizzle,18.8,2022-09-22 13:00:00,13
209,292,501,75,22.9,2,Partly Cloudy,18.6,2022-09-22 14:00:00,14
265,480,745,71,22.3,51,Light Drizzle,19.6,2022-09-22 15:00:00,15
355,603,958,53,23.3,0,Clear,22.7,2022-09-22 16:00:00,16
586,1007,1593,42,23.3,0,Clear,26.0,2022-09-22 17:00:00,17
502,933,1435,41,22.2,0,Clear,21.2,2022-09-22 18:00:00,18
371,671,1042,42,20.9,1,Mostly Clear,23.5,2022-09-22 19:00:00,19
190,449,639,43,19.9,0,Clear,24.7,2022-09-22 20:00:00,20
180,320,500,46,18.8,0,Clear,23.7,2022-09-22 21:00:00,21
110,218,328,49,17.7,0,Clear,22.5,2022-09-22 22:00:00,22
78,121,199,51,16.8,0,Clear,20.2,2022-09-22 23:00:00,23
58,64,122,54,16.1,0,Clear,18.4,2022-09-23 00:00:00,0
22,26,48,56,15.5,0,Clear,17.4,2022-09-23 01:00:00,1
9,13,22,57,14.9,0,Clear,16.7,2022-09-23 02:00:00,2
7,6,13,61,14.4,1,Mostly Clear,16.7,2022-09-23 03:00:00,3
8,19,27,58,14.2,2,Partly Cloudy,16.6,2022-09-23 04:00:00,4
26,56,82,52,14.2,0,Clear,16.7,2022-09-23 05:00:00,5
45,184,229,48,13.9,0,Clear,13.9,2022-09-23 06:00:00,6
127,373,500,48,13.4,0,Clear,17.6,2022-09-23 07:00:00,7
215,609,824,52,13.1,0,Clear,14.0,2022-09-23 08:00:00,8
166,426,592,50,13.4,0,Clear,19.3,2022-09-23 09:00:00,9
259,352,611,48,14.3,0,Clear,18.1,2022-09-23 10:00:00,10
266,356,622,45,15.3,0,Clear,17.6,2022-09-23 11:00:00,11
293,426,719,41,16.4,0,Clear,18.4,2022-09-23 12:00:00,12
336,446,782,38,17.6,0,Clear,18.5,2022-09-23 13:00:00,13
329,434,763,36,18.7,0,Clear,18.6,2022-09-23 14:00:00,14
393,552,945,33,19.4,0,Clear,19.1,2022-09-23 15:00:00,15
479,647,1126,32,19.8,0,Clear,19.4,2022-09-23 16:00:00,16
530,835,1365,32,19.8,0,Clear,18.9,2022-09-23 17:00:00,17
557,753,1310,34,19.2,0,Clear,15.0,2022-09-23 18:00:00,18
401,571,972,36,18.0,0,Clear,12.2,2022-09-23 19:00:00,19
237,386,623,39,17.0,0,Clear,13.0,2022-09-23 20:00:00,20
183,258,441,41,16.1,0,Clear,13.3,2022-09-23 21:00:00,21
162,228,390,44,15.4,0,Clear,13.0,2022-09-23 22:00:00,22
186,208,394,47,14.7,1,Mostly Clear,12.5,2022-09-23 23:00:00,23
93,145,238,49,14.1,1,Mostly Clear,11.4,2022-09-24 00:00:00,0
90,125,215,51,13.6,1,Mostly Clear,9.3,2022-09-24 01:00:00,1
56,52,108,56,12.9,1,Mostly Clear,7.9,2022-09-24 02:00:00,2
27,23,50,66,12.0,1,Mostly Clear,5.9,2022-09-24 03:00:00,3
9,21,30,71,11.3,1,Mostly Clear,5.5,2022-09-24 04:00:00,4
17,29,46,73,11.1,1,Mostly Clear,5.4,2022-09-24 05:00:00,5
30,43,73,70,11.3,1,Mostly Clear,5.0,2022-09-24 06:00:00,6
72,115,187,77,11.4,0,Clear,5.6,2022-09-24 07:00:00,7
127,210,337,77,12.0,1,Mostly Clear,4.8,2022-09-24 08:00:00,8
297,377,674,59,13.8,1,Mostly Clear,5.1,2022-09-24 09:00:00,9
389,458,847,52,15.6,0,Clear,3.9,2022-09-24 10:00:00,10
577,529,1106,47,17.2,0,Clear,2.5,2022-09-24 11:00:00,11
579,525,1104,41,18.7,0,Clear,4.6,2022-09-24 12:00:00,12
675,508,1183,39,19.8,0,Clear,5.5,2022-09-24 13:00:00,13
632,543,1175,37,20.8,0,Clear,7.4,2022-09-24 14:00:00,14
653,584,1237,37,20.9,1,Mostly Clear,9.3,2022-09-24 15:00:00,15
604,533,1137,39,20.5,0,Clear,8.7,2022-09-24 16:00:00,16
524,505,1029,42,20.1,0,Clear,8.9,2022-09-24 17:00:00,17
549,530,1079,46,19.6,0,Clear,8.0,2022-09-24 18:00:00,18
419,493,912,51,18.3,1,Mostly Clear,6.0,2022-09-24 19:00:00,19
253,297,550,57,17.0,0,Clear,5.4,2022-09-24 20:00:00,20
245,233,478,61,16.3,0,Clear,6.9,2022-09-24 21:00:00,21
226,274,500,63,16.0,1,Mostly Clear,7.9,2022-09-24 22:00:00,22
254,232,486,65,15.8,1,Mostly Clear,8.0,2022-09-24 23:00:00,23
135,145,280,68,15.5,0,Clear,7.2,2022-09-25 00:00:00,0
123,98,221,68,15.7,0,Clear,8.3,2022-09-25 01:00:00,1
63,73,136,69,15.7,51,Light Drizzle,9.4,2022-09-25 02:00:00,2
43,29,72,72,15.4,1,Mostly Clear,9.2,2022-09-25 03:00:00,3
15,13,28,73,15.5,2,Partly Cloudy,8.0,2022-09-25 04:00:00,4
9,25,34,73,15.8,2,Partly Cloudy,8.0,2022-09-25 05:00:00,5
28,23,51,75,15.6,2,Partly Cloudy,6.3,2022-09-25 06:00:00,6
47,78,125,78,15.2,1,Mostly Clear,7.1,2022-09-25 07:00:00,7
125,214,339,78,15.8,1,Mostly Clear,7.9,2022-09-25 08:00:00,8
245,339,584,72,17.5,1,Mostly Clear,8.6,2022-09-25 09:00:00,9
445,434,879,66,19.5,2,Partly Cloudy,10.1,2022-09-25 10:00:00,10
488,496,984,61,21.5,2,Partly Cloudy,10.9,2022-09-25 11:00:00,11
530,604,1134,57,22.9,1,Mostly Clear,12.0,2022-09-25 12:00:00,12
507,514,1021,52,24.8,2,Partly Cloudy,13.0,2022-09-25 13:00:00,13
435,526,961,47,26.6,3,Cloudy,14.0,2022-09-25 14:00:00,14
347,431,778,53,25.6,51,Light Drizzle,14.7,2022-09-25 15:00:00,15
261,297,558,61,24.3,51,Light Drizzle,11.3,2022-09-25 16:00:00,16
290,402,692,67,23.4,1,Mostly Clear,12.6,2022-09-25 17:00:00,17
312,416,728,70,22.9,1,Mostly Clear,12.0,2022-09-25 18:00:00,18
212,336,548,70,22.4,1,Mostly Clear,13.5,2022-09-25 19:00:00,19
144,220,364,70,21.7,51,Light Drizzle,13.0,2022-09-25 20:00:00,20
127,163,290,70,21.1,0,Clear,12.6,2022-09-25 21:00:00,21
115,155,270,71,20.4,0,Clear,11.0,2022-09-25 22:00:00,22
49,91,140,72,19.7,1,Mostly Clear,9.7,2022-09-25 23:00:00,23
14,32,46,72,19.2,1,Mostly Clear,9.0,2022-09-26 00:00:00,0
11,15,26,72,18.6,0,Clear,8.6,2022-09-26 01:00:00,1
7,15,22,75,17.9,0,Clear,9.4,2022-09-26 02:00:00,2
3,4,7,85,17.1,0,Clear,9.7,2022-09-26 03:00:00,3
9,14,23,85,16.5,0,Clear,10.8,2022-09-26 04:00:00,4
13,64,77,86,16.0,0,Clear,10.5,2022-09-26 05:00:00,5
51,177,228,86,15.5,0,Clear,7.4,2022-09-26 06:00:00,6
135,444,579,88,14.8,0,Clear,6.9,2022-09-26 07:00:00,7
220,695,915,88,15.3,0,Clear,9.1,2022-09-26 08:00:00,8
211,402,613,73,18.5,0,Clear,9.3,2022-09-26 09:00:00,9
196,277,473,63,20.5,0,Clear,12.0,2022-09-26 10:00:00,10
247,321,568,54,21.9,1,Mostly Clear,15.6,2022-09-26 11:00:00,11
279,402,681,48,23.0,1,Mostly Clear,15.0,2022-09-26 12:00:00,12
249,367,616,44,23.6,1,Mostly Clear,17.1,2022-09-26 13:00:00,13
255,345,600,41,24.0,1,Mostly Clear,15.7,2022-09-26 14:00:00,14
316,473,789,39,24.1,1,Mostly Clear,17.5,2022-09-26 15:00:00,15
348,594,942,38,24.2,1,Mostly Clear,17.0,2022-09-26 16:00:00,16
492,1003,1495,37,23.9,1,Mostly Clear,13.4,2022-09-26 17:00:00,17
456,919,1375,41,22.7,1,Mostly Clear,8.6,2022-09-26 18:00:00,18
303,573,876,43,21.3,2,Partly Cloudy,7.6,2022-09-26 19:00:00,19
201,389,590,45,20.1,1,Mostly Clear,6.9,2022-09-26 20:00:00,20
165,277,442,45,19.4,2,Partly Cloudy,8.1,2022-09-26 21:00:00,21
142,207,349,47,18.6,2,Partly Cloudy,8.4,2022-09-26 22:00:00,22
82,118,200,49,17.8,2,Partly Cloudy,7.6,2022-09-26 23:00:00,23
20,32,52,52,17.2,1,Mostly Clear,8.3,2022-09-27 00:00:00,0
14,10,24,57,16.4,2,Partly Cloudy,10.1,2022-09-27 01:00:00,1
7,5,12,63,15.7,2,Partly Cloudy,10.9,2022-09-27 02:00:00,2
4,9,13,55,16.2,3,Cloudy,10.2,2022-09-27 03:00:00,3
6,14,20,56,15.7,3,Cloudy,9.0,2022-09-27 04:00:00,4
31,63,94,60,15.2,2,Partly Cloudy,7.9,2022-09-27 05:00:00,5
63,202,265,61,14.6,2,Partly Cloudy,8.8,2022-09-27 06:00:00,6
156,555,711,66,14.0,2,Partly Cloudy,8.6,2022-09-27 07:00:00,7
320,897,1217,70,14.1,1,Mostly Clear,9.7,2022-09-27 08:00:00,8
183,467,650,55,17.0,1,Mostly Clear,9.2,2022-09-27 09:00:00,9
161,278,439,47,18.5,0,Clear,13.0,2022-09-27 10:00:00,10
182,291,473,41,19.7,0,Clear,13.7,2022-09-27 11:00:00,11
193,401,594,35,20.6,1,Mostly Clear,15.8,2022-09-27 12:00:00,12
241,367,608,32,21.3,1,Mostly Clear,17.6,2022-09-27 13:00:00,13
185,339,524,29,21.6,1,Mostly Clear,18.4,2022-09-27 14:00:00,14
242,464,706,33,21.3,1,Mostly Clear,18.0,2022-09-27 15:00:00,15
338,619,957,35,20.8,1,Mostly Clear,17.0,2022-09-27 16:00:00,16
519,1095,1614,35,20.5,1,Mostly Clear,15.5,2022-09-27 17:00:00,17
540,975,1515,37,19.9,1,Mostly Clear,11.9,2022-09-27 18:00:00,18
323,662,985,38,18.7,0,Clear,11.3,2022-09-27 19:00:00,19
192,391,583,40,17.5,0,Clear,14.7,2022-09-27 20:00:00,20
168,294,462,42,16.6,0,Clear,15.9,2022-09-27 21:00:00,21
133,266,399,44,15.9,0,Clear,13.5,2022-09-27 22:00:00,22
99,120,219,48,15.2,0,Clear,13.0,2022-09-27 23:00:00,23
27,28,55,51,14.5,0,Clear,13.0,2022-09-28 00:00:00,0
14,21,35,56,13.9,0,Clear,11.4,2022-09-28 01:00:00,1
2,10,12,61,13.2,0,Clear,8.6,2022-09-28 02:00:00,2
7,6,13,67,11.9,0,Clear,7.0,2022-09-28 03:00:00,3
6,16,22,74,10.9,0,Clear,6.6,2022-09-28 04:00:00,4
22,68,90,77,10.2,0,Clear,7.2,2022-09-28 05:00:00,5
62,190,252,79,9.7,0,Clear,7.3,2022-09-28 06:00:00,6
187,541,728,82,9.3,0,Clear,8.3,2022-09-28 07:00:00,7
295,957,1252,80,10.4,0,Clear,10.1,2022-09-28 08:00:00,8
219,482,701,65,13.3,0,Clear,11.4,2022-09-28 09:00:00,9
163,294,457,61,14.8,1,Mostly Clear,11.8,2022-09-28 10:00:00,10
180,319,499,57,16.4,0,Clear,11.5,2022-09-28 11:00:00,11
186,382,568,49,18.4,1,Mostly Clear,12.6,2022-09-28 12:00:00,12
206,329,535,45,19.4,3,Cloudy,12.6,2022-09-28 13:00:00,13
222,333,555,43,19.7,3,Cloudy,13.2,2022-09-28 14:00:00,14
282,451,733,48,19.5,3,Cloudy,14.3,2022-09-28 15:00:00,15
405,654,1059,47,19.9,3,Cloudy,14.6,2022-09-28 16:00:00,16
546,1130,1676,49,19.3,2,Partly Cloudy,13.9,2022-09-28 17:00:00,17
529,991,1520,51,18.7,3,Cloudy,11.7,2022-09-28 18:00:00,18
330,671,1001,53,18.1,3,Cloudy,10.0,2022-09-28 19:00:00,19
217,473,690,56,17.5,1,Mostly Clear,9.9,2022-09-28 20:00:00,20
172,329,501,57,16.9,1,Mostly Clear,11.2,2022-09-28 21:00:00,21
136,216,352,59,16.4,1,Mostly Clear,12.3,2022-09-28 22:00:00,22
69,104,173,61,15.7,1,Mostly Clear,12.6,2022-09-28 23:00:00,23
31,37,68,64,15.1,0,Clear,12.2,2022-09-29 00:00:00,0
11,17,28,67,14.6,0,Clear,12.6,2022-09-29 01:00:00,1
11,8,19,71,14.0,0,Clear,13.0,2022-09-29 02:00:00,2
4,6,10,75,13.7,0,Clear,14.4,2022-09-29 03:00:00,3
5,14,19,75,13.3,0,Clear,14.8,2022-09-29 04:00:00,4
19,57,76,75,12.9,1,Mostly Clear,15.1,2022-09-29 05:00:00,5
62,195,257,75,12.5,1,Mostly Clear,13.0,2022-09-29 06:00:00,6
151,472,623,76,12.2,1,Mostly Clear,13.0,2022-09-29 07:00:00,7
262,820,1082,75,12.4,0,Clear,13.0,2022-09-29 08:00:00,8
192,511,703,70,13.5,1,Mostly Clear,16.1,2022-09-29 09:00:00,9
159,320,479,64,15.1,1,Mostly Clear,16.7,2022-09-29 10:00:00,10
176,310,486,57,16.7,1,Mostly Clear,17.9,2022-09-29 11:00:00,11
217,349,566,51,17.9,1,Mostly Clear,16.9,2022-09-29 12:00:00,12
205,376,581,48,18.6,0,Clear,15.0,2022-09-29 13:00:00,13
242,331,573,46,19.3,1,Mostly Clear,14.3,2022-09-29 14:00:00,14
322,433,755,45,19.6,1,Mostly Clear,14.2,2022-09-29 15:00:00,15
372,597,969,45,19.6,1,Mostly Clear,12.8,2022-09-29 16:00:00,16
487,1101,1588,45,19.4,1,Mostly Clear,11.8,2022-09-29 17:00:00,17
522,934,1456,47,18.6,1,Mostly Clear,9.0,2022-09-29 18:00:00,18
352,620,972,52,17.4,1,Mostly Clear,8.2,2022-09-29 19:00:00,19
219,418,637,56,16.4,1,Mostly Clear,7.9,2022-09-29 20:00:00,20
155,348,503,58,15.7,1,Mostly Clear,10.4,2022-09-29 21:00:00,21
146,213,359,58,15.2,1,Mostly Clear,11.6,2022-09-29 22:00:00,22
150,199,349,58,14.9,1,Mostly Clear,12.2,2022-09-29 23:00:00,23
63,70,133,58,14.5,1,Mostly Clear,12.1,2022-09-30 00:00:00,0
29,33,62,60,14.1,1,Mostly Clear,12.9,2022-09-30 01:00:00,1
24,23,47,62,13.9,1,Mostly Clear,13.2,2022-09-30 02:00:00,2
5,12,17,65,13.5,1,Mostly Clear,13.1,2022-09-30 03:00:00,3
4,13,17,66,13.3,1,Mostly Clear,13.0,2022-09-30 04:00:00,4
23,46,69,67,13.1,1,Mostly Clear,13.9,2022-09-30 05:00:00,5
64,149,213,68,13.0,1,Mostly Clear,13.4,2022-09-30 06:00:00,6
147,412,559,69,13.0,1,Mostly Clear,14.0,2022-09-30 07:00:00,7
210,579,789,70,13.1,1,Mostly Clear,13.9,2022-09-30 08:00:00,8
202,425,627,70,13.5,1,Mostly Clear,13.8,2022-09-30 09:00:00,9
189,289,478,69,14.2,1,Mostly Clear,14.9,2022-09-30 10:00:00,10
243,392,635,69,15.2,2,Partly Cloudy,17.1,2022-09-30 11:00:00,11
245,394,639,69,15.8,3,Cloudy,17.3,2022-09-30 12:00:00,12
256,405,661,70,16.2,3,Cloudy,16.5,2022-09-30 13:00:00,13
275,405,680,69,16.5,3,Cloudy,17.1,2022-09-30 14:00:00,14
242,423,665,71,16.5,3,Cloudy,19.2,2022-09-30 15:00:00,15
180,370,550,75,16.1,51,Light Drizzle,17.6,2022-09-30 16:00:00,16
147,326,473,85,14.9,53,Heavy Drizzle,16.8,2022-09-30 17:00:00,17
147,351,498,88,14.3,53,Heavy Drizzle,19.6,2022-09-30 18:00:00,18
126,286,412,87,14.0,51,Light Drizzle,19.6,2022-09-30 19:00:00,19
99,156,255,84,14.0,3,Cloudy,17.8,2022-09-30 20:00:00,20
55,106,161,85,13.6,61,Light Rain,20.0,2022-09-30 21:00:00,21
33,63,96,89,13.0,63,Rain,21.4,2022-09-30 22:00:00,22
27,68,95,91,12.9,63,Rain,22.5,2022-09-30 23:00:00,23
26,59,85,92,12.9,65,Heavy Rain,24.1,2022-10-01 00:00:00,0
34,36,70,93,12.9,63,Rain,25.1,2022-10-01 01:00:00,1
10,21,31,93,12.8,61,Light Rain,26.8,2022-10-01 02:00:00,2
6,12,18,94,13.2,61,Light Rain,26.7,2022-10-01 03:00:00,3
5,5,10,94,13.2,61,Light Rain,26.2,2022-10-01 04:00:00,4
10,10,20,93,13.3,51,Light Drizzle,24.7,2022-10-01 05:00:00,5
16,26,42,93,13.5,51,Light Drizzle,16.5,2022-10-01 06:00:00,6
44,69,113,92,13.6,3,Cloudy,19.9,2022-10-01 07:00:00,7
72,149,221,91,13.8,3,Cloudy,21.7,2022-10-01 08:00:00,8
89,180,269,89,14.0,3,Cloudy,20.7,2022-10-01 09:00:00,9
99,234,333,87,14.3,3,Cloudy,21.8,2022-10-01 10:00:00,10
184,293,477,84,14.8,3,Cloudy,22.8,2022-10-01 11:00:00,11
125,279,404,83,15.0,3,Cloudy,20.0,2022-10-01 12:00:00,12
160,300,460,82,15.9,3,Cloudy,21.3,2022-10-01 13:00:00,13
217,341,558,80,16.9,3,Cloudy,21.0,2022-10-01 14:00:00,14
263,346,609,89,16.9,51,Light Drizzle,19.1,2022-10-01 15:00:00,15
288,328,616,91,17.4,51,Light Drizzle,17.4,2022-10-01 16:00:00,16
263,344,607,92,18.0,53,Heavy Drizzle,15.6,2022-10-01 17:00:00,17
209,290,499,93,17.9,55,Heavy Drizzle,16.3,2022-10-01 18:00:00,18
139,253,392,94,17.5,55,Heavy Drizzle,16.8,2022-10-01 19:00:00,19
86,162,248,95,17.0,55,Heavy Drizzle,17.1,2022-10-01 20:00:00,20
87,159,246,96,16.6,55,Heavy Drizzle,16.3,2022-10-01 21:00:00,21
67,158,225,97,16.2,55,Heavy Drizzle,16.1,2022-10-01 22:00:00,22
67,107,174,98,15.9,55,Heavy Drizzle,15.3,2022-10-01 23:00:00,23
59,89,148,98,15.7,53,Heavy Drizzle,14.3,2022-10-02 00:00:00,0
54,86,140,98,15.6,53,Heavy Drizzle,13.2,2022-10-02 01:00:00,1
50,55,105,98,15.3,53,Heavy Drizzle,13.0,2022-10-02 02:00:00,2
27,17,44,98,15.1,53,Heavy Drizzle,13.9,2022-10-02 03:00:00,3
7,7,14,98,14.8,51,Light Drizzle,14.6,2022-10-02 04:00:00,4
6,13,19,97,14.6,51,Light Drizzle,15.9,2022-10-02 05:00:00,5
17,16,33,97,14.5,51,Light Drizzle,13.3,2022-10-02 06:00:00,6
7,29,36,96,14.3,53,Heavy Drizzle,15.0,2022-10-02 07:00:00,7
26,90,116,95,14.0,53,Heavy Drizzle,15.6,2022-10-02 08:00:00,8
51,150,201,93,13.7,55,Heavy Drizzle,15.6,2022-10-02 09:00:00,9
95,199,294,92,13.5,55,Heavy Drizzle,16.0,2022-10-02 10:00:00,10
93,201,294,92,13.2,55,Heavy Drizzle,16.7,2022-10-02 11:00:00,11
80,162,242,90,13.1,53,Heavy Drizzle,17.4,2022-10-02 12:00:00,12
105,242,347,92,13.0,53,Heavy Drizzle,18.0,2022-10-02 13:00:00,13
73,169,242,92,13.1,53,Heavy Drizzle,18.3,2022-10-02 14:00:00,14
87,176,263,93,12.9,55,Heavy Drizzle,19.4,2022-10-02 15:00:00,15
61,114,175,94,12.9,61,Light Rain,20.5,2022-10-02 16:00:00,16
51,150,201,95,12.9,61,Light Rain,21.2,2022-10-02 17:00:00,17
41,126,167,94,12.7,61,Light Rain,17.3,2022-10-02 18:00:00,18
56,145,201,93,12.4,53,Heavy Drizzle,18.3,2022-10-02 19:00:00,19
37,117,154,92,12.0,51,Light Drizzle,18.2,2022-10-02 20:00:00,20
37,103,140,92,11.6,53,Heavy Drizzle,17.3,2022-10-02 21:00:00,21
27,69,96,91,11.4,51,Light Drizzle,17.0,2022-10-02 22:00:00,22
14,45,59,90,11.2,51,Light Drizzle,17.4,2022-10-02 23:00:00,23
4,9,13,90,10.9,53,Heavy Drizzle,17.6,2022-10-03 00:00:00,0
5,5,10,90,10.5,53,Heavy Drizzle,18.2,2022-10-03 01:00:00,1
1,5,6,89,10.1,53,Heavy Drizzle,19.2,2022-10-03 02:00:00,2
5,1,6,90,10.4,53,Heavy Drizzle,19.1,2022-10-03 03:00:00,3
4,6,10,89,9.9,53,Heavy Drizzle,18.8,2022-10-03 04:00:00,4
20,43,63,89,9.5,53,Heavy Drizzle,18.7,2022-10-03 05:00:00,5
40,108,148,89,9.2,53,Heavy Drizzle,17.5,2022-10-03 06:00:00,6
73,334,407,89,8.9,53,Heavy Drizzle,17.7,2022-10-03 07:00:00,7
159,589,748,89,8.7,53,Heavy Drizzle,16.9,2022-10-03 08:00:00,8
109,334,443,87,9.0,51,Light Drizzle,16.3,2022-10-03 09:00:00,9
76,174,250,85,9.6,53,Heavy Drizzle,14.3,2022-10-03 10:00:00,10
90,201,291,82,10.1,53,Heavy Drizzle,18.7,2022-10-03 11:00:00,11
106,292,398,82,10.1,53,Heavy Drizzle,19.0,2022-10-03 12:00:00,12
143,277,420,81,10.2,53,Heavy Drizzle,18.6,2022-10-03 13:00:00,13
113,252,365,80,10.4,53,Heavy Drizzle,18.1,2022-10-03 14:00:00,14
64,160,224,73,10.9,53,Heavy Drizzle,15.5,2022-10-03 15:00:00,15
79,221,300,86,9.9,61,Light Rain,13.4,2022-10-03 16:00:00,16
123,360,483,89,9.6,55,Heavy Drizzle,14.8,2022-10-03 17:00:00,17
66,243,309,89,9.6,55,Heavy Drizzle,14.8,2022-10-03 18:00:00,18
33,160,193,89,9.4,55,Heavy Drizzle,14.4,2022-10-03 19:00:00,19
34,99,133,89,9.3,53,Heavy Drizzle,13.9,2022-10-03 20:00:00,20
29,104,133,87,9.2,51,Light Drizzle,14.1,2022-10-03 21:00:00,21
40,81,121,84,9.3,51,Light Drizzle,13.4,2022-10-03 22:00:00,22
17,56,73,83,9.4,51,Light Drizzle,13.3,2022-10-03 23:00:00,23
7,13,20,84,9.3,51,Light Drizzle,14.1,2022-10-04 00:00:00,0
0,5,5,84,9.2,51,Light Drizzle,14.9,2022-10-04 01:00:00,1
2,4,6,85,9.1,51,Light Drizzle,15.5,2022-10-04 02:00:00,2
2,4,6,89,9.0,51,Light Drizzle,15.9,2022-10-04 03:00:00,3
1,12,13,88,9.0,51,Light Drizzle,16.4,2022-10-04 04:00:00,4
15,41,56,88,9.0,51,Light Drizzle,16.9,2022-10-04 05:00:00,5
38,124,162,88,9.0,51,Light Drizzle,15.2,2022-10-04 06:00:00,6
88,388,476,88,9.0,51,Light Drizzle,16.3,2022-10-04 07:00:00,7
195,645,840,87,9.1,53,Heavy Drizzle,15.5,2022-10-04 08:00:00,8
120,419,539,86,9.3,53,Heavy Drizzle,14.4,2022-10-04 09:00:00,9
75,183,258,85,9.7,51,Light Drizzle,14.3,2022-10-04 10:00:00,10
80,210,290,86,10.0,51,Light Drizzle,17.1,2022-10-04 11:00:00,11
99,242,341,82,10.6,3,Cloudy,19.1,2022-10-04 12:00:00,12
123,286,409,77,11.1,3,Cloudy,17.1,2022-10-04 13:00:00,13
107,244,351,77,11.3,51,Light Drizzle,17.6,2022-10-04 14:00:00,14
151,342,493,77,11.9,51,Light Drizzle,16.7,2022-10-04 15:00:00,15
173,495,668,77,11.8,51,Light Drizzle,16.8,2022-10-04 16:00:00,16
231,709,940,79,11.5,51,Light Drizzle,16.6,2022-10-04 17:00:00,17
131,463,594,79,11.3,51,Light Drizzle,14.7,2022-10-04 18:00:00,18
83,279,362,80,11.1,51,Light Drizzle,16.3,2022-10-04 19:00:00,19
67,210,277,79,11.2,3,Cloudy,16.9,2022-10-04 20:00:00,20
48,126,174,80,11.1,51,Light Drizzle,17.1,2022-10-04 21:00:00,21
42,114,156,82,11.0,53,Heavy Drizzle,16.3,2022-10-04 22:00:00,22
31,65,96,84,10.9,61,Light Rain,16.3,2022-10-04 23:00:00,23
19,27,46,87,10.8,53,Heavy Drizzle,17.0,2022-10-05 00:00:00,0
6,6,12,88,10.8,61,Light Rain,17.7,2022-10-05 01:00:00,1
2,5,7,90,10.7,61,Light Rain,18.0,2022-10-05 02:00:00,2
3,4,7,92,10.5,51,Light Drizzle,17.1,2022-10-05 03:00:00,3
2,5,7,93,10.5,51,Light Drizzle,17.0,2022-10-05 04:00:00,4
13,38,51,92,10.7,51,Light Drizzle,17.3,2022-10-05 05:00:00,5
24,111,135,90,10.9,51,Light Drizzle,13.8,2022-10-05 06:00:00,6
77,283,360,91,10.9,53,Heavy Drizzle,15.5,2022-10-05 07:00:00,7
102,415,517,92,10.9,53,Heavy Drizzle,14.7,2022-10-05 08:00:00,8
103,381,484,90,11.2,51,Light Drizzle,14.7,2022-10-05 09:00:00,9
83,200,283,88,11.7,3,Cloudy,14.6,2022-10-05 10:00:00,10
90,220,310,87,12.6,3,Cloudy,13.5,2022-10-05 11:00:00,11
100,278,378,81,13.8,3,Cloudy,12.9,2022-10-05 12:00:00,12
138,302,440,77,14.7,3,Cloudy,12.4,2022-10-05 13:00:00,13
152,343,495,75,15.6,3,Cloudy,12.3,2022-10-05 14:00:00,14
209,401,610,80,15.2,3,Cloudy,11.3,2022-10-05 15:00:00,15
287,556,843,78,15.9,3,Cloudy,10.0,2022-10-05 16:00:00,16
418,883,1301,77,16.3,3,Cloudy,9.2,2022-10-05 17:00:00,17
391,835,1226,78,16.3,3,Cloudy,5.0,2022-10-05 18:00:00,18
242,597,839,81,15.7,3,Cloudy,6.1,2022-10-05 19:00:00,19
138,354,492,85,15.1,3,Cloudy,7.5,2022-10-05 20:00:00,20
138,284,422,88,14.6,1,Mostly Clear,8.4,2022-10-05 21:00:00,21
107,190,297,89,14.1,1,Mostly Clear,8.7,2022-10-05 22:00:00,22
67,109,176,90,13.8,0,Clear,9.0,2022-10-05 23:00:00,23
29,31,60,92,13.3,0,Clear,10.0,2022-10-06 00:00:00,0
7,13,20,92,13.2,0,Clear,10.2,2022-10-06 01:00:00,1
6,13,19,92,12.7,0,Clear,9.7,2022-10-06 02:00:00,2
3,10,13,77,12.1,0,Clear,9.4,2022-10-06 03:00:00,3
0,14,14,78,11.7,0,Clear,8.7,2022-10-06 04:00:00,4
19,60,79,79,11.3,0,Clear,8.2,2022-10-06 05:00:00,5
68,175,243,82,10.7,0,Clear,8.2,2022-10-06 06:00:00,6
133,469,602,86,10.1,0,Clear,7.4,2022-10-06 07:00:00,7
245,776,1021,88,10.2,0,Clear,7.9,2022-10-06 08:00:00,8
218,493,711,78,14.1,0,Clear,6.0,2022-10-06 09:00:00,9
180,295,475,71,17.0,0,Clear,5.0,2022-10-06 10:00:00,10
179,309,488,62,19.6,0,Clear,5.4,2022-10-06 11:00:00,11
254,399,653,54,21.4,0,Clear,5.9,2022-10-06 12:00:00,12
237,366,603,49,22.7,0,Clear,6.0,2022-10-06 13:00:00,13
279,337,616,46,23.5,0,Clear,6.2,2022-10-06 14:00:00,14
298,471,769,44,23.8,0,Clear,6.0,2022-10-06 15:00:00,15
424,606,1030,43,23.8,0,Clear,4.7,2022-10-06 16:00:00,16
615,977,1592,48,23.3,0,Clear,4.1,2022-10-06 17:00:00,17
573,938,1511,58,22.0,0,Clear,5.0,2022-10-06 18:00:00,18
389,573,962,65,20.2,0,Clear,8.0,2022-10-06 19:00:00,19
231,455,686,74,18.2,0,Clear,8.6,2022-10-06 20:00:00,20
160,324,484,80,16.8,0,Clear,7.9,2022-10-06 21:00:00,21
177,249,426,83,15.7,0,Clear,7.2,2022-10-06 22:00:00,22
92,166,258,84,15.1,0,Clear,8.7,2022-10-06 23:00:00,23
46,111,157,86,14.6,0,Clear,10.2,2022-10-07 00:00:00,0
39,33,72,85,14.2,0,Clear,10.2,2022-10-07 01:00:00,1
18,17,35,83,13.7,0,Clear,9.5,2022-10-07 02:00:00,2
5,9,14,81,13.2,0,Clear,9.3,2022-10-07 03:00:00,3
2,20,22,81,12.8,0,Clear,9.2,2022-10-07 04:00:00,4
20,44,64,82,12.2,0,Clear,8.7,2022-10-07 05:00:00,5
50,150,200,83,11.5,0,Clear,8.6,2022-10-07 06:00:00,6
115,340,455,85,10.9,0,Clear,8.0,2022-10-07 07:00:00,7
212,506,718,85,11.2,0,Clear,7.9,2022-10-07 08:00:00,8
217,375,592,73,15.5,0,Clear,7.3,2022-10-07 09:00:00,9
248,286,534,62,18.8,0,Clear,6.5,2022-10-07 10:00:00,10
256,319,575,53,21.1,0,Clear,8.0,2022-10-07 11:00:00,11
291,405,696,47,22.7,0,Clear,9.4,2022-10-07 12:00:00,12
362,464,826,44,23.8,0,Clear,9.4,2022-10-07 13:00:00,13
413,477,890,41,24.4,0,Clear,9.0,2022-10-07 14:00:00,14
516,525,1041,42,24.9,0,Clear,9.5,2022-10-07 15:00:00,15
514,640,1154,43,24.7,1,Mostly Clear,9.1,2022-10-07 16:00:00,16
611,845,1456,51,23.9,2,Partly Cloudy,4.3,2022-10-07 17:00:00,17
553,700,1253,60,22.4,2,Partly Cloudy,3.8,2022-10-07 18:00:00,18
342,533,875,63,21.0,2,Partly Cloudy,3.9,2022-10-07 19:00:00,19
244,317,561,62,19.7,2,Partly Cloudy,9.9,2022-10-07 20:00:00,20
193,230,423,64,18.0,2,Partly Cloudy,17.9,2022-10-07 21:00:00,21
140,206,346,66,16.6,51,Light Drizzle,17.3,2022-10-07 22:00:00,22
118,183,301,70,15.3,51,Light Drizzle,14.0,2022-10-07 23:00:00,23
123,135,258,72,14.4,51,Light Drizzle,13.7,2022-10-08 00:00:00,0
66,99,165,71,13.7,51,Light Drizzle,13.5,2022-10-08 01:00:00,1
58,54,112,67,13.1,1,Mostly Clear,13.0,2022-10-08 02:00:00,2
27,22,49,60,13.1,0,Clear,12.3,2022-10-08 03:00:00,3
11,15,26,58,12.4,0,Clear,11.9,2022-10-08 04:00:00,4
13,24,37,59,11.5,0,Clear,11.4,2022-10-08 05:00:00,5
47,43,90,61,10.9,0,Clear,8.9,2022-10-08 06:00:00,6
56,114,170,65,10.2,0,Clear,9.7,2022-10-08 07:00:00,7
147,213,360,70,10.0,0,Clear,10.3,2022-10-08 08:00:00,8
274,328,602,67,11.1,0,Clear,11.7,2022-10-08 09:00:00,9
400,399,799,62,12.2,0,Clear,13.5,2022-10-08 10:00:00,10
527,488,1015,55,13.3,1,Mostly Clear,14.5,2022-10-08 11:00:00,11
490,505,995,52,14.0,3,Cloudy,13.3,2022-10-08 12:00:00,12
543,495,1038,50,14.6,3,Cloudy,13.3,2022-10-08 13:00:00,13
519,442,961,48,14.7,3,Cloudy,14.0,2022-10-08 14:00:00,14
553,453,1006,48,13.9,3,Cloudy,14.6,2022-10-08 15:00:00,15
523,401,924,47,13.9,3,Cloudy,14.7,2022-10-08 16:00:00,16
556,449,1005,46,13.7,3,Cloudy,14.1,2022-10-08 17:00:00,17
385,420,805,45,13.4,3,Cloudy,11.3,2022-10-08 18:00:00,18
222,308,530,50,12.8,2,Partly Cloudy,8.0,2022-10-08 19:00:00,19
183,206,389,56,11.6,0,Clear,7.3,2022-10-08 20:00:00,20
131,197,328,62,10.5,0,Clear,7.5,2022-10-08 21:00:00,21
129,184,313,66,9.5,0,Clear,7.9,2022-10-08 22:00:00,22
98,170,268,69,8.7,0,Clear,7.1,2022-10-08 23:00:00,23
78,127,205,70,8.1,0,Clear,6.7,2022-10-09 00:00:00,0
93,99,192,72,7.6,0,Clear,7.9,2022-10-09 01:00:00,1
61,50,111,74,7.1,0,Clear,8.0,2022-10-09 02:00:00,2
22,34,56,77,6.4,0,Clear,7.9,2022-10-09 03:00:00,3
10,18,28,79,5.9,0,Clear,8.0,2022-10-09 04:00:00,4
19,10,29,82,5.4,0,Clear,7.3,2022-10-09 05:00:00,5
28,41,69,83,5.1,0,Clear,6.9,2022-10-09 06:00:00,6
49,74,123,85,4.8,0,Clear,6.8,2022-10-09 07:00:00,7
109,171,280,85,5.3,0,Clear,8.2,2022-10-09 08:00:00,8
218,253,471,70,9.3,0,Clear,8.0,2022-10-09 09:00:00,9
381,387,768,60,11.9,0,Clear,9.2,2022-10-09 10:00:00,10
500,457,957,50,13.6,0,Clear,11.2,2022-10-09 11:00:00,11
516,477,993,46,14.7,0,Clear,10.8,2022-10-09 12:00:00,12
551,529,1080,43,15.7,0,Clear,11.5,2022-10-09 13:00:00,13
590,496,1086,42,16.3,0,Clear,12.2,2022-10-09 14:00:00,14
567,472,1039,41,16.7,0,Clear,12.0,2022-10-09 15:00:00,15
530,508,1038,40,16.9,0,Clear,11.0,2022-10-09 16:00:00,16
518,482,1000,41,16.6,0,Clear,9.4,2022-10-09 17:00:00,17
416,445,861,50,15.6,0,Clear,4.8,2022-10-09 18:00:00,18
201,306,507,56,13.9,0,Clear,5.4,2022-10-09 19:00:00,19
153,203,356,66,12.0,0,Clear,5.8,2022-10-09 20:00:00,20
120,163,283,73,10.6,0,Clear,6.5,2022-10-09 21:00:00,21
130,169,299,76,9.8,0,Clear,7.1,2022-10-09 22:00:00,22
60,94,154,77,9.3,0,Clear,8.0,2022-10-09 23:00:00,23
35,41,76,82,8.4,0,Clear,8.2,2022-10-10 00:00:00,0
20,33,53,84,7.7,0,Clear,7.6,2022-10-10 01:00:00,1
7,14,21,85,7.2,0,Clear,7.0,2022-10-10 02:00:00,2
6,11,17,87,6.5,0,Clear,7.3,2022-10-10 03:00:00,3
6,10,16,87,6.2,0,Clear,7.1,2022-10-10 04:00:00,4
11,38,49,86,6.0,0,Clear,7.3,2022-10-10 05:00:00,5
28,87,115,86,5.8,0,Clear,7.7,2022-10-10 06:00:00,6
76,168,244,85,5.7,0,Clear,7.6,2022-10-10 07:00:00,7
124,319,443,86,6.1,0,Clear,8.9,2022-10-10 08:00:00,8
178,288,466,73,10.5,0,Clear,8.3,2022-10-10 09:00:00,9
227,320,547,61,13.7,0,Clear,7.0,2022-10-10 10:00:00,10
281,392,673,51,15.9,0,Clear,6.0,2022-10-10 11:00:00,11
299,408,707,44,17.3,0,Clear,5.6,2022-10-10 12:00:00,12
406,451,857,41,18.1,0,Clear,6.2,2022-10-10 13:00:00,13
443,465,908,40,18.7,0,Clear,6.4,2022-10-10 14:00:00,14
393,495,888,40,19.1,0,Clear,5.6,2022-10-10 15:00:00,15
391,561,952,40,19.1,0,Clear,5.1,2022-10-10 16:00:00,16
512,726,1238,42,18.7,0,Clear,4.9,2022-10-10 17:00:00,17
409,709,1118,52,17.6,0,Clear,4.4,2022-10-10 18:00:00,18
260,426,686,59,15.4,0,Clear,7.1,2022-10-10 19:00:00,19
165,290,455,64,13.9,0,Clear,7.7,2022-10-10 20:00:00,20
107,204,311,68,12.8,0,Clear,7.4,2022-10-10 21:00:00,21
111,145,256,72,11.7,0,Clear,8.0,2022-10-10 22:00:00,22
70,111,181,76,10.8,0,Clear,8.2,2022-10-10 23:00:00,23
27,35,62,78,10.0,0,Clear,7.9,2022-10-11 00:00:00,0
12,9,21,80,9.4,0,Clear,7.8,2022-10-11 01:00:00,1
7,3,10,81,8.9,0,Clear,7.6,2022-10-11 02:00:00,2
5,13,18,83,8.6,0,Clear,7.4,2022-10-11 03:00:00,3
9,8,17,85,8.1,0,Clear,7.3,2022-10-11 04:00:00,4
19,59,78,86,7.9,0,Clear,7.6,2022-10-11 05:00:00,5
46,168,214,85,7.9,0,Clear,7.2,2022-10-11 06:00:00,6
124,472,596,85,7.9,0,Clear,6.6,2022-10-11 07:00:00,7
233,841,1074,86,8.2,0,Clear,6.0,2022-10-11 08:00:00,8
167,396,563,78,11.7,0,Clear,3.9,2022-10-11 09:00:00,9
174,268,442,65,15.5,0,Clear,2.6,2022-10-11 10:00:00,10
160,273,433,54,18.3,0,Clear,2.9,2022-10-11 11:00:00,11
177,344,521,47,20.0,0,Clear,2.5,2022-10-11 12:00:00,12
194,321,515,43,21.0,0,Clear,4.9,2022-10-11 13:00:00,13
224,341,565,42,21.4,0,Clear,6.3,2022-10-11 14:00:00,14
273,438,711,42,21.6,0,Clear,7.3,2022-10-11 15:00:00,15
305,543,848,42,21.4,0,Clear,8.7,2022-10-11 16:00:00,16
551,927,1478,46,20.6,0,Clear,8.7,2022-10-11 17:00:00,17
427,921,1348,55,18.9,0,Clear,7.0,2022-10-11 18:00:00,18
267,623,890,61,16.8,0,Clear,8.4,2022-10-11 19:00:00,19
166,413,579,68,15.3,0,Clear,9.2,2022-10-11 20:00:00,20
131,294,425,73,14.2,0,Clear,10.0,2022-10-11 21:00:00,21
90,224,314,76,13.2,0,Clear,10.2,2022-10-11 22:00:00,22
62,95,157,80,12.4,0,Clear,9.7,2022-10-11 23:00:00,23
28,34,62,83,11.6,0,Clear,9.5,2022-10-12 00:00:00,0
12,8,20,85,10.9,0,Clear,8.8,2022-10-12 01:00:00,1
8,5,13,88,10.3,1,Mostly Clear,8.5,2022-10-12 02:00:00,2
4,8,12,90,9.9,1,Mostly Clear,8.2,2022-10-12 03:00:00,3
3,8,11,92,9.6,0,Clear,7.8,2022-10-12 04:00:00,4
26,69,95,94,9.3,1,Mostly Clear,7.8,2022-10-12 05:00:00,5
61,168,229,96,8.9,0,Clear,6.6,2022-10-12 06:00:00,6
150,493,643,97,8.7,0,Clear,6.6,2022-10-12 07:00:00,7
257,875,1132,97,9.0,0,Clear,8.5,2022-10-12 08:00:00,8
195,474,669,88,12.8,0,Clear,7.8,2022-10-12 09:00:00,9
137,244,381,78,15.2,0,Clear,8.9,2022-10-12 10:00:00,10
168,273,441,71,17.4,1,Mostly Clear,10.2,2022-10-12 11:00:00,11
181,365,546,65,19.1,1,Mostly Clear,12.4,2022-10-12 12:00:00,12
237,327,564,59,20.2,1,Mostly Clear,13.7,2022-10-12 13:00:00,13
261,345,606,57,20.8,1,Mostly Clear,13.7,2022-10-12 14:00:00,14
286,453,739,54,21.2,1,Mostly Clear,14.8,2022-10-12 15:00:00,15
366,572,938,55,21.2,1,Mostly Clear,15.3,2022-10-12 16:00:00,16
543,1062,1605,58,20.5,1,Mostly Clear,13.8,2022-10-12 17:00:00,17
511,972,1483,63,19.2,3,Cloudy,11.3,2022-10-12 18:00:00,18
278,593,871,67,18.2,3,Cloudy,11.5,2022-10-12 19:00:00,19
200,406,606,72,17.4,1,Mostly Clear,12.2,2022-10-12 20:00:00,20
163,304,467,76,16.7,2,Partly Cloudy,12.0,2022-10-12 21:00:00,21
147,228,375,80,16.4,2,Partly Cloudy,11.5,2022-10-12 22:00:00,22
96,124,220,81,16.3,3,Cloudy,12.6,2022-10-12 23:00:00,23
33,58,91,81,16.3,3,Cloudy,13.6,2022-10-13 00:00:00,0
14,13,27,81,16.2,2,Partly Cloudy,14.7,2022-10-13 01:00:00,1
10,12,22,78,16.3,2,Partly Cloudy,15.2,2022-10-13 02:00:00,2
6,4,10,86,16.2,1,Mostly Clear,15.3,2022-10-13 03:00:00,3
6,11,17,87,16.1,51,Light Drizzle,15.3,2022-10-13 04:00:00,4
7,39,46,91,15.8,61,Light Rain,15.2,2022-10-13 05:00:00,5
47,110,157,93,15.7,61,Light Rain,12.5,2022-10-13 06:00:00,6
38,195,233,94,15.7,55,Heavy Drizzle,14.8,2022-10-13 07:00:00,7
53,225,278,95,15.8,51,Light Drizzle,16.3,2022-10-13 08:00:00,8
56,183,239,95,16.3,51,Light Drizzle,15.2,2022-10-13 09:00:00,9
77,179,256,96,17.0,51,Light Drizzle,14.0,2022-10-13 10:00:00,10
41,141,182,91,18.3,53,Heavy Drizzle,14.5,2022-10-13 11:00:00,11
39,166,205,92,19.0,55,Heavy Drizzle,16.9,2022-10-13 12:00:00,12
86,239,325,93,19.5,61,Light Rain,14.4,2022-10-13 13:00:00,13
146,245,391,96,19.4,63,Rain,15.5,2022-10-13 14:00:00,14
197,334,531,83,20.7,2,Partly Cloudy,15.3,2022-10-13 15:00:00,15
232,434,666,83,20.9,1,Mostly Clear,12.6,2022-10-13 16:00:00,16
355,778,1133,84,21.0,51,Light Drizzle,7.5,2022-10-13 17:00:00,17
343,733,1076,90,19.9,53,Heavy Drizzle,1.8,2022-10-13 18:00:00,18
198,470,668,98,18.6,55,Heavy Drizzle,5.6,2022-10-13 19:00:00,19
77,196,273,98,17.8,61,Light Rain,11.2,2022-10-13 20:00:00,20
67,179,246,91,17.3,53,Heavy Drizzle,15.0,2022-10-13 21:00:00,21
65,148,213,80,16.4,51,Light Drizzle,16.8,2022-10-13 22:00:00,22
35,75,110,81,15.7,51,Light Drizzle,15.6,2022-10-13 23:00:00,23
28,66,94,82,15.4,3,Cloudy,12.7,2022-10-14 00:00:00,0
16,23,39,82,15.2,3,Cloudy,9.7,2022-10-14 01:00:00,1
10,12,22,76,14.9,2,Partly Cloudy,7.4,2022-10-14 02:00:00,2
6,12,18,88,13.5,2,Partly Cloudy,6.9,2022-10-14 03:00:00,3
9,17,26,89,13.1,1,Mostly Clear,5.6,2022-10-14 04:00:00,4
15,49,64,90,12.8,1,Mostly Clear,5.5,2022-10-14 05:00:00,5
56,158,214,89,12.7,2,Partly Cloudy,3.3,2022-10-14 06:00:00,6
101,322,423,89,12.8,2,Partly Cloudy,2.2,2022-10-14 07:00:00,7
168,558,726,91,13.0,2,Partly Cloudy,1.6,2022-10-14 08:00:00,8
191,431,622,90,13.3,1,Mostly Clear,2.1,2022-10-14 09:00:00,9
195,313,508,86,14.3,0,Clear,3.1,2022-10-14 10:00:00,10
281,330,611,66,15.8,1,Mostly Clear,4.0,2022-10-14 11:00:00,11
296,400,696,53,17.4,1,Mostly Clear,5.4,2022-10-14 12:00:00,12
337,393,730,47,18.3,1,Mostly Clear,6.5,2022-10-14 13:00:00,13
353,421,774,43,19.0,0,Clear,7.2,2022-10-14 14:00:00,14
374,527,901,44,19.2,0,Clear,8.0,2022-10-14 15:00:00,15
456,629,1085,43,19.1,0,Clear,8.3,2022-10-14 16:00:00,16
535,835,1370,46,18.4,0,Clear,8.9,2022-10-14 17:00:00,17
500,740,1240,51,17.3,0,Clear,9.5,2022-10-14 18:00:00,18
338,583,921,55,15.7,0,Clear,10.0,2022-10-14 19:00:00,19
246,354,600,57,14.7,0,Clear,9.4,2022-10-14 20:00:00,20
178,298,476,60,13.8,0,Clear,8.2,2022-10-14 21:00:00,21
155,229,384,62,13.0,0,Clear,7.7,2022-10-14 22:00:00,22
131,195,326,65,12.1,0,Clear,8.1,2022-10-14 23:00:00,23
81,121,202,70,11.3,0,Clear,8.0,2022-10-15 00:00:00,0
81,91,172,75,10.5,0,Clear,8.0,2022-10-15 01:00:00,1
58,60,118,79,10.0,0,Clear,7.4,2022-10-15 02:00:00,2
29,26,55,85,9.7,0,Clear,6.6,2022-10-15 03:00:00,3
12,9,21,87,9.4,0,Clear,7.3,2022-10-15 04:00:00,4
15,19,34,88,9.1,0,Clear,7.6,2022-10-15 05:00:00,5
29,47,76,88,8.9,0,Clear,6.2,2022-10-15 06:00:00,6
71,123,194,88,8.8,0,Clear,6.5,2022-10-15 07:00:00,7
157,248,405,86,9.4,0,Clear,9.7,2022-10-15 08:00:00,8
262,336,598,78,12.3,0,Clear,9.4,2022-10-15 09:00:00,9
434,407,841,66,15.4,0,Clear,10.2,2022-10-15 10:00:00,10
515,479,994,57,17.8,0,Clear,12.6,2022-10-15 11:00:00,11
637,528,1165,51,19.8,0,Clear,15.2,2022-10-15 12:00:00,12
719,494,1213,47,21.2,0,Clear,16.9,2022-10-15 13:00:00,13
756,555,1311,45,22.1,0,Clear,17.2,2022-10-15 14:00:00,14
803,579,1382,43,22.7,0,Clear,17.0,2022-10-15 15:00:00,15
672,502,1174,42,23.1,0,Clear,14.6,2022-10-15 16:00:00,16
651,554,1205,48,22.5,0,Clear,8.9,2022-10-15 17:00:00,17
441,492,933,54,20.6,0,Clear,8.6,2022-10-15 18:00:00,18
310,362,672,59,18.6,0,Clear,9.4,2022-10-15 19:00:00,19
190,262,452,61,17.6,0,Clear,9.9,2022-10-15 20:00:00,20
168,228,396,65,16.5,0,Clear,9.7,2022-10-15 21:00:00,21
174,219,393,73,15.0,0,Clear,6.9,2022-10-15 22:00:00,22
186,204,390,81,13.8,0,Clear,6.6,2022-10-15 23:00:00,23
121,113,234,81,13.3,0,Clear,6.6,2022-10-16 00:00:00,0
102,100,202,85,12.0,0,Clear,7.9,2022-10-16 01:00:00,1
59,57,116,84,11.4,0,Clear,9.4,2022-10-16 02:00:00,2
44,30,74,82,11.3,1,Mostly Clear,9.4,2022-10-16 03:00:00,3
9,20,29,79,11.0,0,Clear,9.7,2022-10-16 04:00:00,4
10,17,27,78,10.7,1,Mostly Clear,9.0,2022-10-16 05:00:00,5
18,38,56,79,10.4,1,Mostly Clear,7.9,2022-10-16 06:00:00,6
44,62,106,81,10.4,1,Mostly Clear,7.6,2022-10-16 07:00:00,7
122,187,309,84,10.2,1,Mostly Clear,8.2,2022-10-16 08:00:00,8
220,304,524,70,13.0,1,Mostly Clear,7.4,2022-10-16 09:00:00,9
402,422,824,61,15.0,2,Partly Cloudy,5.0,2022-10-16 10:00:00,10
487,454,941,51,16.8,0,Clear,2.9,2022-10-16 11:00:00,11
545,474,1019,44,18.3,0,Clear,2.0,2022-10-16 12:00:00,12
612,547,1159,42,19.5,0,Clear,1.3,2022-10-16 13:00:00,13
580,556,1136,43,20.3,1,Mostly Clear,4.7,2022-10-16 14:00:00,14
569,515,1084,46,20.8,1,Mostly Clear,6.0,2022-10-16 15:00:00,15
539,519,1058,47,20.8,1,Mostly Clear,6.8,2022-10-16 16:00:00,16
476,433,909,53,19.8,3,Cloudy,8.8,2022-10-16 17:00:00,17
320,402,722,58,18.3,3,Cloudy,11.2,2022-10-16 18:00:00,18
209,303,512,61,17.2,3,Cloudy,11.0,2022-10-16 19:00:00,19
134,222,356,62,16.6,3,Cloudy,11.0,2022-10-16 20:00:00,20
99,185,284,67,16.3,3,Cloudy,10.5,2022-10-16 21:00:00,21
74,121,195,73,16.2,3,Cloudy,11.9,2022-10-16 22:00:00,22
50,65,115,77,16.1,51,Light Drizzle,12.6,2022-10-16 23:00:00,23
17,32,49,82,15.6,51,Light Drizzle,14.2,2022-10-17 00:00:00,0
9,11,20,86,14.9,51,Light Drizzle,13.4,2022-10-17 01:00:00,1
3,9,12,89,14.4,2,Partly Cloudy,12.8,2022-10-17 02:00:00,2
4,7,11,93,14.4,1,Mostly Clear,12.6,2022-10-17 03:00:00,3
6,9,15,94,14.2,1,Mostly Clear,12.1,2022-10-17 04:00:00,4
26,60,86,96,14.1,1,Mostly Clear,11.2,2022-10-17 05:00:00,5
52,163,215,97,13.9,3,Cloudy,4.3,2022-10-17 06:00:00,6
116,401,517,97,13.6,3,Cloudy,8.0,2022-10-17 07:00:00,7
182,633,815,96,13.7,3,Cloudy,8.8,2022-10-17 08:00:00,8
154,405,559,92,15.1,2,Partly Cloudy,11.7,2022-10-17 09:00:00,9
185,232,417,86,16.7,2,Partly Cloudy,14.0,2022-10-17 10:00:00,10
180,291,471,81,17.8,1,Mostly Clear,13.0,2022-10-17 11:00:00,11
211,323,534,75,18.8,1,Mostly Clear,12.3,2022-10-17 12:00:00,12
208,368,576,71,19.6,2,Partly Cloudy,14.3,2022-10-17 13:00:00,13
275,331,606,69,19.9,2,Partly Cloudy,15.0,2022-10-17 14:00:00,14
261,440,701,58,20.4,2,Partly Cloudy,14.8,2022-10-17 15:00:00,15
295,500,795,59,20.4,2,Partly Cloudy,13.0,2022-10-17 16:00:00,16
371,853,1224,68,18.6,53,Heavy Drizzle,9.7,2022-10-17 17:00:00,17
356,823,1179,78,17.0,51,Light Drizzle,4.8,2022-10-17 18:00:00,18
221,471,692,80,16.0,51,Light Drizzle,5.6,2022-10-17 19:00:00,19
124,342,466,78,15.1,1,Mostly Clear,9.7,2022-10-17 20:00:00,20
120,258,378,67,13.8,0,Clear,14.7,2022-10-17 21:00:00,21
107,147,254,57,12.5,0,Clear,17.1,2022-10-17 22:00:00,22
52,84,136,48,12.0,0,Clear,16.7,2022-10-17 23:00:00,23
9,27,36,43,11.2,1,Mostly Clear,15.6,2022-10-18 00:00:00,0
3,8,11,39,10.7,0,Clear,13.0,2022-10-18 01:00:00,1
3,3,6,37,10.2,0,Clear,10.8,2022-10-18 02:00:00,2
1,10,11,40,9.5,0,Clear,10.5,2022-10-18 03:00:00,3
2,14,16,41,8.7,0,Clear,11.1,2022-10-18 04:00:00,4
22,60,82,42,8.0,0,Clear,10.5,2022-10-18 05:00:00,5
53,162,215,45,7.2,0,Clear,10.5,2022-10-18 06:00:00,6
126,448,574,55,6.2,0,Clear,9.7,2022-10-18 07:00:00,7
196,851,1047,67,5.5,0,Clear,10.5,2022-10-18 08:00:00,8
153,364,517,50,7.7,0,Clear,12.8,2022-10-18 09:00:00,9
129,223,352,49,8.6,0,Clear,13.1,2022-10-18 10:00:00,10
141,240,381,49,9.7,0,Clear,12.2,2022-10-18 11:00:00,11
192,298,490,48,10.8,0,Clear,11.8,2022-10-18 12:00:00,12
175,292,467,43,12.1,1,Mostly Clear,11.7,2022-10-18 13:00:00,13
160,297,457,38,13.2,2,Partly Cloudy,13.1,2022-10-18 14:00:00,14
219,358,577,40,12.5,2,Partly Cloudy,13.8,2022-10-18 15:00:00,15
282,542,824,38,12.4,2,Partly Cloudy,13.8,2022-10-18 16:00:00,16
376,919,1295,38,12.2,2,Partly Cloudy,13.0,2022-10-18 17:00:00,17
325,797,1122,41,11.5,0,Clear,14.0,2022-10-18 18:00:00,18
161,509,670,44,10.4,0,Clear,12.3,2022-10-18 19:00:00,19
139,331,470,46,9.4,0,Clear,12.1,2022-10-18 20:00:00,20
102,239,341,46,8.7,0,Clear,12.2,2022-10-18 21:00:00,21
86,175,261,49,8.2,0,Clear,11.2,2022-10-18 22:00:00,22
47,79,126,53,7.6,0,Clear,8.7,2022-10-18 23:00:00,23
21,33,54,58,6.9,0,Clear,6.8,2022-10-19 00:00:00,0
6,10,16,63,6.3,0,Clear,7.6,2022-10-19 01:00:00,1
3,9,12,67,5.7,0,Clear,8.3,2022-10-19 02:00:00,2
2,7,9,71,4.8,0,Clear,8.2,2022-10-19 03:00:00,3
7,11,18,75,4.4,0,Clear,8.2,2022-10-19 04:00:00,4
16,46,62,78,4.0,0,Clear,8.2,2022-10-19 05:00:00,5
41,153,194,80,3.7,0,Clear,7.5,2022-10-19 06:00:00,6
130,419,549,82,3.6,0,Clear,8.1,2022-10-19 07:00:00,7
222,780,1002,81,4.1,1,Mostly Clear,10.0,2022-10-19 08:00:00,8
141,443,584,72,6.3,0,Clear,10.2,2022-10-19 09:00:00,9
133,246,379,61,8.2,0,Clear,11.5,2022-10-19 10:00:00,10
138,247,385,54,9.6,0,Clear,14.7,2022-10-19 11:00:00,11
149,304,453,47,11.2,3,Cloudy,17.9,2022-10-19 12:00:00,12
184,306,490,43,11.9,3,Cloudy,18.8,2022-10-19 13:00:00,13
166,313,479,42,11.9,2,Partly Cloudy,16.9,2022-10-19 14:00:00,14
228,386,614,40,12.4,2,Partly Cloudy,17.7,2022-10-19 15:00:00,15
292,579,871,40,12.6,2,Partly Cloudy,17.2,2022-10-19 16:00:00,16
436,956,1392,43,12.3,2,Partly Cloudy,15.5,2022-10-19 17:00:00,17
342,808,1150,45,11.7,0,Clear,11.9,2022-10-19 18:00:00,18
229,517,746,48,10.5,0,Clear,11.2,2022-10-19 19:00:00,19
145,345,490,54,9.3,0,Clear,10.1,2022-10-19 20:00:00,20
102,251,353,60,8.2,0,Clear,9.9,2022-10-19 21:00:00,21
90,183,273,69,7.0,0,Clear,9.3,2022-10-19 22:00:00,22
56,101,157,75,6.0,0,Clear,8.8,2022-10-19 23:00:00,23
33,49,82,78,5.4,0,Clear,7.4,2022-10-20 00:00:00,0
9,15,24,80,4.9,0,Clear,8.2,2022-10-20 01:00:00,1
6,10,16,81,4.5,0,Clear,8.4,2022-10-20 02:00:00,2
2,9,11,82,3.9,0,Clear,7.9,2022-10-20 03:00:00,3
3,9,12,85,3.5,0,Clear,8.0,2022-10-20 04:00:00,4
16,49,65,87,3.2,0,Clear,8.0,2022-10-20 05:00:00,5
46,142,188,88,2.9,0,Clear,8.4,2022-10-20 06:00:00,6
116,376,492,89,2.5,0,Clear,9.3,2022-10-20 07:00:00,7
205,714,919,90,2.7,0,Clear,10.0,2022-10-20 08:00:00,8
150,445,595,78,6.5,0,Clear,9.1,2022-10-20 09:00:00,9
141,283,424,64,9.6,0,Clear,9.4,2022-10-20 10:00:00,10
159,273,432,52,11.8,0,Clear,11.9,2022-10-20 11:00:00,11
205,368,573,41,13.2,0,Clear,13.2,2022-10-20 12:00:00,12
239,332,571,36,14.1,0,Clear,13.9,2022-10-20 13:00:00,13
224,337,561,34,14.8,0,Clear,15.0,2022-10-20 14:00:00,14
258,420,678,32,15.3,0,Clear,16.3,2022-10-20 15:00:00,15
356,573,929,30,15.4,0,Clear,16.4,2022-10-20 16:00:00,16
499,940,1439,33,14.9,0,Clear,12.7,2022-10-20 17:00:00,17
399,807,1206,38,13.3,0,Clear,9.6,2022-10-20 18:00:00,18
247,530,777,44,11.6,0,Clear,9.7,2022-10-20 19:00:00,19
191,343,534,50,10.6,0,Clear,11.2,2022-10-20 20:00:00,20
145,292,437,55,9.9,0,Clear,11.1,2022-10-20 21:00:00,21
113,220,333,60,9.3,0,Clear,10.2,2022-10-20 22:00:00,22
80,119,199,66,8.5,0,Clear,9.2,2022-10-20 23:00:00,23
43,61,104,75,7.4,0,Clear,7.7,2022-10-21 00:00:00,0
23,40,63,81,6.6,0,Clear,7.9,2022-10-21 01:00:00,1
13,11,24,71,8.0,0,Clear,7.2,2022-10-21 02:00:00,2
5,8,13,83,6.0,0,Clear,7.2,2022-10-21 03:00:00,3
3,11,14,81,6.2,0,Clear,7.2,2022-10-21 04:00:00,4
14,38,52,81,6.4,0,Clear,7.4,2022-10-21 05:00:00,5
40,137,177,83,6.0,0,Clear,6.3,2022-10-21 06:00:00,6
91,314,405,83,5.8,0,Clear,6.8,2022-10-21 07:00:00,7
168,508,676,81,6.3,0,Clear,5.7,2022-10-21 08:00:00,8
195,366,561,86,7.3,0,Clear,2.5,2022-10-21 09:00:00,9
230,308,538,58,11.9,0,Clear,1.5,2022-10-21 10:00:00,10
266,305,571,46,14.4,0,Clear,1.9,2022-10-21 11:00:00,11
268,362,630,37,16.0,0,Clear,2.5,2022-10-21 12:00:00,12
289,408,697,34,16.9,0,Clear,3.1,2022-10-21 13:00:00,13
315,360,675,34,17.5,0,Clear,4.4,2022-10-21 14:00:00,14
367,503,870,33,17.7,0,Clear,5.6,2022-10-21 15:00:00,15
422,620,1042,34,17.5,0,Clear,6.9,2022-10-21 16:00:00,16
596,816,1412,39,16.7,0,Clear,7.3,2022-10-21 17:00:00,17
417,666,1083,48,15.2,0,Clear,7.1,2022-10-21 18:00:00,18
313,445,758,57,13.2,0,Clear,8.5,2022-10-21 19:00:00,19
200,286,486,65,11.8,0,Clear,9.7,2022-10-21 20:00:00,20
180,225,405,74,10.8,0,Clear,9.7,2022-10-21 21:00:00,21
131,217,348,81,10.0,0,Clear,10.0,2022-10-21 22:00:00,22
169,215,384,84,9.3,0,Clear,9.8,2022-10-21 23:00:00,23
104,147,251,87,8.7,0,Clear,9.0,2022-10-22 00:00:00,0
73,104,177,89,8.0,0,Clear,8.0,2022-10-22 01:00:00,1
78,54,132,91,7.4,0,Clear,7.3,2022-10-22 02:00:00,2
26,29,55,91,6.9,0,Clear,7.2,2022-10-22 03:00:00,3
5,19,24,92,6.6,0,Clear,7.2,2022-10-22 04:00:00,4
14,26,40,92,6.6,0,Clear,8.2,2022-10-22 05:00:00,5
28,41,69,91,7.1,0,Clear,7.0,2022-10-22 06:00:00,6
57,100,157,92,7.5,0,Clear,4.7,2022-10-22 07:00:00,7
135,205,340,94,7.1,0,Clear,3.3,2022-10-22 08:00:00,8
262,324,586,92,9.1,0,Clear,2.0,2022-10-22 09:00:00,9
419,394,813,75,13.0,0,Clear,3.3,2022-10-22 10:00:00,10
584,463,1047,64,15.4,0,Clear,3.7,2022-10-22 11:00:00,11
687,521,1208,55,17.4,0,Clear,4.5,2022-10-22 12:00:00,12
643,500,1143,48,18.7,0,Clear,4.3,2022-10-22 13:00:00,13
745,572,1317,44,19.3,0,Clear,5.6,2022-10-22 14:00:00,14
676,523,1199,44,19.7,0,Clear,7.6,2022-10-22 15:00:00,15
660,564,1224,45,19.4,0,Clear,7.7,2022-10-22 16:00:00,16
590,538,1128,51,18.5,0,Clear,8.2,2022-10-22 17:00:00,17
562,481,1043,60,16.6,1,Mostly Clear,7.1,2022-10-22 18:00:00,18
353,397,750,69,14.8,1,Mostly Clear,7.4,2022-10-22 19:00:00,19
236,262,498,77,13.4,1,Mostly Clear,6.6,2022-10-22 20:00:00,20
187,217,404,84,12.1,1,Mostly Clear,8.3,2022-10-22 21:00:00,21
182,201,383,86,11.4,1,Mostly Clear,7.0,2022-10-22 22:00:00,22
185,196,381,88,10.8,1,Mostly Clear,8.3,2022-10-22 23:00:00,23
175,138,313,90,10.1,1,Mostly Clear,7.1,2022-10-23 00:00:00,0
136,99,235,92,9.4,0,Clear,6.7,2022-10-23 01:00:00,1
88,66,154,92,8.9,0,Clear,7.6,2022-10-23 02:00:00,2
43,26,69,91,8.2,0,Clear,7.3,2022-10-23 03:00:00,3
16,10,26,91,7.8,0,Clear,7.9,2022-10-23 04:00:00,4
9,15,24,90,8.3,2,Partly Cloudy,9.7,2022-10-23 05:00:00,5
24,27,51,86,8.9,2,Partly Cloudy,9.5,2022-10-23 06:00:00,6
43,58,101,80,9.8,3,Cloudy,10.4,2022-10-23 07:00:00,7
98,142,240,75,10.6,3,Cloudy,11.5,2022-10-23 08:00:00,8
201,272,473,71,11.9,3,Cloudy,13.0,2022-10-23 09:00:00,9
359,387,746,74,12.4,51,Light Drizzle,12.0,2022-10-23 10:00:00,10
353,379,732,77,12.9,51,Light Drizzle,10.7,2022-10-23 11:00:00,11
409,470,879,77,13.8,2,Partly Cloudy,10.6,2022-10-23 12:00:00,12
501,432,933,73,15.3,1,Mostly Clear,10.9,2022-10-23 13:00:00,13
459,491,950,71,16.6,2,Partly Cloudy,12.1,2022-10-23 14:00:00,14
432,453,885,67,18.1,3,Cloudy,11.0,2022-10-23 15:00:00,15
403,477,880,70,17.6,3,Cloudy,9.1,2022-10-23 16:00:00,16
374,379,753,76,16.9,53,Heavy Drizzle,9.4,2022-10-23 17:00:00,17
129,214,343,82,15.8,61,Light Rain,9.6,2022-10-23 18:00:00,18
50,110,160,87,15.1,53,Heavy Drizzle,11.3,2022-10-23 19:00:00,19
35,83,118,91,14.5,51,Light Drizzle,11.8,2022-10-23 20:00:00,20
31,79,110,92,13.9,61,Light Rain,11.0,2022-10-23 21:00:00,21
38,83,121,93,13.6,53,Heavy Drizzle,10.9,2022-10-23 22:00:00,22
44,62,106,94,13.3,53,Heavy Drizzle,11.1,2022-10-23 23:00:00,23
15,16,31,94,13.1,51,Light Drizzle,9.3,2022-10-24 00:00:00,0
2,13,15,95,12.9,51,Light Drizzle,8.6,2022-10-24 01:00:00,1
7,12,19,95,12.8,51,Light Drizzle,9.9,2022-10-24 02:00:00,2
3,5,8,96,12.6,51,Light Drizzle,10.6,2022-10-24 03:00:00,3
7,9,16,96,12.6,51,Light Drizzle,10.5,2022-10-24 04:00:00,4
14,63,77,96,12.5,3,Cloudy,10.6,2022-10-24 05:00:00,5
51,153,204,96,12.5,3,Cloudy,7.9,2022-10-24 06:00:00,6
101,347,448,95,12.6,3,Cloudy,7.9,2022-10-24 07:00:00,7
169,580,749,95,12.8,3,Cloudy,7.4,2022-10-24 08:00:00,8
138,354,492,95,13.1,2,Partly Cloudy,8.2,2022-10-24 09:00:00,9
153,223,376,90,13.9,3,Cloudy,8.8,2022-10-24 10:00:00,10
209,260,469,90,14.3,3,Cloudy,10.6,2022-10-24 11:00:00,11
191,314,505,88,14.9,3,Cloudy,9.4,2022-10-24 12:00:00,12
203,308,511,88,15.0,3,Cloudy,8.3,2022-10-24 13:00:00,13
204,293,497,87,15.3,3,Cloudy,8.0,2022-10-24 14:00:00,14
233,411,644,81,17.0,3,Cloudy,7.6,2022-10-24 15:00:00,15
263,487,750,81,17.1,3,Cloudy,8.6,2022-10-24 16:00:00,16
392,800,1192,82,16.9,3,Cloudy,7.1,2022-10-24 17:00:00,17
333,696,1029,85,16.2,3,Cloudy,4.3,2022-10-24 18:00:00,18
200,487,687,88,15.8,3,Cloudy,4.0,2022-10-24 19:00:00,19
133,332,465,89,15.6,3,Cloudy,3.3,2022-10-24 20:00:00,20
119,230,349,90,15.4,3,Cloudy,3.6,2022-10-24 21:00:00,21
104,178,282,91,15.2,3,Cloudy,3.5,2022-10-24 22:00:00,22
58,77,135,92,15.0,3,Cloudy,3.7,2022-10-24 23:00:00,23
15,45,60,94,14.8,3,Cloudy,2.5,2022-10-25 00:00:00,0
9,17,26,95,14.7,3,Cloudy,0.8,2022-10-25 01:00:00,1
7,7,14,96,14.5,3,Cloudy,3.7,2022-10-25 02:00:00,2
1,7,8,97,14.6,3,Cloudy,4.1,2022-10-25 03:00:00,3
3,17,20,97,14.5,3,Cloudy,2.9,2022-10-25 04:00:00,4
20,57,77,97,14.5,3,Cloudy,1.8,2022-10-25 05:00:00,5
56,184,240,97,14.5,3,Cloudy,1.1,2022-10-25 06:00:00,6
123,468,591,97,14.5,51,Light Drizzle,1.1,2022-10-25 07:00:00,7
235,801,1036,98,14.4,3,Cloudy,2.5,2022-10-25 08:00:00,8
157,461,618,94,15.3,3,Cloudy,2.7,2022-10-25 09:00:00,9
142,222,364,87,16.8,3,Cloudy,2.6,2022-10-25 10:00:00,10
121,273,394,84,17.5,51,Light Drizzle,2.3,2022-10-25 11:00:00,11
156,306,462,80,18.7,3,Cloudy,2.3,2022-10-25 12:00:00,12
177,313,490,77,19.3,3,Cloudy,2.9,2022-10-25 13:00:00,13
206,305,511,72,20.0,3,Cloudy,2.8,2022-10-25 14:00:00,14
252,423,675,82,18.2,3,Cloudy,4.1,2022-10-25 15:00:00,15
286,589,875,81,18.4,3,Cloudy,6.9,2022-10-25 16:00:00,16
382,959,1341,82,18.1,3,Cloudy,7.7,2022-10-25 17:00:00,17
368,794,1162,85,17.5,3,Cloudy,6.7,2022-10-25 18:00:00,18
228,517,745,89,16.7,51,Light Drizzle,6.3,2022-10-25 19:00:00,19
156,339,495,91,16.2,3,Cloudy,6.0,2022-10-25 20:00:00,20
162,330,492,93,15.8,3,Cloudy,6.1,2022-10-25 21:00:00,21
117,226,343,95,15.4,3,Cloudy,5.6,2022-10-25 22:00:00,22
63,86,149,96,15.2,2,Partly Cloudy,6.4,2022-10-25 23:00:00,23
29,45,74,97,14.9,2,Partly Cloudy,5.6,2022-10-26 00:00:00,0
7,17,24,97,14.7,3,Cloudy,4.7,2022-10-26 01:00:00,1
8,7,15,97,14.6,3,Cloudy,4.9,2022-10-26 02:00:00,2
4,6,10,96,14.7,3,Cloudy,5.9,2022-10-26 03:00:00,3
6,10,16,95,14.8,3,Cloudy,6.0,2022-10-26 04:00:00,4
19,67,86,95,14.8,51,Light Drizzle,5.4,2022-10-26 05:00:00,5
51,210,261,96,14.8,51,Light Drizzle,3.1,2022-10-26 06:00:00,6
118,452,570,97,14.7,51,Light Drizzle,3.0,2022-10-26 07:00:00,7
230,780,1010,97,14.7,3,Cloudy,2.0,2022-10-26 08:00:00,8
141,445,586,96,14.8,3,Cloudy,4.6,2022-10-26 09:00:00,9
157,233,390,94,15.4,3,Cloudy,4.9,2022-10-26 10:00:00,10
131,278,409,91,15.9,3,Cloudy,7.0,2022-10-26 11:00:00,11
161,278,439,84,16.9,3,Cloudy,9.7,2022-10-26 12:00:00,12
158,332,490,78,18.0,3,Cloudy,12.5,2022-10-26 13:00:00,13
216,340,556,74,18.4,3,Cloudy,13.7,2022-10-26 14:00:00,14
260,431,691,71,18.8,3,Cloudy,15.1,2022-10-26 15:00:00,15
304,572,876,72,19.2,3,Cloudy,10.5,2022-10-26 16:00:00,16
420,995,1415,74,19.0,3,Cloudy,8.4,2022-10-26 17:00:00,17
427,928,1355,77,18.5,3,Cloudy,5.6,2022-10-26 18:00:00,18
284,543,827,81,17.8,3,Cloudy,6.2,2022-10-26 19:00:00,19
190,389,579,83,17.4,51,Light Drizzle,7.6,2022-10-26 20:00:00,20
147,288,435,80,17.1,3,Cloudy,12.1,2022-10-26 21:00:00,21
105,215,320,68,16.5,3,Cloudy,15.8,2022-10-26 22:00:00,22
73,100,173,65,15.9,0,Clear,16.1,2022-10-26 23:00:00,23
24,41,65,68,15.2,0,Clear,15.8,2022-10-27 00:00:00,0
18,14,32,70,14.5,0,Clear,15.4,2022-10-27 01:00:00,1
8,8,16,72,13.8,0,Clear,15.6,2022-10-27 02:00:00,2
4,7,11,73,13.1,0,Clear,15.0,2022-10-27 03:00:00,3
4,12,16,73,12.6,1,Mostly Clear,15.0,2022-10-27 04:00:00,4
25,60,85,73,12.3,2,Partly Cloudy,14.7,2022-10-27 05:00:00,5
39,179,218,71,12.4,3,Cloudy,14.5,2022-10-27 06:00:00,6
123,456,579,68,12.5,3,Cloudy,14.5,2022-10-27 07:00:00,7
245,782,1027,67,12.5,2,Partly Cloudy,14.7,2022-10-27 08:00:00,8
196,419,615,65,12.8,1,Mostly Clear,14.7,2022-10-27 09:00:00,9
156,270,426,61,13.2,1,Mostly Clear,17.7,2022-10-27 10:00:00,10
186,308,494,56,14.1,0,Clear,16.9,2022-10-27 11:00:00,11
186,374,560,51,15.2,0,Clear,15.7,2022-10-27 12:00:00,12
211,342,553,47,16.1,0,Clear,14.1,2022-10-27 13:00:00,13
260,308,568,44,16.8,0,Clear,13.3,2022-10-27 14:00:00,14
312,460,772,43,17.6,0,Clear,13.3,2022-10-27 15:00:00,15
359,586,945,42,17.6,0,Clear,13.7,2022-10-27 16:00:00,16
494,908,1402,44,17.0,0,Clear,12.6,2022-10-27 17:00:00,17
449,834,1283,47,15.5,0,Clear,8.3,2022-10-27 18:00:00,18
248,554,802,50,14.1,0,Clear,8.6,2022-10-27 19:00:00,19
184,387,571,53,13.0,0,Clear,10.2,2022-10-27 20:00:00,20
139,318,457,55,12.3,0,Clear,11.4,2022-10-27 21:00:00,21
118,225,343,56,11.7,0,Clear,12.3,2022-10-27 22:00:00,22
113,161,274,57,11.1,0,Clear,12.4,2022-10-27 23:00:00,23
49,56,105,59,10.6,0,Clear,12.5,2022-10-28 00:00:00,0
31,29,60,60,10.0,0,Clear,12.5,2022-10-28 01:00:00,1
16,19,35,61,9.5,0,Clear,13.1,2022-10-28 02:00:00,2
12,12,24,58,9.1,0,Clear,13.4,2022-10-28 03:00:00,3
6,12,18,59,8.7,0,Clear,13.4,2022-10-28 04:00:00,4
18,60,78,59,8.4,0,Clear,13.4,2022-10-28 05:00:00,5
45,129,174,60,8.1,1,Mostly Clear,12.3,2022-10-28 06:00:00,6
80,333,413,61,7.9,1,Mostly Clear,12.2,2022-10-28 07:00:00,7
170,518,688,64,7.8,1,Mostly Clear,12.0,2022-10-28 08:00:00,8
192,379,571,63,9.0,1,Mostly Clear,11.8,2022-10-28 09:00:00,9
161,258,419,57,10.7,2,Partly Cloudy,13.5,2022-10-28 10:00:00,10
201,288,489,56,12.1,2,Partly Cloudy,12.8,2022-10-28 11:00:00,11
278,376,654,57,13.2,2,Partly Cloudy,12.1,2022-10-28 12:00:00,12
270,424,694,57,14.2,2,Partly Cloudy,12.0,2022-10-28 13:00:00,13
292,412,704,58,14.8,1,Mostly Clear,11.8,2022-10-28 14:00:00,14
349,472,821,62,14.7,1,Mostly Clear,11.8,2022-10-28 15:00:00,15
365,591,956,61,14.7,1,Mostly Clear,11.9,2022-10-28 16:00:00,16
436,737,1173,62,14.3,1,Mostly Clear,11.4,2022-10-28 17:00:00,17
352,626,978,64,13.6,2,Partly Cloudy,8.2,2022-10-28 18:00:00,18
240,441,681,67,13.0,2,Partly Cloudy,8.4,2022-10-28 19:00:00,19
177,277,454,69,12.6,2,Partly Cloudy,8.3,2022-10-28 20:00:00,20
124,225,349,73,12.0,1,Mostly Clear,8.8,2022-10-28 21:00:00,21
133,189,322,74,11.9,2,Partly Cloudy,8.9,2022-10-28 22:00:00,22
144,189,333,78,11.3,2,Partly Cloudy,8.9,2022-10-28 23:00:00,23
108,160,268,80,11.0,2,Partly Cloudy,9.1,2022-10-29 00:00:00,0
111,127,238,80,10.9,2,Partly Cloudy,9.2,2022-10-29 01:00:00,1
75,78,153,82,10.5,2,Partly Cloudy,9.2,2022-10-29 02:00:00,2
35,24,59,80,10.1,2,Partly Cloudy,9.3,2022-10-29 03:00:00,3
8,11,19,79,10.0,3,Cloudy,9.3,2022-10-29 04:00:00,4
5,19,24,80,9.8,3,Cloudy,9.7,2022-10-29 05:00:00,5
17,37,54,81,9.7,2,Partly Cloudy,9.7,2022-10-29 06:00:00,6
38,103,141,80,9.9,2,Partly Cloudy,9.7,2022-10-29 07:00:00,7
81,194,275,81,10.0,2,Partly Cloudy,9.8,2022-10-29 08:00:00,8
197,304,501,77,10.9,2,Partly Cloudy,9.8,2022-10-29 09:00:00,9
379,385,764,72,12.1,1,Mostly Clear,10.5,2022-10-29 10:00:00,10
461,465,926,66,13.0,1,Mostly Clear,9.5,2022-10-29 11:00:00,11
513,457,970,61,13.8,0,Clear,8.1,2022-10-29 12:00:00,12
621,521,1142,58,14.4,0,Clear,7.6,2022-10-29 13:00:00,13
630,475,1105,55,14.9,0,Clear,8.4,2022-10-29 14:00:00,14
624,562,1186,47,15.6,0,Clear,8.2,2022-10-29 15:00:00,15
621,550,1171,46,15.6,0,Clear,8.3,2022-10-29 16:00:00,16
462,455,917,47,14.9,0,Clear,7.9,2022-10-29 17:00:00,17
319,402,721,53,13.6,0,Clear,5.6,2022-10-29 18:00:00,18
214,355,569,61,11.9,0,Clear,5.8,2022-10-29 19:00:00,19
187,281,468,72,10.1,0,Clear,6.6,2022-10-29 20:00:00,20
155,195,350,74,9.2,0,Clear,7.6,2022-10-29 21:00:00,21
157,186,343,71,9.5,0,Clear,7.2,2022-10-29 22:00:00,22
182,181,363,65,10.8,0,Clear,5.0,2022-10-29 23:00:00,23
167,176,343,67,10.4,0,Clear,3.2,2022-10-30 00:00:00,0
132,143,275,72,9.5,0,Clear,4.6,2022-10-30 01:00:00,1
107,102,209,85,6.7,0,Clear,6.4,2022-10-30 02:00:00,2
39,42,81,89,5.6,0,Clear,7.0,2022-10-30 03:00:00,3
15,16,31,92,5.0,0,Clear,6.4,2022-10-30 04:00:00,4
19,28,47,93,4.9,0,Clear,6.0,2022-10-30 05:00:00,5
43,48,91,93,5.2,1,Mostly Clear,3.8,2022-10-30 06:00:00,6
77,68,145,93,5.6,1,Mostly Clear,5.0,2022-10-30 07:00:00,7
164,140,304,92,6.3,1,Mostly Clear,5.4,2022-10-30 08:00:00,8
269,250,519,86,8.7,1,Mostly Clear,4.7,2022-10-30 09:00:00,9
462,390,852,76,11.2,1,Mostly Clear,2.5,2022-10-30 10:00:00,10
429,392,821,70,13.1,2,Partly Cloudy,1.3,2022-10-30 11:00:00,11
518,497,1015,64,13.8,2,Partly Cloudy,2.1,2022-10-30 12:00:00,12
531,466,997,60,14.8,1,Mostly Clear,5.2,2022-10-30 13:00:00,13
557,456,1013,59,15.5,1,Mostly Clear,6.6,2022-10-30 14:00:00,14
491,542,1033,60,15.9,0,Clear,7.1,2022-10-30 15:00:00,15
475,513,988,60,15.8,1,Mostly Clear,7.5,2022-10-30 16:00:00,16
386,462,848,62,15.3,1,Mostly Clear,6.8,2022-10-30 17:00:00,17
266,394,660,68,14.3,1,Mostly Clear,6.6,2022-10-30 18:00:00,18
178,291,469,75,13.1,1,Mostly Clear,7.5,2022-10-30 19:00:00,19
110,202,312,79,12.4,1,Mostly Clear,6.4,2022-10-30 20:00:00,20
91,144,235,82,11.9,1,Mostly Clear,5.5,2022-10-30 21:00:00,21
63,137,200,85,11.2,0,Clear,6.8,2022-10-30 22:00:00,22
44,52,96,88,10.5,1,Mostly Clear,6.9,2022-10-30 23:00:00,23
24,26,50,90,10.2,1,Mostly Clear,6.6,2022-10-31 00:00:00,0
12,12,24,90,10.3,1,Mostly Clear,6.0,2022-10-31 01:00:00,1
12,6,18,92,10.4,2,Partly Cloudy,7.0,2022-10-31 02:00:00,2
3,3,6,94,10.2,3,Cloudy,7.6,2022-10-31 03:00:00,3
9,7,16,95,10.5,2,Partly Cloudy,7.6,2022-10-31 04:00:00,4
20,63,83,95,10.7,1,Mostly Clear,7.5,2022-10-31 05:00:00,5
55,143,198,96,10.5,1,Mostly Clear,6.3,2022-10-31 06:00:00,6
75,359,434,97,10.6,3,Cloudy,6.5,2022-10-31 07:00:00,7
144,575,719,98,10.6,3,Cloudy,7.0,2022-10-31 08:00:00,8
137,355,492,94,12.3,3,Cloudy,6.9,2022-10-31 09:00:00,9
71,144,215,87,14.3,53,Heavy Drizzle,7.9,2022-10-31 10:00:00,10
108,229,337,80,15.7,51,Light Drizzle,8.7,2022-10-31 11:00:00,11
130,268,398,76,16.5,3,Cloudy,7.3,2022-10-31 12:00:00,12
154,330,484,76,17.1,51,Light Drizzle,6.6,2022-10-31 13:00:00,13
142,340,482,76,17.5,51,Light Drizzle,8.9,2022-10-31 14:00:00,14
165,435,600,85,17.1,51,Light Drizzle,12.0,2022-10-31 15:00:00,15
116,287,403,88,17.0,61,Light Rain,9.9,2022-10-31 16:00:00,16
160,504,664,94,16.6,61,Light Rain,7.9,2022-10-31 17:00:00,17
137,430,567,95,16.1,61,Light Rain,4.5,2022-10-31 18:00:00,18
78,267,345,97,15.8,61,Light Rain,5.7,2022-10-31 19:00:00,19
66,203,269,97,15.6,61,Light Rain,7.3,2022-10-31 20:00:00,20
41,155,196,98,15.5,61,Light Rain,8.8,2022-10-31 21:00:00,21
42,111,153,98,15.4,61,Light Rain,8.8,2022-10-31 22:00:00,22
35,58,93,98,15.4,63,Rain,8.3,2022-10-31 23:00:00,23
14,44,58,98,15.4,61,Light Rain,7.3,2022-11-01 00:00:00,0
5,15,20,98,15.6,51,Light Drizzle,6.3,2022-11-01 01:00:00,1
10,14,24,99,15.7,3,Cloudy,6.0,2022-11-01 02:00:00,2
4,8,12,98,15.1,51,Light Drizzle,5.2,2022-11-01 03:00:00,3
6,8,14,99,14.7,2,Partly Cloudy,6.4,2022-11-01 04:00:00,4
20,66,86,99,14.1,2,Partly Cloudy,6.5,2022-11-01 05:00:00,5
44,173,217,99,13.5,2,Partly Cloudy,7.4,2022-11-01 06:00:00,6
111,450,561,99,12.7,3,Cloudy,5.8,2022-11-01 07:00:00,7
198,727,925,99,12.1,2,Partly Cloudy,5.8,2022-11-01 08:00:00,8
145,429,574,97,13.6,1,Mostly Clear,6.6,2022-11-01 09:00:00,9
121,213,334,91,15.8,1,Mostly Clear,6.8,2022-11-01 10:00:00,10
130,241,371,83,17.7,0,Clear,7.2,2022-11-01 11:00:00,11
160,341,501,72,19.3,0,Clear,8.4,2022-11-01 12:00:00,12
162,365,527,65,20.3,0,Clear,10.8,2022-11-01 13:00:00,13
193,316,509,62,20.8,0,Clear,13.0,2022-11-01 14:00:00,14
195,455,650,55,22.0,1,Mostly Clear,15.2,2022-11-01 15:00:00,15
316,571,887,57,21.5,1,Mostly Clear,14.0,2022-11-01 16:00:00,16
419,1021,1440,61,20.5,0,Clear,10.7,2022-11-01 17:00:00,17
398,879,1277,66,18.9,0,Clear,10.5,2022-11-01 18:00:00,18
239,563,802,71,17.6,0,Clear,10.6,2022-11-01 19:00:00,19
158,395,553,75,16.5,0,Clear,11.1,2022-11-01 20:00:00,20
153,301,454,78,15.8,0,Clear,11.1,2022-11-01 21:00:00,21
108,178,286,80,15.2,0,Clear,11.2,2022-11-01 22:00:00,22
47,95,142,83,14.7,0,Clear,11.3,2022-11-01 23:00:00,23
27,43,70,87,14.1,0,Clear,11.8,2022-11-02 00:00:00,0
10,13,23,89,13.8,0,Clear,12.0,2022-11-02 01:00:00,1
1,11,12,91,13.6,0,Clear,12.3,2022-11-02 02:00:00,2
5,7,12,91,13.7,0,Clear,12.5,2022-11-02 03:00:00,3
4,10,14,92,13.5,1,Mostly Clear,13.6,2022-11-02 04:00:00,4
25,65,90,93,13.4,2,Partly Cloudy,13.2,2022-11-02 05:00:00,5
51,191,242,93,13.3,2,Partly Cloudy,10.8,2022-11-02 06:00:00,6
137,516,653,90,13.4,2,Partly Cloudy,10.0,2022-11-02 07:00:00,7
211,837,1048,88,13.4,2,Partly Cloudy,9.5,2022-11-02 08:00:00,8
188,465,653,85,13.8,2,Partly Cloudy,9.0,2022-11-02 09:00:00,9
127,245,372,80,14.3,2,Partly Cloudy,9.5,2022-11-02 10:00:00,10
165,300,465,75,15.3,1,Mostly Clear,10.4,2022-11-02 11:00:00,11
180,378,558,70,16.4,1,Mostly Clear,9.9,2022-11-02 12:00:00,12
204,343,547,65,17.6,1,Mostly Clear,8.4,2022-11-02 13:00:00,13
190,337,527,62,18.2,1,Mostly Clear,7.6,2022-11-02 14:00:00,14
237,417,654,55,19.8,1,Mostly Clear,7.3,2022-11-02 15:00:00,15
291,593,884,55,19.5,1,Mostly Clear,6.7,2022-11-02 16:00:00,16
403,1010,1413,62,18.6,1,Mostly Clear,6.1,2022-11-02 17:00:00,17
350,818,1168,67,17.4,1,Mostly Clear,5.4,2022-11-02 18:00:00,18
256,566,822,79,15.7,1,Mostly Clear,4.4,2022-11-02 19:00:00,19
165,391,556,80,14.9,1,Mostly Clear,2.2,2022-11-02 20:00:00,20
152,279,431,79,14.5,1,Mostly Clear,2.4,2022-11-02 21:00:00,21
110,196,306,79,14.3,1,Mostly Clear,3.4,2022-11-02 22:00:00,22
74,105,179,84,13.2,1,Mostly Clear,4.1,2022-11-02 23:00:00,23
30,41,71,88,12.2,1,Mostly Clear,5.3,2022-11-03 00:00:00,0
10,20,30,89,11.7,1,Mostly Clear,6.5,2022-11-03 01:00:00,1
5,12,17,90,11.4,1,Mostly Clear,7.2,2022-11-03 02:00:00,2
2,5,7,90,10.7,1,Mostly Clear,6.5,2022-11-03 03:00:00,3
5,20,25,92,10.4,1,Mostly Clear,5.3,2022-11-03 04:00:00,4
20,83,103,94,10.2,1,Mostly Clear,6.3,2022-11-03 05:00:00,5
54,169,223,93,10.3,1,Mostly Clear,8.4,2022-11-03 06:00:00,6
111,435,546,94,10.1,0,Clear,9.2,2022-11-03 07:00:00,7
247,782,1029,96,9.5,0,Clear,8.7,2022-11-03 08:00:00,8
186,478,664,95,11.3,0,Clear,8.4,2022-11-03 09:00:00,9
177,274,451,83,14.8,0,Clear,7.2,2022-11-03 10:00:00,10
177,289,466,75,16.4,0,Clear,8.0,2022-11-03 11:00:00,11
200,375,575,67,17.6,0,Clear,7.3,2022-11-03 12:00:00,12
202,348,550,61,18.5,0,Clear,6.3,2022-11-03 13:00:00,13
214,389,603,59,18.9,0,Clear,5.4,2022-11-03 14:00:00,14
289,461,750,57,19.2,0,Clear,5.1,2022-11-03 15:00:00,15
381,609,990,58,19.2,0,Clear,5.6,2022-11-03 16:00:00,16
519,1014,1533,61,18.5,0,Clear,5.5,2022-11-03 17:00:00,17
434,834,1268,69,17.2,0,Clear,6.0,2022-11-03 18:00:00,18
268,554,822,77,15.4,0,Clear,6.7,2022-11-03 19:00:00,19
167,335,502,81,14.3,0,Clear,5.9,2022-11-03 20:00:00,20
155,323,478,85,13.6,0,Clear,6.6,2022-11-03 21:00:00,21
121,213,334,87,12.9,1,Mostly Clear,8.2,2022-11-03 22:00:00,22
84,133,217,90,12.2,1,Mostly Clear,7.0,2022-11-03 23:00:00,23
45,75,120,93,11.6,1,Mostly Clear,6.2,2022-11-04 00:00:00,0
24,34,58,94,11.1,0,Clear,6.4,2022-11-04 01:00:00,1
11,11,22,94,11.3,0,Clear,6.1,2022-11-04 02:00:00,2
5,11,16,95,11.4,0,Clear,7.1,2022-11-04 03:00:00,3
3,15,18,95,12.4,0,Clear,5.0,2022-11-04 04:00:00,4
15,57,72,97,12.1,0,Clear,4.3,2022-11-04 05:00:00,5
47,135,182,98,11.8,3,Cloudy,1.9,2022-11-04 06:00:00,6
80,352,432,99,10.9,3,Cloudy,3.7,2022-11-04 07:00:00,7
175,552,727,99,10.8,3,Cloudy,3.1,2022-11-04 08:00:00,8
197,381,578,96,12.5,3,Cloudy,2.3,2022-11-04 09:00:00,9
225,274,499,88,15.6,3,Cloudy,1.4,2022-11-04 10:00:00,10
203,377,580,79,18.0,1,Mostly Clear,2.3,2022-11-04 11:00:00,11
238,402,640,71,20.1,1,Mostly Clear,3.5,2022-11-04 12:00:00,12
328,407,735,65,21.4,1,Mostly Clear,4.8,2022-11-04 13:00:00,13
366,395,761,64,22.1,2,Partly Cloudy,5.6,2022-11-04 14:00:00,14
439,533,972,66,21.5,2,Partly Cloudy,7.4,2022-11-04 15:00:00,15
489,628,1117,68,21.3,1,Mostly Clear,8.9,2022-11-04 16:00:00,16
494,788,1282,73,20.4,1,Mostly Clear,8.4,2022-11-04 17:00:00,17
449,676,1125,80,18.8,1,Mostly Clear,7.6,2022-11-04 18:00:00,18
268,478,746,87,17.5,1,Mostly Clear,8.9,2022-11-04 19:00:00,19
211,304,515,91,16.8,2,Partly Cloudy,9.4,2022-11-04 20:00:00,20
214,296,510,93,16.4,3,Cloudy,10.1,2022-11-04 21:00:00,21
184,211,395,95,16.2,3,Cloudy,11.1,2022-11-04 22:00:00,22
141,186,327,95,16.2,1,Mostly Clear,11.8,2022-11-04 23:00:00,23
100,125,225,95,16.3,1,Mostly Clear,12.7,2022-11-05 00:00:00,0
95,107,202,95,16.5,1,Mostly Clear,12.8,2022-11-05 01:00:00,1
68,57,125,95,16.4,1,Mostly Clear,12.4,2022-11-05 02:00:00,2
25,21,46,96,16.7,1,Mostly Clear,11.6,2022-11-05 03:00:00,3
13,12,25,97,16.7,1,Mostly Clear,11.2,2022-11-05 04:00:00,4
12,28,40,97,16.7,2,Partly Cloudy,11.7,2022-11-05 05:00:00,5
16,47,63,97,16.7,1,Mostly Clear,9.1,2022-11-05 06:00:00,6
43,116,159,97,16.6,1,Mostly Clear,9.4,2022-11-05 07:00:00,7
149,235,384,97,16.5,0,Clear,9.6,2022-11-05 08:00:00,8
259,370,629,94,17.4,1,Mostly Clear,10.7,2022-11-05 09:00:00,9
432,453,885,88,18.9,1,Mostly Clear,10.7,2022-11-05 10:00:00,10
595,623,1218,82,20.4,1,Mostly Clear,12.3,2022-11-05 11:00:00,11
661,580,1241,75,21.9,2,Partly Cloudy,15.2,2022-11-05 12:00:00,12
683,562,1245,69,22.8,1,Mostly Clear,16.6,2022-11-05 13:00:00,13
836,604,1440,65,23.4,0,Clear,16.3,2022-11-05 14:00:00,14
867,577,1444,62,24.4,0,Clear,16.8,2022-11-05 15:00:00,15
729,589,1318,62,24.2,0,Clear,17.0,2022-11-05 16:00:00,16
674,511,1185,66,23.2,0,Clear,16.1,2022-11-05 17:00:00,17
467,483,950,72,21.6,1,Mostly Clear,14.1,2022-11-05 18:00:00,18
296,354,650,78,20.5,0,Clear,16.9,2022-11-05 19:00:00,19
269,290,559,83,19.8,1,Mostly Clear,17.2,2022-11-05 20:00:00,20
200,242,442,86,19.5,1,Mostly Clear,17.1,2022-11-05 21:00:00,21
190,221,411,86,19.4,2,Partly Cloudy,17.1,2022-11-05 22:00:00,22
161,186,347,86,19.3,1,Mostly Clear,17.9,2022-11-05 23:00:00,23
133,165,298,85,19.2,1,Mostly Clear,18.2,2022-11-06 00:00:00,0
182,163,345,84,19.1,1,Mostly Clear,17.3,2022-11-06 01:00:00,1
36,46,82,84,18.8,1,Mostly Clear,17.7,2022-11-06 02:00:00,2
12,18,30,84,19.3,1,Mostly Clear,18.9,2022-11-06 03:00:00,3
8,7,15,84,19.1,0,Clear,17.3,2022-11-06 04:00:00,4
9,11,20,84,18.9,1,Mostly Clear,15.9,2022-11-06 05:00:00,5
34,42,76,83,18.9,51,Light Drizzle,15.6,2022-11-06 06:00:00,6
54,116,170,86,18.5,53,Heavy Drizzle,13.4,2022-11-06 07:00:00,7
85,143,228,88,18.2,61,Light Rain,11.7,2022-11-06 08:00:00,8
237,268,505,90,18.2,55,Heavy Drizzle,11.9,2022-11-06 09:00:00,9
379,392,771,91,18.4,55,Heavy Drizzle,14.1,2022-11-06 10:00:00,10
456,477,933,92,19.3,53,Heavy Drizzle,13.6,2022-11-06 11:00:00,11
560,528,1088,91,20.0,53,Heavy Drizzle,12.7,2022-11-06 12:00:00,12
524,506,1030,87,21.0,53,Heavy Drizzle,11.9,2022-11-06 13:00:00,13
494,468,962,89,21.1,51,Light Drizzle,11.3,2022-11-06 14:00:00,14
468,456,924,89,23.0,51,Light Drizzle,9.4,2022-11-06 15:00:00,15
466,445,911,89,23.0,51,Light Drizzle,9.3,2022-11-06 16:00:00,16
313,408,721,88,22.7,51,Light Drizzle,9.7,2022-11-06 17:00:00,17
198,315,513,90,21.8,51,Light Drizzle,9.4,2022-11-06 18:00:00,18
143,241,384,91,21.1,51,Light Drizzle,9.9,2022-11-06 19:00:00,19
107,218,325,91,20.5,2,Partly Cloudy,8.0,2022-11-06 20:00:00,20
109,157,266,91,20.1,2,Partly Cloudy,9.0,2022-11-06 21:00:00,21
88,104,192,91,19.8,1,Mostly Clear,10.1,2022-11-06 22:00:00,22
43,71,114,90,19.7,1,Mostly Clear,10.4,2022-11-06 23:00:00,23
22,30,52,90,19.4,1,Mostly Clear,10.7,2022-11-07 00:00:00,0
8,14,22,91,19.1,1,Mostly Clear,12.0,2022-11-07 01:00:00,1
12,10,22,91,19.1,1,Mostly Clear,12.5,2022-11-07 02:00:00,2
11,10,21,94,19.3,0,Clear,12.1,2022-11-07 03:00:00,3
10,11,21,95,19.0,0,Clear,11.3,2022-11-07 04:00:00,4
22,70,92,96,18.8,1,Mostly Clear,9.9,2022-11-07 05:00:00,5
54,206,260,97,18.7,1,Mostly Clear,8.4,2022-11-07 06:00:00,6
107,487,594,98,18.3,0,Clear,7.7,2022-11-07 07:00:00,7
220,671,891,98,18.1,0,Clear,7.1,2022-11-07 08:00:00,8
183,356,539,96,18.8,0,Clear,8.4,2022-11-07 09:00:00,9
192,236,428,85,20.3,0,Clear,8.9,2022-11-07 10:00:00,10
229,299,528,64,21.2,0,Clear,10.2,2022-11-07 11:00:00,11
211,374,585,53,22.0,0,Clear,10.7,2022-11-07 12:00:00,12
252,360,612,48,22.8,0,Clear,10.7,2022-11-07 13:00:00,13
296,386,682,46,23.3,0,Clear,11.5,2022-11-07 14:00:00,14
355,475,830,39,24.6,0,Clear,13.0,2022-11-07 15:00:00,15
373,638,1011,41,24.1,0,Clear,12.2,2022-11-07 16:00:00,16
369,901,1270,47,22.8,0,Clear,10.2,2022-11-07 17:00:00,17
279,747,1026,50,20.9,0,Clear,9.4,2022-11-07 18:00:00,18
234,508,742,52,19.4,0,Clear,10.5,2022-11-07 19:00:00,19
189,328,517,52,18.3,0,Clear,11.2,2022-11-07 20:00:00,20
110,258,368,49,17.2,0,Clear,11.0,2022-11-07 21:00:00,21
98,175,273,44,16.3,0,Clear,12.0,2022-11-07 22:00:00,22
68,89,157,40,15.6,0,Clear,13.8,2022-11-07 23:00:00,23
17,32,49,39,14.8,0,Clear,15.5,2022-11-08 00:00:00,0
7,15,22,39,13.9,0,Clear,16.2,2022-11-08 01:00:00,1
2,7,9,38,13.0,0,Clear,15.9,2022-11-08 02:00:00,2
2,7,9,35,13.0,0,Clear,15.8,2022-11-08 03:00:00,3
5,17,22,38,12.2,0,Clear,15.8,2022-11-08 04:00:00,4
32,84,116,42,11.5,0,Clear,15.8,2022-11-08 05:00:00,5
57,203,260,45,10.8,0,Clear,15.2,2022-11-08 06:00:00,6
136,466,602,48,10.1,0,Clear,14.8,2022-11-08 07:00:00,7
241,774,1015,52,9.4,1,Mostly Clear,14.4,2022-11-08 08:00:00,8
180,434,614,53,9.4,1,Mostly Clear,15.5,2022-11-08 09:00:00,9
146,260,406,52,10.0,1,Mostly Clear,16.3,2022-11-08 10:00:00,10
186,263,449,50,11.1,1,Mostly Clear,15.2,2022-11-08 11:00:00,11
189,369,558,47,12.2,1,Mostly Clear,14.2,2022-11-08 12:00:00,12
226,373,599,45,13.4,0,Clear,13.5,2022-11-08 13:00:00,13
208,340,548,43,14.1,0,Clear,13.2,2022-11-08 14:00:00,14
274,459,733,43,14.7,0,Clear,12.8,2022-11-08 15:00:00,15
292,583,875,42,14.8,0,Clear,12.6,2022-11-08 16:00:00,16
344,881,1225,43,14.3,0,Clear,11.3,2022-11-08 17:00:00,17
299,678,977,47,13.1,0,Clear,7.3,2022-11-08 18:00:00,18
216,482,698,51,12.0,0,Clear,8.3,2022-11-08 19:00:00,19
136,353,489,54,11.2,0,Clear,9.1,2022-11-08 20:00:00,20
105,262,367,55,10.5,0,Clear,9.8,2022-11-08 21:00:00,21
107,171,278,57,10.0,0,Clear,10.6,2022-11-08 22:00:00,22
70,131,201,58,9.5,0,Clear,10.9,2022-11-08 23:00:00,23
27,57,84,59,9.0,0,Clear,11.3,2022-11-09 00:00:00,0
10,25,35,59,8.6,0,Clear,11.9,2022-11-09 01:00:00,1
7,9,16,59,8.2,0,Clear,12.2,2022-11-09 02:00:00,2
4,11,15,56,8.0,0,Clear,12.1,2022-11-09 03:00:00,3
2,12,14,57,7.7,0,Clear,11.6,2022-11-09 04:00:00,4
21,65,86,59,7.3,0,Clear,11.5,2022-11-09 05:00:00,5
52,206,258,61,6.9,0,Clear,10.5,2022-11-09 06:00:00,6
117,500,617,63,6.4,0,Clear,9.1,2022-11-09 07:00:00,7
234,817,1051,70,5.8,0,Clear,9.0,2022-11-09 08:00:00,8
170,461,631,70,6.9,0,Clear,8.7,2022-11-09 09:00:00,9
142,272,414,58,9.1,0,Clear,8.7,2022-11-09 10:00:00,10
132,291,423,58,10.3,0,Clear,7.6,2022-11-09 11:00:00,11
176,322,498,58,11.5,0,Clear,6.4,2022-11-09 12:00:00,12
189,323,512,57,12.5,0,Clear,6.1,2022-11-09 13:00:00,13
195,304,499,57,13.2,0,Clear,6.9,2022-11-09 14:00:00,14
246,428,674,56,13.5,0,Clear,8.2,2022-11-09 15:00:00,15
271,620,891,57,13.4,0,Clear,8.7,2022-11-09 16:00:00,16
343,912,1255,59,13.0,0,Clear,8.8,2022-11-09 17:00:00,17
273,681,954,64,12.0,0,Clear,5.8,2022-11-09 18:00:00,18
228,497,725,70,11.1,1,Mostly Clear,6.5,2022-11-09 19:00:00,19
134,342,476,77,10.3,1,Mostly Clear,6.2,2022-11-09 20:00:00,20
120,241,361,84,9.3,0,Clear,6.2,2022-11-09 21:00:00,21
136,206,342,88,8.5,0,Clear,6.5,2022-11-09 22:00:00,22
55,115,170,90,7.9,0,Clear,6.6,2022-11-09 23:00:00,23
22,50,72,91,7.7,0,Clear,6.2,2022-11-10 00:00:00,0
10,17,27,92,7.7,0,Clear,6.3,2022-11-10 01:00:00,1
10,6,16,92,7.9,1,Mostly Clear,5.6,2022-11-10 02:00:00,2
4,6,10,93,8.2,2,Partly Cloudy,5.1,2022-11-10 03:00:00,3
2,12,14,94,8.5,2,Partly Cloudy,5.0,2022-11-10 04:00:00,4
17,55,72,94,8.6,1,Mostly Clear,4.9,2022-11-10 05:00:00,5
51,184,235,95,8.5,1,Mostly Clear,3.7,2022-11-10 06:00:00,6
109,438,547,95,8.9,1,Mostly Clear,3.3,2022-11-10 07:00:00,7
233,749,982,95,9.3,1,Mostly Clear,4.0,2022-11-10 08:00:00,8
189,449,638,94,10.2,1,Mostly Clear,5.4,2022-11-10 09:00:00,9
149,282,431,85,12.4,1,Mostly Clear,4.5,2022-11-10 10:00:00,10
185,319,504,80,14.3,1,Mostly Clear,3.6,2022-11-10 11:00:00,11
243,383,626,76,15.9,1,Mostly Clear,3.3,2022-11-10 12:00:00,12
239,400,639,75,16.8,1,Mostly Clear,4.0,2022-11-10 13:00:00,13
263,376,639,71,18.2,1,Mostly Clear,5.2,2022-11-10 14:00:00,14
320,453,773,67,18.4,1,Mostly Clear,6.4,2022-11-10 15:00:00,15
333,638,971,68,18.3,3,Cloudy,7.5,2022-11-10 16:00:00,16
386,837,1223,71,17.7,3,Cloudy,7.0,2022-11-10 17:00:00,17
373,737,1110,76,16.7,3,Cloudy,4.7,2022-11-10 18:00:00,18
230,480,710,79,16.0,3,Cloudy,6.6,2022-11-10 19:00:00,19
185,371,556,81,15.5,3,Cloudy,7.3,2022-11-10 20:00:00,20
177,311,488,83,15.3,3,Cloudy,7.2,2022-11-10 21:00:00,21
160,264,424,84,15.3,3,Cloudy,8.0,2022-11-10 22:00:00,22
114,178,292,88,15.2,2,Partly Cloudy,8.4,2022-11-10 23:00:00,23
66,79,145,93,14.7,1,Mostly Clear,7.9,2022-11-11 00:00:00,0
34,45,79,95,14.4,2,Partly Cloudy,8.2,2022-11-11 01:00:00,1
28,41,69,96,14.2,2,Partly Cloudy,8.7,2022-11-11 02:00:00,2
18,20,38,95,14.3,2,Partly Cloudy,7.1,2022-11-11 03:00:00,3
7,24,31,95,14.5,3,Cloudy,7.3,2022-11-11 04:00:00,4
9,33,42,94,15.2,55,Heavy Drizzle,8.4,2022-11-11 05:00:00,5
14,61,75,94,15.6,61,Light Rain,8.6,2022-11-11 06:00:00,6
24,91,115,95,15.8,61,Light Rain,9.4,2022-11-11 07:00:00,7
44,134,178,96,16.4,61,Light Rain,11.9,2022-11-11 08:00:00,8
25,120,145,96,17.1,61,Light Rain,14.6,2022-11-11 09:00:00,9
30,82,112,97,17.8,61,Light Rain,17.1,2022-11-11 10:00:00,10
51,129,180,98,18.3,61,Light Rain,17.8,2022-11-11 11:00:00,11
99,234,333,98,18.7,61,Light Rain,17.7,2022-11-11 12:00:00,12
154,241,395,99,19.1,61,Light Rain,17.2,2022-11-11 13:00:00,13
181,279,460,100,19.3,55,Heavy Drizzle,17.9,2022-11-11 14:00:00,14
99,184,283,100,19.4,55,Heavy Drizzle,18.9,2022-11-11 15:00:00,15
167,301,468,99,19.6,51,Light Drizzle,18.4,2022-11-11 16:00:00,16
175,383,558,98,20.0,3,Cloudy,18.5,2022-11-11 17:00:00,17
203,395,598,98,20.2,51,Light Drizzle,17.3,2022-11-11 18:00:00,18
158,299,457,98,20.4,51,Light Drizzle,17.2,2022-11-11 19:00:00,19
128,214,342,97,20.6,3,Cloudy,20.4,2022-11-11 20:00:00,20
123,190,313,96,20.8,3,Cloudy,21.1,2022-11-11 21:00:00,21
110,155,265,95,20.8,3,Cloudy,21.6,2022-11-11 22:00:00,22
58,89,147,95,20.7,3,Cloudy,22.4,2022-11-11 23:00:00,23
77,101,178,93,20.7,51,Light Drizzle,22.1,2022-11-12 00:00:00,0
51,55,106,95,20.4,53,Heavy Drizzle,21.3,2022-11-12 01:00:00,1
49,37,86,96,20.1,53,Heavy Drizzle,21.8,2022-11-12 02:00:00,2
21,18,39,96,20.2,53,Heavy Drizzle,21.1,2022-11-12 03:00:00,3
8,12,20,95,19.7,53,Heavy Drizzle,23.9,2022-11-12 04:00:00,4
18,19,37,89,18.2,0,Clear,23.7,2022-11-12 05:00:00,5
26,51,77,88,17.2,0,Clear,15.6,2022-11-12 06:00:00,6
66,126,192,86,16.3,0,Clear,14.9,2022-11-12 07:00:00,7
131,228,359,83,15.6,0,Clear,14.0,2022-11-12 08:00:00,8
327,337,664,80,15.5,0,Clear,13.1,2022-11-12 09:00:00,9
531,449,980,73,16.3,0,Clear,12.9,2022-11-12 10:00:00,10
663,539,1202,68,17.3,0,Clear,12.4,2022-11-12 11:00:00,11
727,546,1273,64,18.4,0,Clear,10.2,2022-11-12 12:00:00,12
845,610,1455,61,19.3,0,Clear,7.1,2022-11-12 13:00:00,13
785,608,1393,58,20.0,0,Clear,4.4,2022-11-12 14:00:00,14
784,582,1366,57,21.2,1,Mostly Clear,6.1,2022-11-12 15:00:00,15
690,580,1270,58,21.4,2,Partly Cloudy,6.9,2022-11-12 16:00:00,16
468,456,924,64,20.7,2,Partly Cloudy,3.1,2022-11-12 17:00:00,17
329,367,696,68,19.7,2,Partly Cloudy,4.3,2022-11-12 18:00:00,18
236,319,555,72,18.7,3,Cloudy,7.6,2022-11-12 19:00:00,19
232,270,502,77,17.9,2,Partly Cloudy,7.1,2022-11-12 20:00:00,20
153,194,347,78,17.6,1,Mostly Clear,4.3,2022-11-12 21:00:00,21
119,171,290,77,16.9,2,Partly Cloudy,13.4,2022-11-12 22:00:00,22
60,100,160,73,13.5,2,Partly Cloudy,21.2,2022-11-12 23:00:00,23
91,108,199,67,12.2,3,Cloudy,21.4,2022-11-13 00:00:00,0
71,89,160,67,11.0,51,Light Drizzle,20.6,2022-11-13 01:00:00,1
47,65,112,67,10.0,51,Light Drizzle,19.6,2022-11-13 02:00:00,2
21,30,51,64,9.8,3,Cloudy,20.4,2022-11-13 03:00:00,3
9,10,19,59,9.0,3,Cloudy,20.9,2022-11-13 04:00:00,4
8,14,22,57,8.3,2,Partly Cloudy,20.4,2022-11-13 05:00:00,5
21,40,61,56,7.8,1,Mostly Clear,15.5,2022-11-13 06:00:00,6
20,74,94,54,7.5,2,Partly Cloudy,16.1,2022-11-13 07:00:00,7
78,127,205,55,7.3,2,Partly Cloudy,18.1,2022-11-13 08:00:00,8
165,244,409,56,7.2,1,Mostly Clear,18.4,2022-11-13 09:00:00,9
263,331,594,55,7.5,1,Mostly Clear,20.9,2022-11-13 10:00:00,10
342,322,664,50,8.6,2,Partly Cloudy,21.9,2022-11-13 11:00:00,11
359,390,749,44,9.8,1,Mostly Clear,22.7,2022-11-13 12:00:00,12
277,420,697,44,10.1,1,Mostly Clear,22.3,2022-11-13 13:00:00,13
297,349,646,42,9.9,3,Cloudy,22.6,2022-11-13 14:00:00,14
243,360,603,40,9.4,3,Cloudy,22.4,2022-11-13 15:00:00,15
215,346,561,39,9.0,3,Cloudy,22.1,2022-11-13 16:00:00,16
176,330,506,37,8.4,3,Cloudy,20.5,2022-11-13 17:00:00,17
124,246,370,37,7.7,3,Cloudy,16.0,2022-11-13 18:00:00,18
66,167,233,39,7.1,1,Mostly Clear,13.5,2022-11-13 19:00:00,19
70,150,220,41,6.6,0,Clear,13.9,2022-11-13 20:00:00,20
56,100,156,43,6.2,0,Clear,13.4,2022-11-13 21:00:00,21
44,78,122,45,5.7,0,Clear,13.4,2022-11-13 22:00:00,22
27,54,81,47,5.3,0,Clear,13.2,2022-11-13 23:00:00,23
15,24,39,50,4.8,0,Clear,13.0,2022-11-14 00:00:00,0
1,15,16,52,4.4,0,Clear,12.1,2022-11-14 01:00:00,1
2,11,13,55,3.9,0,Clear,11.0,2022-11-14 02:00:00,2
1,9,10,57,3.7,0,Clear,10.5,2022-11-14 03:00:00,3
6,14,20,58,3.4,0,Clear,9.9,2022-11-14 04:00:00,4
14,53,67,61,3.0,0,Clear,9.7,2022-11-14 05:00:00,5
39,152,191,63,2.7,0,Clear,6.1,2022-11-14 06:00:00,6
84,356,440,66,2.3,0,Clear,5.7,2022-11-14 07:00:00,7
113,567,680,72,1.8,0,Clear,6.0,2022-11-14 08:00:00,8
110,280,390,71,2.8,0,Clear,6.9,2022-11-14 09:00:00,9
101,204,305,58,4.7,0,Clear,8.2,2022-11-14 10:00:00,10
139,222,361,52,5.8,0,Clear,9.6,2022-11-14 11:00:00,11
136,285,421,49,6.7,0,Clear,7.1,2022-11-14 12:00:00,12
154,258,412,48,7.6,0,Clear,6.0,2022-11-14 13:00:00,13
134,263,397,46,8.3,0,Clear,5.6,2022-11-14 14:00:00,14
164,380,544,45,8.8,0,Clear,4.3,2022-11-14 15:00:00,15
184,444,628,44,8.8,0,Clear,3.1,2022-11-14 16:00:00,16
206,731,937,44,8.5,0,Clear,2.5,2022-11-14 17:00:00,17
174,573,747,53,7.9,0,Clear,3.3,2022-11-14 18:00:00,18
117,411,528,48,7.8,0,Clear,5.6,2022-11-14 19:00:00,19
79,301,380,53,7.4,0,Clear,5.7,2022-11-14 20:00:00,20
59,166,225,64,5.8,0,Clear,6.5,2022-11-14 21:00:00,21
56,125,181,71,4.9,1,Mostly Clear,6.6,2022-11-14 22:00:00,22
34,55,89,76,4.1,1,Mostly Clear,8.7,2022-11-14 23:00:00,23
14,21,35,79,3.7,0,Clear,9.4,2022-11-15 00:00:00,0
3,7,10,81,3.4,0,Clear,9.3,2022-11-15 01:00:00,1
2,5,7,85,2.6,0,Clear,9.1,2022-11-15 02:00:00,2
2,4,6,87,1.7,0,Clear,7.9,2022-11-15 03:00:00,3
8,13,21,88,1.7,0,Clear,9.0,2022-11-15 04:00:00,4
20,54,74,88,1.8,1,Mostly Clear,7.4,2022-11-15 05:00:00,5
39,165,204,88,1.7,1,Mostly Clear,8.9,2022-11-15 06:00:00,6
102,469,571,88,2.0,1,Mostly Clear,6.9,2022-11-15 07:00:00,7
178,748,926,88,2.3,1,Mostly Clear,8.9,2022-11-15 08:00:00,8
132,388,520,86,3.6,2,Partly Cloudy,9.5,2022-11-15 09:00:00,9
77,242,319,76,5.6,3,Cloudy,10.2,2022-11-15 10:00:00,10
69,213,282,70,6.6,51,Light Drizzle,9.2,2022-11-15 11:00:00,11
41,164,205,68,7.4,3,Cloudy,6.8,2022-11-15 12:00:00,12
44,164,208,68,7.7,51,Light Drizzle,8.9,2022-11-15 13:00:00,13
43,158,201,73,7.8,55,Heavy Drizzle,10.5,2022-11-15 14:00:00,14
65,186,251,83,6.1,53,Heavy Drizzle,8.7,2022-11-15 15:00:00,15
47,176,223,91,5.7,53,Heavy Drizzle,13.2,2022-11-15 16:00:00,16
38,182,220,94,5.6,53,Heavy Drizzle,12.7,2022-11-15 17:00:00,17
28,126,154,95,5.6,61,Light Rain,10.3,2022-11-15 18:00:00,18
19,90,109,95,5.7,63,Rain,15.0,2022-11-15 19:00:00,19
10,42,52,96,5.9,63,Rain,16.1,2022-11-15 20:00:00,20
10,51,61,97,5.8,63,Rain,14.0,2022-11-15 21:00:00,21
14,39,53,97,5.3,63,Rain,12.6,2022-11-15 22:00:00,22
23,44,67,97,4.7,63,Rain,12.3,2022-11-15 23:00:00,23
6,22,28,95,4.6,61,Light Rain,11.8,2022-11-16 00:00:00,0
5,7,12,96,4.8,53,Heavy Drizzle,10.2,2022-11-16 01:00:00,1
4,4,8,95,5.3,3,Cloudy,11.0,2022-11-16 02:00:00,2
1,2,3,97,5.1,3,Cloudy,12.0,2022-11-16 03:00:00,3
6,10,16,96,4.9,3,Cloudy,12.1,2022-11-16 04:00:00,4
15,60,75,95,4.7,3,Cloudy,12.1,2022-11-16 05:00:00,5
39,145,184,96,4.2,2,Partly Cloudy,9.7,2022-11-16 06:00:00,6
76,401,477,96,3.6,2,Partly Cloudy,10.5,2022-11-16 07:00:00,7
164,616,780,96,3.5,1,Mostly Clear,9.7,2022-11-16 08:00:00,8
95,338,433,94,4.5,1,Mostly Clear,10.8,2022-11-16 09:00:00,9
70,229,299,89,6.5,1,Mostly Clear,10.6,2022-11-16 10:00:00,10
108,240,348,77,8.9,0,Clear,13.5,2022-11-16 11:00:00,11
99,293,392,62,9.8,2,Partly Cloudy,18.5,2022-11-16 12:00:00,12
111,260,371,56,10.2,1,Mostly Clear,18.5,2022-11-16 13:00:00,13
110,244,354,53,10.2,2,Partly Cloudy,18.7,2022-11-16 14:00:00,14
143,328,471,50,10.3,3,Cloudy,18.4,2022-11-16 15:00:00,15
191,443,634,49,9.9,3,Cloudy,17.6,2022-11-16 16:00:00,16
247,695,942,49,9.2,2,Partly Cloudy,15.8,2022-11-16 17:00:00,17
192,661,853,51,8.1,2,Partly Cloudy,12.3,2022-11-16 18:00:00,18
134,456,590,53,7.3,2,Partly Cloudy,12.7,2022-11-16 19:00:00,19
91,279,370,55,6.4,2,Partly Cloudy,14.0,2022-11-16 20:00:00,20
74,202,276,56,5.8,3,Cloudy,14.3,2022-11-16 21:00:00,21
74,139,213,56,5.4,2,Partly Cloudy,13.9,2022-11-16 22:00:00,22
43,101,144,58,4.9,1,Mostly Clear,13.6,2022-11-16 23:00:00,23
16,47,63,61,4.3,0,Clear,12.9,2022-11-17 00:00:00,0
9,11,20,63,3.9,0,Clear,11.4,2022-11-17 01:00:00,1
5,9,14,66,3.3,0,Clear,9.0,2022-11-17 02:00:00,2
3,4,7,70,2.9,0,Clear,7.5,2022-11-17 03:00:00,3
4,9,13,69,2.7,0,Clear,11.4,2022-11-17 04:00:00,4
9,70,79,63,2.9,0,Clear,15.6,2022-11-17 05:00:00,5
39,174,213,56,2.7,0,Clear,14.3,2022-11-17 06:00:00,6
81,413,494,51,2.3,0,Clear,15.1,2022-11-17 07:00:00,7
180,648,828,51,2.0,0,Clear,16.0,2022-11-17 08:00:00,8
98,347,445,52,2.3,0,Clear,15.1,2022-11-17 09:00:00,9
74,233,307,47,3.2,0,Clear,20.1,2022-11-17 10:00:00,10
72,229,301,47,4.2,2,Partly Cloudy,23.4,2022-11-17 11:00:00,11
99,281,380,46,5.4,2,Partly Cloudy,21.3,2022-11-17 12:00:00,12
83,254,337,36,7.5,3,Cloudy,22.0,2022-11-17 13:00:00,13
108,260,368,36,7.9,1,Mostly Clear,22.5,2022-11-17 14:00:00,14
128,307,435,38,7.3,1,Mostly Clear,21.1,2022-11-17 15:00:00,15
163,439,602,39,6.8,1,Mostly Clear,19.2,2022-11-17 16:00:00,16
215,622,837,40,6.0,1,Mostly Clear,16.9,2022-11-17 17:00:00,17
182,540,722,42,5.0,0,Clear,13.7,2022-11-17 18:00:00,18
108,363,471,45,4.1,0,Clear,12.0,2022-11-17 19:00:00,19
78,244,322,50,3.2,0,Clear,13.0,2022-11-17 20:00:00,20
66,194,260,52,2.6,0,Clear,13.1,2022-11-17 21:00:00,21
55,124,179,54,2.1,0,Clear,12.1,2022-11-17 22:00:00,22
45,102,147,57,1.6,0,Clear,10.5,2022-11-17 23:00:00,23
23,39,62,60,1.0,0,Clear,9.7,2022-11-18 00:00:00,0
13,17,30,66,0.2,0,Clear,8.6,2022-11-18 01:00:00,1
5,10,15,72,-0.6,0,Clear,6.8,2022-11-18 02:00:00,2
7,5,12,74,-1.2,0,Clear,6.9,2022-11-18 03:00:00,3
4,10,14,76,-1.5,0,Clear,6.7,2022-11-18 04:00:00,4
22,50,72,77,-1.8,0,Clear,6.8,2022-11-18 05:00:00,5
35,118,153,78,-2.0,3,Cloudy,7.4,2022-11-18 06:00:00,6
52,316,368,78,-2.2,0,Clear,7.8,2022-11-18 07:00:00,7
118,450,568,79,-2.4,0,Clear,7.7,2022-11-18 08:00:00,8
81,303,384,79,-0.9,0,Clear,9.8,2022-11-18 09:00:00,9
90,266,356,58,2.8,0,Clear,10.7,2022-11-18 10:00:00,10
104,257,361,49,4.1,0,Clear,13.0,2022-11-18 11:00:00,11
164,295,459,46,5.3,0,Clear,13.2,2022-11-18 12:00:00,12
142,266,408,44,6.2,0,Clear,13.0,2022-11-18 13:00:00,13
163,336,499,42,7.0,3,Cloudy,17.7,2022-11-18 14:00:00,14
209,407,616,39,7.5,2,Partly Cloudy,17.2,2022-11-18 15:00:00,15
224,473,697,39,7.4,2,Partly Cloudy,17.1,2022-11-18 16:00:00,16
204,534,738,40,7.2,2,Partly Cloudy,13.9,2022-11-18 17:00:00,17
129,428,557,44,6.3,2,Partly Cloudy,6.5,2022-11-18 18:00:00,18
113,318,431,47,5.9,51,Light Drizzle,6.7,2022-11-18 19:00:00,19
82,209,291,58,4.6,51,Light Drizzle,7.7,2022-11-18 20:00:00,20
66,181,247,63,3.8,1,Mostly Clear,7.9,2022-11-18 21:00:00,21
51,147,198,59,3.1,0,Clear,8.7,2022-11-18 22:00:00,22
67,117,184,57,2.3,0,Clear,9.5,2022-11-18 23:00:00,23
53,83,136,57,1.7,0,Clear,10.0,2022-11-19 00:00:00,0
39,53,92,59,1.0,0,Clear,8.9,2022-11-19 01:00:00,1
28,21,49,63,0.2,0,Clear,7.7,2022-11-19 02:00:00,2
6,10,16,70,-0.3,0,Clear,6.7,2022-11-19 03:00:00,3
3,14,17,75,-1.1,0,Clear,8.1,2022-11-19 04:00:00,4
4,11,15,72,-1.1,0,Clear,6.2,2022-11-19 05:00:00,5
18,30,48,64,0.3,0,Clear,3.3,2022-11-19 06:00:00,6
25,65,90,65,0.4,1,Mostly Clear,3.1,2022-11-19 07:00:00,7
59,141,200,71,-0.0,1,Mostly Clear,3.3,2022-11-19 08:00:00,8
117,271,388,74,0.1,0,Clear,4.0,2022-11-19 09:00:00,9
204,354,558,64,2.0,0,Clear,4.0,2022-11-19 10:00:00,10
219,363,582,58,3.7,0,Clear,5.7,2022-11-19 11:00:00,11
246,424,670,53,5.4,0,Clear,9.7,2022-11-19 12:00:00,12
281,430,711,46,6.4,1,Mostly Clear,13.2,2022-11-19 13:00:00,13
290,378,668,43,7.1,0,Clear,12.7,2022-11-19 14:00:00,14
325,425,750,39,7.3,0,Clear,12.8,2022-11-19 15:00:00,15
249,383,632,37,7.3,0,Clear,11.9,2022-11-19 16:00:00,16
178,351,529,39,6.9,0,Clear,9.2,2022-11-19 17:00:00,17
116,238,354,45,5.6,0,Clear,7.0,2022-11-19 18:00:00,18
83,186,269,52,4.3,0,Clear,6.6,2022-11-19 19:00:00,19
66,161,227,57,3.4,0,Clear,8.6,2022-11-19 20:00:00,20
61,114,175,62,2.9,0,Clear,11.3,2022-11-19 21:00:00,21
65,114,179,68,2.3,0,Clear,9.8,2022-11-19 22:00:00,22
76,111,187,72,1.9,0,Clear,8.2,2022-11-19 23:00:00,23
61,89,150,73,1.3,0,Clear,7.8,2022-11-20 00:00:00,0
55,68,123,71,0.6,0,Clear,7.6,2022-11-20 01:00:00,1
33,33,66,63,0.3,0,Clear,7.9,2022-11-20 02:00:00,2
20,13,33,64,-0.2,0,Clear,11.7,2022-11-20 03:00:00,3
6,12,18,48,0.4,0,Clear,15.3,2022-11-20 04:00:00,4
3,11,14,41,0.7,0,Clear,15.6,2022-11-20 05:00:00,5
16,15,31,40,0.4,0,Clear,12.0,2022-11-20 06:00:00,6
13,54,67,40,-0.0,0,Clear,13.1,2022-11-20 07:00:00,7
43,87,130,40,-0.6,0,Clear,16.4,2022-11-20 08:00:00,8
64,159,223,39,-0.6,0,Clear,17.7,2022-11-20 09:00:00,9
144,216,360,35,-0.1,0,Clear,22.0,2022-11-20 10:00:00,10
130,205,335,34,0.6,0,Clear,22.5,2022-11-20 11:00:00,11
156,238,394,32,1.4,0,Clear,21.5,2022-11-20 12:00:00,12
162,277,439,31,2.2,0,Clear,21.4,2022-11-20 13:00:00,13
143,265,408,30,2.8,0,Clear,20.8,2022-11-20 14:00:00,14
150,259,409,30,3.1,0,Clear,20.0,2022-11-20 15:00:00,15
134,257,391,29,3.1,0,Clear,18.5,2022-11-20 16:00:00,16
100,202,302,28,2.7,0,Clear,15.1,2022-11-20 17:00:00,17
58,181,239,31,1.7,0,Clear,8.2,2022-11-20 18:00:00,18
48,107,155,36,0.6,0,Clear,8.6,2022-11-20 19:00:00,19
39,89,128,47,-0.7,0,Clear,8.1,2022-11-20 20:00:00,20
38,70,108,55,-2.0,0,Clear,7.6,2022-11-20 21:00:00,21
36,53,89,55,-2.5,0,Clear,8.2,2022-11-20 22:00:00,22
11,22,33,53,-2.5,0,Clear,8.2,2022-11-20 23:00:00,23
11,13,24,52,-2.5,0,Clear,7.9,2022-11-21 00:00:00,0
4,4,8,49,-2.0,0,Clear,6.9,2022-11-21 01:00:00,1
3,5,8,46,-1.4,0,Clear,5.7,2022-11-21 02:00:00,2
1,4,5,41,-0.5,0,Clear,2.5,2022-11-21 03:00:00,3
2,7,9,55,-2.8,0,Clear,4.6,2022-11-21 04:00:00,4
12,42,54,57,-2.4,0,Clear,6.7,2022-11-21 05:00:00,5
28,110,138,58,-2.4,0,Clear,4.8,2022-11-21 06:00:00,6
45,270,315,58,-2.1,0,Clear,5.4,2022-11-21 07:00:00,7
87,414,501,62,-2.5,0,Clear,5.2,2022-11-21 08:00:00,8
64,256,320,62,-1.5,0,Clear,5.8,2022-11-21 09:00:00,9
84,187,271,46,1.6,0,Clear,7.1,2022-11-21 10:00:00,10
84,211,295,39,3.2,0,Clear,8.9,2022-11-21 11:00:00,11
117,231,348,37,4.7,0,Clear,10.1,2022-11-21 12:00:00,12
194,277,471,37,5.9,0,Clear,11.3,2022-11-21 13:00:00,13
116,265,381,37,6.8,0,Clear,13.2,2022-11-21 14:00:00,14
164,327,491,40,7.1,0,Clear,14.2,2022-11-21 15:00:00,15
220,427,647,41,7.2,0,Clear,12.7,2022-11-21 16:00:00,16
170,522,692,46,6.4,0,Clear,9.7,2022-11-21 17:00:00,17
109,384,493,52,4.5,0,Clear,9.7,2022-11-21 18:00:00,18
103,298,401,56,3.6,0,Clear,12.1,2022-11-21 19:00:00,19
49,212,261,55,3.4,0,Clear,13.0,2022-11-21 20:00:00,20
53,136,189,53,3.3,0,Clear,14.5,2022-11-21 21:00:00,21
41,97,138,53,3.0,0,Clear,14.1,2022-11-21 22:00:00,22
17,45,62,54,2.6,0,Clear,13.0,2022-11-21 23:00:00,23
11,21,32,57,2.0,0,Clear,11.6,2022-11-22 00:00:00,0
6,8,14,63,1.1,0,Clear,9.0,2022-11-22 01:00:00,1
2,4,6,71,-0.1,0,Clear,8.3,2022-11-22 02:00:00,2
2,4,6,72,-0.6,0,Clear,8.3,2022-11-22 03:00:00,3
7,8,15,72,-0.8,0,Clear,8.2,2022-11-22 04:00:00,4
11,51,62,73,-1.0,0,Clear,8.2,2022-11-22 05:00:00,5
21,106,127,72,-0.8,0,Clear,9.4,2022-11-22 06:00:00,6
53,301,354,68,-0.0,0,Clear,8.7,2022-11-22 07:00:00,7
101,437,538,65,0.6,0,Clear,7.9,2022-11-22 08:00:00,8
105,314,419,66,1.4,0,Clear,5.0,2022-11-22 09:00:00,9
142,191,333,66,4.0,0,Clear,3.4,2022-11-22 10:00:00,10
147,200,347,51,7.1,0,Clear,0.8,2022-11-22 11:00:00,11
182,288,470,41,9.0,0,Clear,0.8,2022-11-22 12:00:00,12
160,287,447,37,10.2,0,Clear,2.1,2022-11-22 13:00:00,13
157,295,452,36,11.1,0,Clear,4.9,2022-11-22 14:00:00,14
219,366,585,33,12.3,0,Clear,7.8,2022-11-22 15:00:00,15
233,446,679,35,12.1,0,Clear,8.4,2022-11-22 16:00:00,16
209,544,753,43,10.7,0,Clear,6.1,2022-11-22 17:00:00,17
128,364,492,49,8.6,0,Clear,8.7,2022-11-22 18:00:00,18
119,285,404,56,6.9,0,Clear,8.4,2022-11-22 19:00:00,19
58,225,283,64,5.4,0,Clear,9.5,2022-11-22 20:00:00,20
51,147,198,70,4.3,0,Clear,10.1,2022-11-22 21:00:00,21
69,99,168,75,3.4,0,Clear,10.0,2022-11-22 22:00:00,22
37,61,98,78,2.5,0,Clear,9.1,2022-11-22 23:00:00,23
21,33,54,80,1.8,0,Clear,9.2,2022-11-23 00:00:00,0
5,10,15,81,1.1,0,Clear,8.3,2022-11-23 01:00:00,1
4,8,12,82,0.6,0,Clear,7.6,2022-11-23 02:00:00,2
4,6,10,78,0.1,0,Clear,8.4,2022-11-23 03:00:00,3
3,10,13,79,-0.3,0,Clear,8.5,2022-11-23 04:00:00,4
9,36,45,78,-0.5,0,Clear,8.7,2022-11-23 05:00:00,5
28,93,121,77,-0.5,0,Clear,10.1,2022-11-23 06:00:00,6
40,177,217,75,-0.6,0,Clear,10.0,2022-11-23 07:00:00,7
62,261,323,75,-0.7,0,Clear,9.2,2022-11-23 08:00:00,8
103,222,325,76,0.5,0,Clear,8.0,2022-11-23 09:00:00,9
142,189,331,61,5.7,0,Clear,7.7,2022-11-23 10:00:00,10
181,262,443,48,9.3,0,Clear,6.0,2022-11-23 11:00:00,11
267,321,588,42,11.4,0,Clear,7.1,2022-11-23 12:00:00,12
296,357,653,40,12.5,0,Clear,8.4,2022-11-23 13:00:00,13
278,428,706,40,13.2,0,Clear,8.4,2022-11-23 14:00:00,14
305,349,654,37,14.4,0,Clear,7.4,2022-11-23 15:00:00,15
331,487,818,40,14.1,0,Clear,6.4,2022-11-23 16:00:00,16
193,388,581,50,12.9,0,Clear,6.2,2022-11-23 17:00:00,17
110,306,416,66,10.5,0,Clear,6.4,2022-11-23 18:00:00,18
109,227,336,64,9.2,0,Clear,6.2,2022-11-23 19:00:00,19
81,145,226,65,8.4,0,Clear,4.7,2022-11-23 20:00:00,20
47,108,155,68,7.6,0,Clear,3.3,2022-11-23 21:00:00,21
61,118,179,72,6.5,0,Clear,3.5,2022-11-23 22:00:00,22
52,72,124,76,5.5,0,Clear,5.1,2022-11-23 23:00:00,23
23,52,75,78,4.8,0,Clear,6.2,2022-11-24 00:00:00,0
26,21,47,84,3.3,0,Clear,5.9,2022-11-24 01:00:00,1
18,18,36,87,2.0,0,Clear,4.7,2022-11-24 02:00:00,2
9,14,23,81,2.7,0,Clear,5.2,2022-11-24 03:00:00,3
6,8,14,86,1.5,0,Clear,5.8,2022-11-24 04:00:00,4
4,14,18,88,0.8,0,Clear,6.3,2022-11-24 05:00:00,5
12,23,35,88,0.8,0,Clear,7.7,2022-11-24 06:00:00,6
23,66,89,90,0.3,0,Clear,7.9,2022-11-24 07:00:00,7
81,111,192,90,0.2,1,Mostly Clear,8.4,2022-11-24 08:00:00,8
118,124,242,90,1.6,1,Mostly Clear,6.9,2022-11-24 09:00:00,9
181,158,339,82,6.0,0,Clear,5.7,2022-11-24 10:00:00,10
225,208,433,66,9.4,0,Clear,4.8,2022-11-24 11:00:00,11
190,209,399,57,11.5,0,Clear,5.7,2022-11-24 12:00:00,12
238,212,450,50,12.9,1,Mostly Clear,6.6,2022-11-24 13:00:00,13
253,179,432,47,13.6,1,Mostly Clear,7.2,2022-11-24 14:00:00,14
255,152,407,44,14.0,0,Clear,8.3,2022-11-24 15:00:00,15
245,149,394,46,13.6,0,Clear,8.7,2022-11-24 16:00:00,16
141,111,252,54,12.2,0,Clear,7.4,2022-11-24 17:00:00,17
61,90,151,62,10.2,0,Clear,8.9,2022-11-24 18:00:00,18
59,61,120,70,8.6,0,Clear,9.5,2022-11-24 19:00:00,19
34,34,68,77,7.5,0,Clear,10.8,2022-11-24 20:00:00,20
44,83,127,83,6.7,0,Clear,10.3,2022-11-24 21:00:00,21
39,63,102,87,6.1,0,Clear,11.3,2022-11-24 22:00:00,22
17,35,52,90,5.7,1,Mostly Clear,12.4,2022-11-24 23:00:00,23
6,26,32,92,5.3,1,Mostly Clear,9.8,2022-11-25 00:00:00,0
15,21,36,93,5.2,1,Mostly Clear,9.8,2022-11-25 01:00:00,1
11,5,16,93,5.3,1,Mostly Clear,10.9,2022-11-25 02:00:00,2
8,3,11,93,5.7,2,Partly Cloudy,11.2,2022-11-25 03:00:00,3
1,7,8,91,6.3,3,Cloudy,11.2,2022-11-25 04:00:00,4
6,10,16,88,6.7,3,Cloudy,11.1,2022-11-25 05:00:00,5
4,13,17,84,7.2,3,Cloudy,8.7,2022-11-25 06:00:00,6
8,33,41,79,7.5,3,Cloudy,6.8,2022-11-25 07:00:00,7
13,52,65,78,7.6,51,Light Drizzle,8.8,2022-11-25 08:00:00,8
37,53,90,80,7.7,51,Light Drizzle,9.0,2022-11-25 09:00:00,9
80,106,186,81,8.2,51,Light Drizzle,10.5,2022-11-25 10:00:00,10
106,143,249,86,8.1,51,Light Drizzle,9.8,2022-11-25 11:00:00,11
203,219,422,88,8.2,51,Light Drizzle,9.1,2022-11-25 12:00:00,12
307,313,620,85,9.6,0,Clear,10.2,2022-11-25 13:00:00,13
261,244,505,82,11.3,0,Clear,13.2,2022-11-25 14:00:00,14
293,227,520,61,15.1,2,Partly Cloudy,23.2,2022-11-25 15:00:00,15
256,290,546,59,14.7,1,Mostly Clear,18.8,2022-11-25 16:00:00,16
168,241,409,57,14.0,1,Mostly Clear,20.0,2022-11-25 17:00:00,17
105,175,280,56,12.4,0,Clear,14.3,2022-11-25 18:00:00,18
93,176,269,56,10.8,0,Clear,13.4,2022-11-25 19:00:00,19
76,107,183,54,9.6,0,Clear,12.0,2022-11-25 20:00:00,20
64,113,177,55,8.8,0,Clear,12.7,2022-11-25 21:00:00,21
60,74,134,57,8.1,0,Clear,14.8,2022-11-25 22:00:00,22
60,67,127,58,7.5,0,Clear,14.0,2022-11-25 23:00:00,23
33,42,75,60,6.8,0,Clear,12.8,2022-11-26 00:00:00,0
27,33,60,61,6.1,0,Clear,12.7,2022-11-26 01:00:00,1
22,20,42,63,5.6,0,Clear,13.1,2022-11-26 02:00:00,2
12,10,22,66,5.8,0,Clear,13.0,2022-11-26 03:00:00,3
3,5,8,66,5.3,0,Clear,12.5,2022-11-26 04:00:00,4
5,13,18,69,4.7,0,Clear,10.5,2022-11-26 05:00:00,5
25,17,42,76,3.5,0,Clear,7.9,2022-11-26 06:00:00,6
21,55,76,81,2.4,0,Clear,8.3,2022-11-26 07:00:00,7
65,126,191,84,1.7,0,Clear,8.3,2022-11-26 08:00:00,8
129,188,317,84,2.4,0,Clear,8.8,2022-11-26 09:00:00,9
258,235,493,68,6.4,0,Clear,8.4,2022-11-26 10:00:00,10
300,254,554,59,8.7,0,Clear,9.3,2022-11-26 11:00:00,11
388,311,699,53,10.4,0,Clear,10.5,2022-11-26 12:00:00,12
436,353,789,49,11.7,0,Clear,11.2,2022-11-26 13:00:00,13
441,317,758,46,12.8,0,Clear,11.5,2022-11-26 14:00:00,14
403,367,770,43,14.1,0,Clear,11.3,2022-11-26 15:00:00,15
415,384,799,43,14.2,0,Clear,9.8,2022-11-26 16:00:00,16
220,280,500,50,13.2,0,Clear,5.3,2022-11-26 17:00:00,17
119,186,305,61,11.3,1,Mostly Clear,5.2,2022-11-26 18:00:00,18
131,182,313,66,9.1,1,Mostly Clear,6.8,2022-11-26 19:00:00,19
93,120,213,70,7.5,1,Mostly Clear,7.2,2022-11-26 20:00:00,20
74,117,191,72,6.6,1,Mostly Clear,8.3,2022-11-26 21:00:00,21
66,106,172,72,6.2,1,Mostly Clear,9.4,2022-11-26 22:00:00,22
41,83,124,73,5.8,1,Mostly Clear,9.2,2022-11-26 23:00:00,23
43,59,102,74,5.6,1,Mostly Clear,10.2,2022-11-27 00:00:00,0
42,42,84,74,5.6,1,Mostly Clear,11.2,2022-11-27 01:00:00,1
24,28,52,72,6.0,1,Mostly Clear,9.8,2022-11-27 02:00:00,2
25,18,43,68,6.5,1,Mostly Clear,11.2,2022-11-27 03:00:00,3
7,8,15,68,6.9,1,Mostly Clear,12.0,2022-11-27 04:00:00,4
9,11,20,68,7.3,2,Partly Cloudy,11.5,2022-11-27 05:00:00,5
15,18,33,69,7.5,3,Cloudy,10.1,2022-11-27 06:00:00,6
21,49,70,69,7.8,3,Cloudy,9.8,2022-11-27 07:00:00,7
36,80,116,69,8.2,3,Cloudy,11.5,2022-11-27 08:00:00,8
58,135,193,69,8.8,3,Cloudy,15.5,2022-11-27 09:00:00,9
83,151,234,77,8.9,51,Light Drizzle,13.7,2022-11-27 10:00:00,10
25,96,121,91,8.8,55,Heavy Drizzle,15.3,2022-11-27 11:00:00,11
23,80,103,94,8.9,63,Rain,15.5,2022-11-27 12:00:00,12
50,112,162,95,9.3,63,Rain,15.5,2022-11-27 13:00:00,13
45,120,165,96,10.6,53,Heavy Drizzle,15.0,2022-11-27 14:00:00,14
58,142,200,98,11.1,61,Light Rain,15.8,2022-11-27 15:00:00,15
76,182,258,98,12.5,51,Light Drizzle,14.1,2022-11-27 16:00:00,16
79,173,252,98,13.5,51,Light Drizzle,12.5,2022-11-27 17:00:00,17
57,167,224,100,14.1,51,Light Drizzle,14.3,2022-11-27 18:00:00,18
69,157,226,98,15.0,3,Cloudy,17.8,2022-11-27 19:00:00,19
47,105,152,96,15.4,2,Partly Cloudy,17.1,2022-11-27 20:00:00,20
37,100,137,95,14.7,3,Cloudy,15.0,2022-11-27 21:00:00,21
31,97,128,96,13.7,3,Cloudy,11.9,2022-11-27 22:00:00,22
31,45,76,96,13.1,3,Cloudy,9.0,2022-11-27 23:00:00,23
4,25,29,96,12.1,2,Partly Cloudy,8.7,2022-11-28 00:00:00,0
10,15,25,95,11.6,2,Partly Cloudy,8.0,2022-11-28 01:00:00,1
5,5,10,94,10.9,1,Mostly Clear,9.6,2022-11-28 02:00:00,2
8,12,20,95,11.0,1,Mostly Clear,12.0,2022-11-28 03:00:00,3
3,13,16,93,10.8,0,Clear,12.6,2022-11-28 04:00:00,4
13,46,59,92,10.2,0,Clear,12.6,2022-11-28 05:00:00,5
31,128,159,92,9.7,0,Clear,13.0,2022-11-28 06:00:00,6
76,317,393,91,9.5,0,Clear,12.8,2022-11-28 07:00:00,7
142,574,716,91,9.4,0,Clear,13.9,2022-11-28 08:00:00,8
102,357,459,89,9.7,0,Clear,17.8,2022-11-28 09:00:00,9
97,219,316,79,10.1,0,Clear,20.2,2022-11-28 10:00:00,10
86,235,321,62,10.1,1,Mostly Clear,21.6,2022-11-28 11:00:00,11
120,308,428,57,10.2,1,Mostly Clear,20.7,2022-11-28 12:00:00,12
153,287,440,55,10.6,2,Partly Cloudy,19.4,2022-11-28 13:00:00,13
157,253,410,54,10.9,3,Cloudy,18.4,2022-11-28 14:00:00,14
152,331,483,53,11.6,3,Cloudy,17.3,2022-11-28 15:00:00,15
153,449,602,53,11.4,3,Cloudy,16.3,2022-11-28 16:00:00,16
209,624,833,53,11.1,3,Cloudy,13.0,2022-11-28 17:00:00,17
158,481,639,54,10.6,2,Partly Cloudy,9.7,2022-11-28 18:00:00,18
114,369,483,56,10.2,2,Partly Cloudy,8.7,2022-11-28 19:00:00,19
68,268,336,57,9.9,2,Partly Cloudy,8.0,2022-11-28 20:00:00,20
59,183,242,60,9.2,2,Partly Cloudy,7.9,2022-11-28 21:00:00,21
53,106,159,68,8.1,2,Partly Cloudy,7.9,2022-11-28 22:00:00,22
30,59,89,75,6.6,1,Mostly Clear,7.6,2022-11-28 23:00:00,23
8,25,33,80,5.6,1,Mostly Clear,7.6,2022-11-29 00:00:00,0
1,12,13,80,5.5,1,Mostly Clear,5.9,2022-11-29 01:00:00,1
3,5,8,81,5.0,2,Partly Cloudy,5.6,2022-11-29 02:00:00,2
2,7,9,88,4.1,1,Mostly Clear,6.0,2022-11-29 03:00:00,3
3,10,13,89,3.8,1,Mostly Clear,5.1,2022-11-29 04:00:00,4
18,62,80,87,3.9,1,Mostly Clear,6.0,2022-11-29 05:00:00,5
40,147,187,84,4.6,1,Mostly Clear,6.6,2022-11-29 06:00:00,6
82,427,509,87,4.1,1,Mostly Clear,5.9,2022-11-29 07:00:00,7
179,700,879,91,3.1,2,Partly Cloudy,5.8,2022-11-29 08:00:00,8
112,423,535,91,3.5,3,Cloudy,7.3,2022-11-29 09:00:00,9
92,242,334,80,7.1,3,Cloudy,6.8,2022-11-29 10:00:00,10
86,248,334,66,9.0,3,Cloudy,7.9,2022-11-29 11:00:00,11
133,289,422,58,10.1,3,Cloudy,8.4,2022-11-29 12:00:00,12
133,394,527,56,10.7,3,Cloudy,9.0,2022-11-29 13:00:00,13
135,290,425,56,11.0,1,Mostly Clear,9.2,2022-11-29 14:00:00,14
143,316,459,58,10.9,1,Mostly Clear,9.2,2022-11-29 15:00:00,15
192,548,740,59,10.8,1,Mostly Clear,10.3,2022-11-29 16:00:00,16
213,716,929,62,10.1,1,Mostly Clear,10.5,2022-11-29 17:00:00,17
197,572,769,67,8.8,1,Mostly Clear,8.8,2022-11-29 18:00:00,18
115,399,514,71,7.8,1,Mostly Clear,9.7,2022-11-29 19:00:00,19
82,267,349,74,7.2,1,Mostly Clear,11.5,2022-11-29 20:00:00,20
69,183,252,75,6.9,1,Mostly Clear,13.2,2022-11-29 21:00:00,21
67,151,218,76,6.8,1,Mostly Clear,11.8,2022-11-29 22:00:00,22
44,74,118,76,6.8,1,Mostly Clear,11.8,2022-11-29 23:00:00,23
14,36,50,79,6.8,1,Mostly Clear,12.7,2022-11-30 00:00:00,0
11,9,20,81,6.9,1,Mostly Clear,13.8,2022-11-30 01:00:00,1
8,2,10,83,7.2,2,Partly Cloudy,14.0,2022-11-30 02:00:00,2
7,4,11,87,7.5,3,Cloudy,13.4,2022-11-30 03:00:00,3
2,11,13,88,7.8,2,Partly Cloudy,14.0,2022-11-30 04:00:00,4
13,31,44,89,8.1,3,Cloudy,15.2,2022-11-30 05:00:00,5
12,68,80,88,8.5,3,Cloudy,11.1,2022-11-30 06:00:00,6
25,147,172,87,9.2,51,Light Drizzle,12.4,2022-11-30 07:00:00,7
57,287,344,93,9.3,55,Heavy Drizzle,16.0,2022-11-30 08:00:00,8
40,169,209,95,9.6,61,Light Rain,16.6,2022-11-30 09:00:00,9
46,124,170,95,10.0,63,Rain,19.1,2022-11-30 10:00:00,10
48,170,218,94,10.6,61,Light Rain,22.3,2022-11-30 11:00:00,11
79,252,331,93,11.5,53,Heavy Drizzle,24.7,2022-11-30 12:00:00,12
76,242,318,93,12.4,55,Heavy Drizzle,25.7,2022-11-30 13:00:00,13
97,263,360,93,12.8,51,Light Drizzle,27.1,2022-11-30 14:00:00,14
97,258,355,90,13.4,53,Heavy Drizzle,24.7,2022-11-30 15:00:00,15
130,407,537,89,13.9,53,Heavy Drizzle,21.4,2022-11-30 16:00:00,16
182,681,863,91,12.8,53,Heavy Drizzle,24.6,2022-11-30 17:00:00,17
163,611,774,70,9.9,1,Mostly Clear,18.7,2022-11-30 18:00:00,18
120,428,548,55,9.1,0,Clear,19.1,2022-11-30 19:00:00,19
70,277,347,46,8.1,0,Clear,21.1,2022-11-30 20:00:00,20
68,186,254,41,7.3,0,Clear,21.5,2022-11-30 21:00:00,21
52,143,195,36,6.4,0,Clear,21.4,2022-11-30 22:00:00,22
40,66,106,34,5.6,0,Clear,19.8,2022-11-30 23:00:00,23
20,33,53,35,4.8,0,Clear,19.0,2022-12-01 00:00:00,0
10,10,20,36,4.2,0,Clear,18.2,2022-12-01 01:00:00,1
4,7,11,37,3.6,0,Clear,18.5,2022-12-01 02:00:00,2
2,4,6,41,4.2,0,Clear,18.5,2022-12-01 03:00:00,3
3,16,19,42,3.6,0,Clear,18.1,2022-12-01 04:00:00,4
17,53,70,42,3.0,0,Clear,17.2,2022-12-01 05:00:00,5
42,147,189,42,2.4,0,Clear,14.0,2022-12-01 06:00:00,6
92,420,512,42,1.8,0,Clear,12.4,2022-12-01 07:00:00,7
159,634,793,44,1.2,0,Clear,10.1,2022-12-01 08:00:00,8
106,376,482,49,1.1,0,Clear,9.5,2022-12-01 09:00:00,9
88,240,328,44,2.0,0,Clear,10.7,2022-12-01 10:00:00,10
97,225,322,42,3.0,0,Clear,13.2,2022-12-01 11:00:00,11
73,253,326,41,4.0,0,Clear,14.6,2022-12-01 12:00:00,12
96,285,381,40,5.0,0,Clear,16.3,2022-12-01 13:00:00,13
107,282,389,38,5.8,0,Clear,16.8,2022-12-01 14:00:00,14
131,317,448,39,6.5,0,Clear,15.8,2022-12-01 15:00:00,15
182,466,648,38,6.6,0,Clear,14.5,2022-12-01 16:00:00,16
206,660,866,38,6.1,0,Clear,11.8,2022-12-01 17:00:00,17
195,592,787,42,4.9,0,Clear,7.1,2022-12-01 18:00:00,18
122,398,520,46,3.7,1,Mostly Clear,7.0,2022-12-01 19:00:00,19
101,264,365,53,2.6,1,Mostly Clear,6.8,2022-12-01 20:00:00,20
68,218,286,62,1.4,1,Mostly Clear,7.8,2022-12-01 21:00:00,21
68,123,191,63,1.1,1,Mostly Clear,6.8,2022-12-01 22:00:00,22
36,83,119,59,1.3,0,Clear,6.5,2022-12-01 23:00:00,23
20,49,69,65,0.3,0,Clear,5.4,2022-12-02 00:00:00,0
10,23,33,66,0.2,0,Clear,5.4,2022-12-02 01:00:00,1
3,10,13,62,1.2,0,Clear,5.0,2022-12-02 02:00:00,2
5,3,8,63,0.8,0,Clear,4.5,2022-12-02 03:00:00,3
1,10,11,72,-0.6,0,Clear,6.3,2022-12-02 04:00:00,4
18,40,58,77,-1.3,0,Clear,5.7,2022-12-02 05:00:00,5
30,119,149,79,-1.7,0,Clear,5.0,2022-12-02 06:00:00,6
56,287,343,81,-2.1,0,Clear,6.3,2022-12-02 07:00:00,7
126,495,621,82,-2.1,0,Clear,6.5,2022-12-02 08:00:00,8
134,332,466,85,-1.3,0,Clear,8.7,2022-12-02 09:00:00,9
99,241,340,75,3.1,0,Clear,8.8,2022-12-02 10:00:00,10
98,283,381,65,5.5,0,Clear,10.8,2022-12-02 11:00:00,11
140,339,479,56,7.0,0,Clear,12.1,2022-12-02 12:00:00,12
166,376,542,50,8.1,0,Clear,12.3,2022-12-02 13:00:00,13
158,334,492,46,8.7,0,Clear,11.9,2022-12-02 14:00:00,14
203,415,618,46,8.9,0,Clear,11.5,2022-12-02 15:00:00,15
232,498,730,46,8.9,0,Clear,10.9,2022-12-02 16:00:00,16
248,555,803,51,7.8,0,Clear,9.0,2022-12-02 17:00:00,17
179,489,668,58,6.2,1,Mostly Clear,9.7,2022-12-02 18:00:00,18
143,337,480,62,5.3,1,Mostly Clear,10.5,2022-12-02 19:00:00,19
109,226,335,65,4.9,1,Mostly Clear,10.7,2022-12-02 20:00:00,20
112,201,313,66,4.6,1,Mostly Clear,12.5,2022-12-02 21:00:00,21
84,164,248,64,4.8,2,Partly Cloudy,12.8,2022-12-02 22:00:00,22
85,134,219,61,5.1,1,Mostly Clear,12.6,2022-12-02 23:00:00,23
71,99,170,62,5.5,2,Partly Cloudy,13.4,2022-12-03 00:00:00,0
52,66,118,66,5.9,3,Cloudy,15.7,2022-12-03 01:00:00,1
21,41,62,72,6.9,3,Cloudy,18.3,2022-12-03 02:00:00,2
9,11,20,77,8.5,3,Cloudy,19.1,2022-12-03 03:00:00,3
3,8,11,82,9.2,2,Partly Cloudy,18.6,2022-12-03 04:00:00,4
8,11,19,88,9.4,55,Heavy Drizzle,18.6,2022-12-03 05:00:00,5
19,24,43,92,9.6,61,Light Rain,20.1,2022-12-03 06:00:00,6
11,59,70,94,9.9,51,Light Drizzle,19.8,2022-12-03 07:00:00,7
20,80,100,95,10.3,53,Heavy Drizzle,20.2,2022-12-03 08:00:00,8
77,163,240,95,10.7,61,Light Rain,21.3,2022-12-03 09:00:00,9
53,150,203,95,11.3,55,Heavy Drizzle,23.1,2022-12-03 10:00:00,10
97,218,315,95,11.9,61,Light Rain,25.9,2022-12-03 11:00:00,11
198,382,580,95,12.5,53,Heavy Drizzle,26.9,2022-12-03 12:00:00,12
283,420,703,95,13.0,51,Light Drizzle,26.8,2022-12-03 13:00:00,13
293,423,716,92,13.8,3,Cloudy,23.7,2022-12-03 14:00:00,14
308,442,750,83,15.5,2,Partly Cloudy,18.8,2022-12-03 15:00:00,15
346,445,791,82,15.9,1,Mostly Clear,19.2,2022-12-03 16:00:00,16
254,409,663,80,15.6,51,Light Drizzle,15.9,2022-12-03 17:00:00,17
257,375,632,85,14.3,51,Light Drizzle,11.5,2022-12-03 18:00:00,18
163,291,454,90,13.0,51,Light Drizzle,11.0,2022-12-03 19:00:00,19
189,269,458,78,11.7,1,Mostly Clear,12.0,2022-12-03 20:00:00,20
125,183,308,67,10.3,0,Clear,15.4,2022-12-03 21:00:00,21
89,193,282,64,9.1,0,Clear,16.4,2022-12-03 22:00:00,22
105,181,286,61,8.0,0,Clear,16.1,2022-12-03 23:00:00,23
65,106,171,60,7.0,0,Clear,15.2,2022-12-04 00:00:00,0
62,88,150,60,6.0,0,Clear,13.6,2022-12-04 01:00:00,1
40,53,93,62,5.0,0,Clear,12.5,2022-12-04 02:00:00,2
15,19,34,67,5.0,0,Clear,13.2,2022-12-04 03:00:00,3
6,11,17,64,4.4,0,Clear,14.7,2022-12-04 04:00:00,4
9,8,17,62,3.7,0,Clear,15.6,2022-12-04 05:00:00,5
11,30,41,60,3.1,0,Clear,12.7,2022-12-04 06:00:00,6
20,56,76,59,2.5,0,Clear,11.0,2022-12-04 07:00:00,7
50,137,187,62,1.9,0,Clear,8.6,2022-12-04 08:00:00,8
129,223,352,72,1.3,0,Clear,7.0,2022-12-04 09:00:00,9
161,309,470,58,3.1,0,Clear,8.3,2022-12-04 10:00:00,10
198,335,533,53,4.1,1,Mostly Clear,8.9,2022-12-04 11:00:00,11
267,436,703,50,5.1,1,Mostly Clear,6.9,2022-12-04 12:00:00,12
261,389,650,47,6.1,0,Clear,6.6,2022-12-04 13:00:00,13
248,404,652,45,6.8,0,Clear,7.0,2022-12-04 14:00:00,14
231,419,650,43,7.7,1,Mostly Clear,7.0,2022-12-04 15:00:00,15
235,423,658,42,7.7,0,Clear,7.3,2022-12-04 16:00:00,16
153,332,485,43,7.3,0,Clear,5.1,2022-12-04 17:00:00,17
93,253,346,61,5.9,0,Clear,4.2,2022-12-04 18:00:00,18
105,175,280,67,3.9,0,Clear,2.2,2022-12-04 19:00:00,19
60,137,197,72,2.6,0,Clear,3.3,2022-12-04 20:00:00,20
41,121,162,73,2.3,0,Clear,4.8,2022-12-04 21:00:00,21
44,111,155,73,2.2,0,Clear,5.4,2022-12-04 22:00:00,22
25,56,81,80,0.9,0,Clear,6.5,2022-12-04 23:00:00,23
8,24,32,80,0.8,0,Clear,6.6,2022-12-05 00:00:00,0
6,7,13,77,1.9,0,Clear,7.1,2022-12-05 01:00:00,1
2,1,3,78,2.0,0,Clear,7.5,2022-12-05 02:00:00,2
3,6,9,82,0.2,0,Clear,8.1,2022-12-05 03:00:00,3
5,7,12,87,-0.8,0,Clear,7.1,2022-12-05 04:00:00,4
14,48,62,90,-1.1,0,Clear,7.1,2022-12-05 05:00:00,5
29,139,168,91,-1.1,0,Clear,8.3,2022-12-05 06:00:00,6
57,318,375,93,-1.4,0,Clear,8.0,2022-12-05 07:00:00,7
130,496,626,94,-1.8,0,Clear,8.0,2022-12-05 08:00:00,8
103,350,453,95,-1.2,1,Mostly Clear,6.1,2022-12-05 09:00:00,9
84,182,266,88,2.8,1,Mostly Clear,6.2,2022-12-05 10:00:00,10
82,221,303,74,5.4,1,Mostly Clear,6.5,2022-12-05 11:00:00,11
87,242,329,64,6.8,1,Mostly Clear,8.0,2022-12-05 12:00:00,12
119,297,416,57,7.7,1,Mostly Clear,10.0,2022-12-05 13:00:00,13
119,248,367,52,8.1,0,Clear,10.5,2022-12-05 14:00:00,14
139,333,472,54,8.1,0,Clear,10.9,2022-12-05 15:00:00,15
148,434,582,56,7.7,0,Clear,9.1,2022-12-05 16:00:00,16
166,592,758,63,6.2,0,Clear,7.9,2022-12-05 17:00:00,17
129,528,657,69,4.5,0,Clear,8.2,2022-12-05 18:00:00,18
105,345,450,74,3.5,0,Clear,8.9,2022-12-05 19:00:00,19
64,265,329,77,3.1,0,Clear,8.4,2022-12-05 20:00:00,20
59,181,240,82,2.8,0,Clear,8.6,2022-12-05 21:00:00,21
33,121,154,86,2.5,0,Clear,7.6,2022-12-05 22:00:00,22
31,66,97,89,2.2,0,Clear,7.9,2022-12-05 23:00:00,23
13,17,30,91,2.0,0,Clear,9.2,2022-12-06 00:00:00,0
4,8,12,93,1.8,1,Mostly Clear,9.4,2022-12-06 01:00:00,1
8,3,11,94,1.7,1,Mostly Clear,8.4,2022-12-06 02:00:00,2
1,5,6,94,1.8,1,Mostly Clear,8.7,2022-12-06 03:00:00,3
1,13,14,95,2.4,3,Cloudy,7.5,2022-12-06 04:00:00,4
17,51,68,96,3.3,3,Cloudy,6.0,2022-12-06 05:00:00,5
38,149,187,96,4.1,3,Cloudy,1.3,2022-12-06 06:00:00,6
87,362,449,96,4.6,3,Cloudy,3.2,2022-12-06 07:00:00,7
92,325,417,96,4.8,3,Cloudy,3.7,2022-12-06 08:00:00,8
49,188,237,96,5.1,51,Light Drizzle,2.5,2022-12-06 09:00:00,9
45,164,209,94,5.4,51,Light Drizzle,2.9,2022-12-06 10:00:00,10
58,187,245,96,6.5,53,Heavy Drizzle,2.9,2022-12-06 11:00:00,11
55,172,227,96,6.8,51,Light Drizzle,1.3,2022-12-06 12:00:00,12
55,200,255,95,7.4,53,Heavy Drizzle,2.6,2022-12-06 13:00:00,13
72,187,259,96,8.0,51,Light Drizzle,4.0,2022-12-06 14:00:00,14
96,246,342,97,6.6,53,Heavy Drizzle,4.8,2022-12-06 15:00:00,15
96,344,440,97,6.8,55,Heavy Drizzle,5.6,2022-12-06 16:00:00,16
105,328,433,97,7.1,61,Light Rain,7.2,2022-12-06 17:00:00,17
120,409,529,97,7.1,61,Light Rain,6.9,2022-12-06 18:00:00,18
101,341,442,97,7.2,55,Heavy Drizzle,8.8,2022-12-06 19:00:00,19
51,231,282,97,7.5,53,Heavy Drizzle,10.1,2022-12-06 20:00:00,20
55,170,225,97,7.8,51,Light Drizzle,10.8,2022-12-06 21:00:00,21
44,134,178,97,8.2,51,Light Drizzle,10.2,2022-12-06 22:00:00,22
39,63,102,98,8.7,51,Light Drizzle,11.3,2022-12-06 23:00:00,23
16,29,45,98,9.2,51,Light Drizzle,10.2,2022-12-07 00:00:00,0
4,11,15,98,9.7,3,Cloudy,11.3,2022-12-07 01:00:00,1
8,2,10,98,10.2,3,Cloudy,11.1,2022-12-07 02:00:00,2
2,2,4,99,10.8,3,Cloudy,10.0,2022-12-07 03:00:00,3
3,8,11,99,11.0,3,Cloudy,9.5,2022-12-07 04:00:00,4
21,53,74,99,11.0,3,Cloudy,8.9,2022-12-07 05:00:00,5
36,153,189,99,11.0,3,Cloudy,4.1,2022-12-07 06:00:00,6
87,373,460,99,11.0,3,Cloudy,5.0,2022-12-07 07:00:00,7
155,549,704,99,11.0,3,Cloudy,6.1,2022-12-07 08:00:00,8
61,271,332,99,11.2,3,Cloudy,4.0,2022-12-07 09:00:00,9
54,147,201,99,11.7,3,Cloudy,4.7,2022-12-07 10:00:00,10
61,203,264,96,12.4,3,Cloudy,7.4,2022-12-07 11:00:00,11
105,252,357,95,13.0,3,Cloudy,8.3,2022-12-07 12:00:00,12
106,259,365,91,13.5,3,Cloudy,10.2,2022-12-07 13:00:00,13
125,237,362,92,14.0,51,Light Drizzle,8.8,2022-12-07 14:00:00,14
161,323,484,93,13.4,51,Light Drizzle,9.1,2022-12-07 15:00:00,15
132,454,586,93,13.6,3,Cloudy,7.4,2022-12-07 16:00:00,16
235,633,868,95,13.5,3,Cloudy,3.7,2022-12-07 17:00:00,17
220,634,854,97,13.1,51,Light Drizzle,4.6,2022-12-07 18:00:00,18
190,465,655,99,12.5,51,Light Drizzle,5.2,2022-12-07 19:00:00,19
104,307,411,99,12.3,3,Cloudy,5.4,2022-12-07 20:00:00,20
114,262,376,100,12.0,3,Cloudy,4.2,2022-12-07 21:00:00,21
92,186,278,100,11.7,3,Cloudy,5.4,2022-12-07 22:00:00,22
67,103,170,99,11.8,3,Cloudy,7.4,2022-12-07 23:00:00,23
29,41,70,98,12.4,3,Cloudy,10.0,2022-12-08 00:00:00,0
9,18,27,96,12.0,1,Mostly Clear,11.8,2022-12-08 01:00:00,1
7,7,14,96,11.5,1,Mostly Clear,12.1,2022-12-08 02:00:00,2
4,7,11,95,11.1,0,Clear,12.1,2022-12-08 03:00:00,3
7,12,19,95,10.4,0,Clear,10.8,2022-12-08 04:00:00,4
16,51,67,95,9.8,1,Mostly Clear,10.6,2022-12-08 05:00:00,5
32,143,175,96,9.4,1,Mostly Clear,10.2,2022-12-08 06:00:00,6
107,364,471,96,9.5,1,Mostly Clear,10.3,2022-12-08 07:00:00,7
209,736,945,96,9.7,2,Partly Cloudy,10.3,2022-12-08 08:00:00,8
120,398,518,95,9.9,2,Partly Cloudy,8.2,2022-12-08 09:00:00,9
108,245,353,94,10.2,2,Partly Cloudy,7.6,2022-12-08 10:00:00,10
104,269,373,84,10.4,2,Partly Cloudy,6.1,2022-12-08 11:00:00,11
125,323,448,77,10.7,3,Cloudy,8.2,2022-12-08 12:00:00,12
130,323,453,74,10.7,3,Cloudy,8.3,2022-12-08 13:00:00,13
154,264,418,73,10.6,3,Cloudy,6.2,2022-12-08 14:00:00,14
179,352,531,68,12.6,3,Cloudy,4.1,2022-12-08 15:00:00,15
195,527,722,68,12.5,3,Cloudy,3.8,2022-12-08 16:00:00,16
260,660,920,71,12.0,3,Cloudy,3.7,2022-12-08 17:00:00,17
217,586,803,74,11.1,2,Partly Cloudy,6.9,2022-12-08 18:00:00,18
150,442,592,76,10.3,2,Partly Cloudy,7.2,2022-12-08 19:00:00,19
130,305,435,75,9.8,1,Mostly Clear,6.9,2022-12-08 20:00:00,20
104,249,353,73,9.5,2,Partly Cloudy,8.0,2022-12-08 21:00:00,21
95,208,303,70,9.4,2,Partly Cloudy,9.4,2022-12-08 22:00:00,22
81,143,224,70,9.1,2,Partly Cloudy,9.3,2022-12-08 23:00:00,23
35,62,97,68,8.8,2,Partly Cloudy,9.2,2022-12-09 00:00:00,0
13,35,48,65,8.5,2,Partly Cloudy,9.3,2022-12-09 01:00:00,1
6,11,17,64,8.0,2,Partly Cloudy,9.5,2022-12-09 02:00:00,2
4,8,12,59,7.6,2,Partly Cloudy,9.6,2022-12-09 03:00:00,3
6,5,11,59,7.1,1,Mostly Clear,10.0,2022-12-09 04:00:00,4
11,41,52,62,6.1,0,Clear,9.6,2022-12-09 05:00:00,5
46,118,164,66,5.1,0,Clear,8.4,2022-12-09 06:00:00,6
65,276,341,70,4.3,0,Clear,8.4,2022-12-09 07:00:00,7
147,459,606,75,3.5,0,Clear,8.5,2022-12-09 08:00:00,8
109,360,469,78,3.3,0,Clear,8.7,2022-12-09 09:00:00,9
128,254,382,73,4.6,0,Clear,9.7,2022-12-09 10:00:00,10
114,276,390,67,5.8,0,Clear,10.1,2022-12-09 11:00:00,11
169,345,514,62,6.8,0,Clear,7.9,2022-12-09 12:00:00,12
213,353,566,57,7.6,0,Clear,7.0,2022-12-09 13:00:00,13
190,385,575,54,8.2,0,Clear,7.1,2022-12-09 14:00:00,14
204,397,601,51,8.6,0,Clear,7.1,2022-12-09 15:00:00,15
177,425,602,50,8.5,0,Clear,6.7,2022-12-09 16:00:00,16
235,569,804,50,8.0,0,Clear,5.9,2022-12-09 17:00:00,17
161,497,658,56,6.9,0,Clear,4.9,2022-12-09 18:00:00,18
171,381,552,66,5.3,0,Clear,4.7,2022-12-09 19:00:00,19
100,234,334,75,3.8,0,Clear,5.9,2022-12-09 20:00:00,20
78,195,273,79,2.8,0,Clear,6.1,2022-12-09 21:00:00,21
82,149,231,79,2.3,0,Clear,6.7,2022-12-09 22:00:00,22
93,152,245,80,1.9,0,Clear,7.2,2022-12-09 23:00:00,23
56,119,175,85,0.9,0,Clear,7.2,2022-12-10 00:00:00,0
37,87,124,86,0.3,0,Clear,7.8,2022-12-10 01:00:00,1
34,46,80,87,-0.0,0,Clear,6.8,2022-12-10 02:00:00,2
12,16,28,86,-0.5,0,Clear,6.7,2022-12-10 03:00:00,3
5,6,11,87,-0.8,0,Clear,7.8,2022-12-10 04:00:00,4
5,10,15,88,-0.8,0,Clear,8.5,2022-12-10 05:00:00,5
24,26,50,88,-0.6,0,Clear,8.2,2022-12-10 06:00:00,6
21,75,96,86,-0.6,0,Clear,6.4,2022-12-10 07:00:00,7
76,156,232,83,-0.1,1,Mostly Clear,7.9,2022-12-10 08:00:00,8
110,217,327,76,0.8,1,Mostly Clear,8.8,2022-12-10 09:00:00,9
148,298,446,65,2.2,2,Partly Cloudy,9.2,2022-12-10 10:00:00,10
185,345,530,57,3.5,1,Mostly Clear,8.2,2022-12-10 11:00:00,11
231,392,623,57,4.2,2,Partly Cloudy,7.1,2022-12-10 12:00:00,12
300,404,704,57,5.1,1,Mostly Clear,7.0,2022-12-10 13:00:00,13
244,369,613,58,5.7,1,Mostly Clear,5.5,2022-12-10 14:00:00,14
219,320,539,58,5.9,2,Partly Cloudy,4.2,2022-12-10 15:00:00,15
221,414,635,59,5.8,3,Cloudy,6.7,2022-12-10 16:00:00,16
141,353,494,61,5.7,3,Cloudy,6.8,2022-12-10 17:00:00,17
173,293,466,65,5.2,3,Cloudy,3.8,2022-12-10 18:00:00,18
120,219,339,69,4.9,3,Cloudy,3.9,2022-12-10 19:00:00,19
63,186,249,71,4.9,3,Cloudy,4.6,2022-12-10 20:00:00,20
61,132,193,74,4.9,3,Cloudy,6.6,2022-12-10 21:00:00,21
105,158,263,77,4.9,3,Cloudy,7.7,2022-12-10 22:00:00,22
69,112,181,79,4.9,3,Cloudy,6.9,2022-12-10 23:00:00,23
94,107,201,81,4.8,3,Cloudy,9.4,2022-12-11 00:00:00,0
52,72,124,83,4.7,3,Cloudy,9.0,2022-12-11 01:00:00,1
47,62,109,84,4.6,3,Cloudy,10.5,2022-12-11 02:00:00,2
20,20,40,84,4.8,3,Cloudy,9.0,2022-12-11 03:00:00,3
7,12,19,86,4.8,3,Cloudy,6.9,2022-12-11 04:00:00,4
9,16,25,87,4.8,51,Light Drizzle,6.9,2022-12-11 05:00:00,5
14,20,34,88,4.8,51,Light Drizzle,6.5,2022-12-11 06:00:00,6
23,81,104,89,4.8,51,Light Drizzle,7.2,2022-12-11 07:00:00,7
39,106,145,89,4.9,51,Light Drizzle,5.4,2022-12-11 08:00:00,8
74,179,253,91,5.0,3,Cloudy,5.1,2022-12-11 09:00:00,9
154,287,441,90,5.5,3,Cloudy,6.4,2022-12-11 10:00:00,10
153,314,467,88,6.5,3,Cloudy,5.7,2022-12-11 11:00:00,11
207,376,583,86,7.2,3,Cloudy,3.9,2022-12-11 12:00:00,12
207,357,564,81,8.2,3,Cloudy,3.7,2022-12-11 13:00:00,13
187,327,514,77,8.7,3,Cloudy,4.3,2022-12-11 14:00:00,14
226,359,585,82,7.6,3,Cloudy,5.4,2022-12-11 15:00:00,15
222,393,615,82,7.8,3,Cloudy,7.9,2022-12-11 16:00:00,16
145,340,485,83,7.6,3,Cloudy,4.8,2022-12-11 17:00:00,17
136,269,405,84,7.4,3,Cloudy,1.3,2022-12-11 18:00:00,18
69,214,283,86,7.0,3,Cloudy,2.9,2022-12-11 19:00:00,19
65,144,209,89,6.3,2,Partly Cloudy,4.3,2022-12-11 20:00:00,20
65,137,202,92,5.5,2,Partly Cloudy,5.4,2022-12-11 21:00:00,21
52,103,155,92,5.1,1,Mostly Clear,7.6,2022-12-11 22:00:00,22
31,64,95,93,4.9,1,Mostly Clear,6.5,2022-12-11 23:00:00,23
24,26,50,91,4.6,1,Mostly Clear,9.2,2022-12-12 00:00:00,0
10,11,21,90,4.0,0,Clear,11.0,2022-12-12 01:00:00,1
6,3,9,87,3.6,0,Clear,12.0,2022-12-12 02:00:00,2
4,4,8,89,3.2,0,Clear,12.6,2022-12-12 03:00:00,3
8,10,18,88,2.8,0,Clear,13.2,2022-12-12 04:00:00,4
8,43,51,88,2.5,0,Clear,13.3,2022-12-12 05:00:00,5
36,135,171,88,2.2,3,Cloudy,9.7,2022-12-12 06:00:00,6
58,319,377,87,1.9,3,Cloudy,10.0,2022-12-12 07:00:00,7
118,492,610,86,1.6,3,Cloudy,10.2,2022-12-12 08:00:00,8
81,288,369,85,1.9,3,Cloudy,10.2,2022-12-12 09:00:00,9
63,156,219,80,3.3,3,Cloudy,10.0,2022-12-12 10:00:00,10
78,193,271,69,4.3,3,Cloudy,13.6,2022-12-12 11:00:00,11
75,207,282,64,4.8,3,Cloudy,16.0,2022-12-12 12:00:00,12
77,198,275,62,5.2,3,Cloudy,15.4,2022-12-12 13:00:00,13
97,194,291,59,5.4,3,Cloudy,14.1,2022-12-12 14:00:00,14
97,268,365,55,6.4,3,Cloudy,13.5,2022-12-12 15:00:00,15
152,363,515,54,6.2,3,Cloudy,12.6,2022-12-12 16:00:00,16
176,584,760,54,5.9,2,Partly Cloudy,11.6,2022-12-12 17:00:00,17
146,494,640,55,5.4,3,Cloudy,9.1,2022-12-12 18:00:00,18
95,340,435,55,5.1,3,Cloudy,7.7,2022-12-12 19:00:00,19
69,224,293,56,4.8,3,Cloudy,7.4,2022-12-12 20:00:00,20
59,211,270,55,4.5,3,Cloudy,7.7,2022-12-12 21:00:00,21
41,105,146,57,4.0,2,Partly Cloudy,8.0,2022-12-12 22:00:00,22
37,65,102,59,3.5,2,Partly Cloudy,7.9,2022-12-12 23:00:00,23
23,32,55,62,2.8,1,Mostly Clear,9.0,2022-12-13 00:00:00,0
1,8,9,65,2.2,0,Clear,9.7,2022-12-13 01:00:00,1
3,8,11,68,1.5,0,Clear,9.5,2022-12-13 02:00:00,2
0,7,7,72,1.2,0,Clear,8.7,2022-12-13 03:00:00,3
2,12,14,75,0.4,0,Clear,8.6,2022-12-13 04:00:00,4
17,50,67,77,-0.5,0,Clear,7.9,2022-12-13 05:00:00,5
34,144,178,79,-1.3,0,Clear,6.6,2022-12-13 06:00:00,6
80,343,423,81,-2.1,0,Clear,6.5,2022-12-13 07:00:00,7
149,574,723,82,-2.8,0,Clear,6.7,2022-12-13 08:00:00,8
83,308,391,80,-2.4,0,Clear,8.0,2022-12-13 09:00:00,9
52,184,236,64,0.1,0,Clear,8.8,2022-12-13 10:00:00,10
90,186,276,58,1.4,0,Clear,7.9,2022-12-13 11:00:00,11
97,224,321,53,2.7,0,Clear,7.5,2022-12-13 12:00:00,12
101,237,338,49,3.9,0,Clear,7.0,2022-12-13 13:00:00,13
101,209,310,47,4.8,0,Clear,7.0,2022-12-13 14:00:00,14
112,278,390,45,5.0,0,Clear,6.1,2022-12-13 15:00:00,15
178,441,619,44,5.1,0,Clear,5.9,2022-12-13 16:00:00,16
227,615,842,45,4.6,0,Clear,5.4,2022-12-13 17:00:00,17
214,557,771,55,3.5,0,Clear,6.4,2022-12-13 18:00:00,18
110,383,493,70,1.5,0,Clear,7.4,2022-12-13 19:00:00,19
78,245,323,70,0.6,0,Clear,7.8,2022-12-13 20:00:00,20
70,176,246,70,0.2,0,Clear,7.6,2022-12-13 21:00:00,21
51,141,192,70,0.2,0,Clear,7.9,2022-12-13 22:00:00,22
52,79,131,68,0.9,0,Clear,6.8,2022-12-13 23:00:00,23
16,31,47,72,0.3,0,Clear,6.9,2022-12-14 00:00:00,0
5,14,19,80,-1.4,0,Clear,6.2,2022-12-14 01:00:00,1
2,2,4,81,-2.1,0,Clear,5.8,2022-12-14 02:00:00,2
3,1,4,83,-3.6,0,Clear,6.3,2022-12-14 03:00:00,3
4,10,14,82,-3.8,1,Mostly Clear,6.1,2022-12-14 04:00:00,4
13,51,64,80,-3.7,0,Clear,6.6,2022-12-14 05:00:00,5
26,128,154,81,-3.9,1,Mostly Clear,6.3,2022-12-14 06:00:00,6
77,342,419,78,-3.8,1,Mostly Clear,6.8,2022-12-14 07:00:00,7
164,587,751,77,-3.6,1,Mostly Clear,8.0,2022-12-14 08:00:00,8
119,353,472,74,-3.1,1,Mostly Clear,7.0,2022-12-14 09:00:00,9
69,209,278,61,-0.1,1,Mostly Clear,5.9,2022-12-14 10:00:00,10
70,233,303,50,2.2,1,Mostly Clear,6.7,2022-12-14 11:00:00,11
90,251,341,47,3.2,1,Mostly Clear,8.0,2022-12-14 12:00:00,12
114,272,386,46,4.0,1,Mostly Clear,5.8,2022-12-14 13:00:00,13
117,235,352,45,4.2,3,Cloudy,4.5,2022-12-14 14:00:00,14
159,292,451,43,5.0,3,Cloudy,4.4,2022-12-14 15:00:00,15
183,443,626,45,4.9,2,Partly Cloudy,4.3,2022-12-14 16:00:00,16
221,606,827,50,4.3,2,Partly Cloudy,4.0,2022-12-14 17:00:00,17
188,526,714,57,3.3,2,Partly Cloudy,1.6,2022-12-14 18:00:00,18
129,383,512,70,1.4,1,Mostly Clear,5.6,2022-12-14 19:00:00,19
85,250,335,72,0.7,3,Cloudy,6.1,2022-12-14 20:00:00,20
79,177,256,76,0.2,3,Cloudy,6.9,2022-12-14 21:00:00,21
54,151,205,76,0.2,3,Cloudy,7.1,2022-12-14 22:00:00,22
42,74,116,76,-0.1,3,Cloudy,6.8,2022-12-14 23:00:00,23
8,49,57,75,0.0,3,Cloudy,6.5,2022-12-15 00:00:00,0
5,24,29,77,0.4,3,Cloudy,6.2,2022-12-15 01:00:00,1
2,11,13,75,0.9,3,Cloudy,5.7,2022-12-15 02:00:00,2
1,6,7,71,1.9,51,Light Drizzle,8.0,2022-12-15 03:00:00,3
0,5,5,83,1.6,53,Heavy Drizzle,11.9,2022-12-15 04:00:00,4
7,14,21,87,1.5,53,Heavy Drizzle,11.5,2022-12-15 05:00:00,5
6,33,39,90,1.4,61,Light Rain,9.4,2022-12-15 06:00:00,6
7,48,55,92,1.3,61,Light Rain,9.0,2022-12-15 07:00:00,7
23,110,133,93,1.6,61,Light Rain,4.8,2022-12-15 08:00:00,8
19,91,110,94,1.9,63,Rain,12.7,2022-12-15 09:00:00,9
17,52,69,96,2.4,61,Light Rain,12.9,2022-12-15 10:00:00,10
9,53,62,96,3.3,61,Light Rain,11.3,2022-12-15 11:00:00,11
11,57,68,96,4.0,63,Rain,15.1,2022-12-15 12:00:00,12
14,50,64,97,4.8,63,Rain,8.6,2022-12-15 13:00:00,13
14,42,56,96,5.7,61,Light Rain,14.8,2022-12-15 14:00:00,14
29,101,130,97,5.1,61,Light Rain,18.0,2022-12-15 15:00:00,15
21,73,94,97,6.1,61,Light Rain,19.8,2022-12-15 16:00:00,16
33,138,171,97,6.9,61,Light Rain,22.1,2022-12-15 17:00:00,17
63,232,295,97,7.5,63,Rain,12.1,2022-12-15 18:00:00,18
39,156,195,97,7.9,63,Rain,13.8,2022-12-15 19:00:00,19
20,101,121,97,8.1,61,Light Rain,18.2,2022-12-15 20:00:00,20
25,86,111,98,8.4,55,Heavy Drizzle,18.5,2022-12-15 21:00:00,21
22,78,100,99,8.6,61,Light Rain,16.4,2022-12-15 22:00:00,22
35,62,97,99,8.7,53,Heavy Drizzle,13.1,2022-12-15 23:00:00,23
12,25,37,99,8.7,53,Heavy Drizzle,11.5,2022-12-16 00:00:00,0
14,21,35,99,8.5,55,Heavy Drizzle,13.3,2022-12-16 01:00:00,1
7,6,13,100,8.1,61,Light Rain,16.1,2022-12-16 02:00:00,2
7,6,13,99,6.2,51,Light Drizzle,18.4,2022-12-16 03:00:00,3
5,16,21,97,5.5,51,Light Drizzle,19.4,2022-12-16 04:00:00,4
10,27,37,96,5.2,51,Light Drizzle,19.2,2022-12-16 05:00:00,5
24,114,138,96,5.0,3,Cloudy,15.6,2022-12-16 06:00:00,6
54,236,290,95,5.0,3,Cloudy,16.2,2022-12-16 07:00:00,7
107,381,488,95,4.9,3,Cloudy,15.5,2022-12-16 08:00:00,8
82,285,367,94,4.8,2,Partly Cloudy,15.2,2022-12-16 09:00:00,9
104,220,324,92,5.5,2,Partly Cloudy,15.3,2022-12-16 10:00:00,10
135,265,400,79,7.5,1,Mostly Clear,16.5,2022-12-16 11:00:00,11
155,279,434,71,8.7,0,Clear,18.4,2022-12-16 12:00:00,12
154,321,475,59,9.4,0,Clear,19.2,2022-12-16 13:00:00,13
154,329,483,53,9.6,0,Clear,18.2,2022-12-16 14:00:00,14
189,377,566,47,10.2,0,Clear,17.1,2022-12-16 15:00:00,15
206,441,647,46,9.9,1,Mostly Clear,15.7,2022-12-16 16:00:00,16
214,504,718,49,9.1,2,Partly Cloudy,10.9,2022-12-16 17:00:00,17
168,435,603,52,7.8,3,Cloudy,12.6,2022-12-16 18:00:00,18
150,305,455,56,6.7,3,Cloudy,11.5,2022-12-16 19:00:00,19
89,233,322,60,5.7,1,Mostly Clear,9.1,2022-12-16 20:00:00,20
66,162,228,65,4.5,0,Clear,7.6,2022-12-16 21:00:00,21
89,128,217,70,3.1,0,Clear,7.5,2022-12-16 22:00:00,22
87,127,214,74,2.0,0,Clear,7.9,2022-12-16 23:00:00,23
57,111,168,76,1.2,1,Mostly Clear,7.8,2022-12-17 00:00:00,0
57,70,127,78,0.7,0,Clear,8.0,2022-12-17 01:00:00,1
45,53,98,78,0.6,0,Clear,8.8,2022-12-17 02:00:00,2
19,10,29,82,-0.3,0,Clear,9.2,2022-12-17 03:00:00,3
4,10,14,82,-0.6,0,Clear,9.8,2022-12-17 04:00:00,4
5,10,15,81,-0.7,0,Clear,10.9,2022-12-17 05:00:00,5
13,19,32,80,-0.7,2,Partly Cloudy,11.2,2022-12-17 06:00:00,6
21,52,73,77,-0.6,3,Cloudy,11.5,2022-12-17 07:00:00,7
62,123,185,77,-0.8,0,Clear,10.2,2022-12-17 08:00:00,8
96,232,328,79,-0.9,0,Clear,9.5,2022-12-17 09:00:00,9
150,257,407,73,2.3,0,Clear,8.7,2022-12-17 10:00:00,10
177,336,513,56,5.2,0,Clear,8.6,2022-12-17 11:00:00,11
199,325,524,45,6.3,1,Mostly Clear,13.4,2022-12-17 12:00:00,12
231,356,587,43,6.9,3,Cloudy,16.2,2022-12-17 13:00:00,13
219,416,635,43,7.0,3,Cloudy,14.5,2022-12-17 14:00:00,14
210,382,592,40,7.7,3,Cloudy,14.1,2022-12-17 15:00:00,15
224,337,561,39,7.6,2,Partly Cloudy,13.8,2022-12-17 16:00:00,16
123,329,452,43,7.1,2,Partly Cloudy,7.6,2022-12-17 17:00:00,17
122,279,401,62,6.1,2,Partly Cloudy,5.5,2022-12-17 18:00:00,18
113,235,348,45,6.3,2,Partly Cloudy,5.9,2022-12-17 19:00:00,19
70,155,225,50,5.2,1,Mostly Clear,6.4,2022-12-17 20:00:00,20
62,119,181,72,1.3,1,Mostly Clear,7.6,2022-12-17 21:00:00,21
64,123,187,71,0.5,1,Mostly Clear,8.3,2022-12-17 22:00:00,22
72,112,184,70,-0.0,1,Mostly Clear,6.5,2022-12-17 23:00:00,23
59,71,130,73,-0.7,2,Partly Cloudy,5.8,2022-12-18 00:00:00,0
49,61,110,72,-0.7,0,Clear,5.4,2022-12-18 01:00:00,1
27,49,76,68,0.4,1,Mostly Clear,6.6,2022-12-18 02:00:00,2
23,26,49,66,1.3,3,Cloudy,5.1,2022-12-18 03:00:00,3
3,14,17,68,1.2,2,Partly Cloudy,6.5,2022-12-18 04:00:00,4
3,12,15,73,0.6,1,Mostly Clear,7.3,2022-12-18 05:00:00,5
10,14,24,78,-0.4,2,Partly Cloudy,7.9,2022-12-18 06:00:00,6
19,48,67,79,-1.2,1,Mostly Clear,9.0,2022-12-18 07:00:00,7
45,131,176,76,-0.9,0,Clear,8.2,2022-12-18 08:00:00,8
168,280,448,72,-0.5,0,Clear,8.4,2022-12-18 09:00:00,9
100,189,289,66,1.6,0,Clear,9.5,2022-12-18 10:00:00,10
101,199,300,49,3.3,0,Clear,14.5,2022-12-18 11:00:00,11
112,192,304,46,3.9,1,Mostly Clear,18.8,2022-12-18 12:00:00,12
208,348,556,43,4.4,2,Partly Cloudy,20.5,2022-12-18 13:00:00,13
158,273,431,42,4.6,1,Mostly Clear,20.8,2022-12-18 14:00:00,14
136,280,416,45,5.1,1,Mostly Clear,19.3,2022-12-18 15:00:00,15
122,316,438,43,4.9,1,Mostly Clear,19.3,2022-12-18 16:00:00,16
107,233,340,42,4.4,0,Clear,15.8,2022-12-18 17:00:00,17
52,183,235,44,3.2,0,Clear,14.8,2022-12-18 18:00:00,18
49,134,183,46,2.3,0,Clear,15.0,2022-12-18 19:00:00,19
43,85,128,47,1.5,0,Clear,14.2,2022-12-18 20:00:00,20
39,64,103,48,0.9,0,Clear,12.7,2022-12-18 21:00:00,21
31,61,92,49,0.3,0,Clear,12.3,2022-12-18 22:00:00,22
19,43,62,50,-0.2,0,Clear,11.6,2022-12-18 23:00:00,23
12,20,32,52,-0.6,0,Clear,11.6,2022-12-19 00:00:00,0
4,10,14,54,-1.0,0,Clear,12.1,2022-12-19 01:00:00,1
5,7,12,55,-1.3,0,Clear,12.4,2022-12-19 02:00:00,2
1,5,6,58,-1.3,0,Clear,12.6,2022-12-19 03:00:00,3
2,10,12,59,-1.4,0,Clear,12.1,2022-12-19 04:00:00,4
13,36,49,59,-1.5,0,Clear,12.1,2022-12-19 05:00:00,5
17,96,113,60,-1.6,0,Clear,8.5,2022-12-19 06:00:00,6
39,221,260,61,-1.8,0,Clear,7.6,2022-12-19 07:00:00,7
69,366,435,64,-2.1,0,Clear,7.9,2022-12-19 08:00:00,8
66,231,297,67,-2.0,0,Clear,9.4,2022-12-19 09:00:00,9
72,138,210,60,0.4,0,Clear,9.4,2022-12-19 10:00:00,10
66,162,228,53,2.1,0,Clear,14.1,2022-12-19 11:00:00,11
83,207,290,50,3.2,0,Clear,15.3,2022-12-19 12:00:00,12
63,178,241,48,4.0,0,Clear,15.7,2022-12-19 13:00:00,13
79,195,274,46,4.6,0,Clear,15.8,2022-12-19 14:00:00,14
100,275,375,46,5.0,0,Clear,16.6,2022-12-19 15:00:00,15
113,343,456,45,4.9,0,Clear,16.0,2022-12-19 16:00:00,16
132,458,590,48,4.2,1,Mostly Clear,12.5,2022-12-19 17:00:00,17
107,347,454,50,2.9,1,Mostly Clear,9.7,2022-12-19 18:00:00,18
59,262,321,53,2.1,1,Mostly Clear,10.8,2022-12-19 19:00:00,19
48,160,208,54,1.4,1,Mostly Clear,11.4,2022-12-19 20:00:00,20
39,97,136,55,0.7,1,Mostly Clear,12.2,2022-12-19 21:00:00,21
33,70,103,55,0.2,0,Clear,12.9,2022-12-19 22:00:00,22
11,51,62,57,-0.4,0,Clear,12.4,2022-12-19 23:00:00,23
11,17,28,58,-0.8,0,Clear,11.2,2022-12-20 00:00:00,0
2,11,13,60,-1.3,0,Clear,10.4,2022-12-20 01:00:00,1
2,5,7,64,-1.9,0,Clear,9.7,2022-12-20 02:00:00,2
3,5,8,66,-2.5,0,Clear,9.5,2022-12-20 03:00:00,3
2,13,15,67,-2.7,0,Clear,9.8,2022-12-20 04:00:00,4
10,33,43,67,-2.8,0,Clear,10.4,2022-12-20 05:00:00,5
21,115,136,67,-2.8,0,Clear,9.2,2022-12-20 06:00:00,6
52,238,290,69,-3.1,0,Clear,9.2,2022-12-20 07:00:00,7
86,404,490,73,-3.5,0,Clear,8.4,2022-12-20 08:00:00,8
91,276,367,73,-3.2,0,Clear,8.3,2022-12-20 09:00:00,9
62,165,227,61,-0.3,0,Clear,7.9,2022-12-20 10:00:00,10
68,185,253,57,1.2,0,Clear,8.4,2022-12-20 11:00:00,11
93,218,311,55,2.3,0,Clear,7.0,2022-12-20 12:00:00,12
83,218,301,52,3.2,0,Clear,6.0,2022-12-20 13:00:00,13
94,228,322,51,3.9,0,Clear,5.1,2022-12-20 14:00:00,14
152,248,400,51,4.1,0,Clear,5.8,2022-12-20 15:00:00,15
150,339,489,51,4.1,0,Clear,6.2,2022-12-20 16:00:00,16
151,472,623,55,3.6,0,Clear,4.3,2022-12-20 17:00:00,17
135,376,511,62,2.5,0,Clear,6.2,2022-12-20 18:00:00,18
97,236,333,76,0.6,0,Clear,7.0,2022-12-20 19:00:00,19
48,165,213,74,0.3,0,Clear,7.1,2022-12-20 20:00:00,20
59,130,189,69,1.2,0,Clear,7.0,2022-12-20 21:00:00,21
28,68,96,72,0.9,0,Clear,6.4,2022-12-20 22:00:00,22
25,36,61,75,0.6,0,Clear,5.8,2022-12-20 23:00:00,23
13,19,32,79,-0.1,0,Clear,6.8,2022-12-21 00:00:00,0
4,12,16,83,-1.4,0,Clear,5.4,2022-12-21 01:00:00,1
2,4,6,83,-1.6,0,Clear,5.0,2022-12-21 02:00:00,2
4,5,9,83,-3.0,0,Clear,5.6,2022-12-21 03:00:00,3
4,13,17,83,-3.2,0,Clear,5.0,2022-12-21 04:00:00,4
9,36,45,84,-3.4,0,Clear,4.7,2022-12-21 05:00:00,5
21,110,131,85,-3.6,0,Clear,5.3,2022-12-21 06:00:00,6
38,203,241,85,-3.7,0,Clear,5.5,2022-12-21 07:00:00,7
66,329,395,84,-3.7,0,Clear,5.0,2022-12-21 08:00:00,8
57,223,280,83,-3.0,0,Clear,4.7,2022-12-21 09:00:00,9
72,134,206,71,-0.3,0,Clear,4.1,2022-12-21 10:00:00,10
77,186,263,61,2.0,0,Clear,3.4,2022-12-21 11:00:00,11
110,242,352,56,3.4,0,Clear,2.6,2022-12-21 12:00:00,12
127,240,367,53,4.4,0,Clear,1.8,2022-12-21 13:00:00,13
125,239,364,51,5.1,0,Clear,1.9,2022-12-21 14:00:00,14
168,311,479,52,5.3,0,Clear,3.0,2022-12-21 15:00:00,15
149,352,501,54,5.0,1,Mostly Clear,4.0,2022-12-21 16:00:00,16
144,387,531,61,3.9,1,Mostly Clear,5.6,2022-12-21 17:00:00,17
114,315,429,70,1.8,1,Mostly Clear,7.5,2022-12-21 18:00:00,18
92,174,266,75,0.6,1,Mostly Clear,9.6,2022-12-21 19:00:00,19
56,139,195,78,-0.1,1,Mostly Clear,7.9,2022-12-21 20:00:00,20
45,109,154,82,-0.7,1,Mostly Clear,7.1,2022-12-21 21:00:00,21
43,82,125,84,-1.1,1,Mostly Clear,6.8,2022-12-21 22:00:00,22
21,43,64,85,-1.3,1,Mostly Clear,6.6,2022-12-21 23:00:00,23
20,19,39,87,-1.6,1,Mostly Clear,6.8,2022-12-22 00:00:00,0
7,10,17,87,-1.9,1,Mostly Clear,7.6,2022-12-22 01:00:00,1
2,12,14,89,-2.1,1,Mostly Clear,7.6,2022-12-22 02:00:00,2
2,3,5,89,-1.5,1,Mostly Clear,7.9,2022-12-22 03:00:00,3
2,15,17,91,-0.8,2,Partly Cloudy,8.9,2022-12-22 04:00:00,4
12,19,31,91,0.1,3,Cloudy,8.2,2022-12-22 05:00:00,5
10,60,70,92,0.9,3,Cloudy,8.2,2022-12-22 06:00:00,6
35,140,175,92,1.4,51,Light Drizzle,10.2,2022-12-22 07:00:00,7
20,136,156,94,1.7,51,Light Drizzle,14.4,2022-12-22 08:00:00,8
22,100,122,94,2.1,51,Light Drizzle,13.3,2022-12-22 09:00:00,9
9,57,66,94,2.8,51,Light Drizzle,11.1,2022-12-22 10:00:00,10
13,60,73,94,3.8,51,Light Drizzle,12.4,2022-12-22 11:00:00,11
5,57,62,94,3.9,61,Light Rain,16.4,2022-12-22 12:00:00,12
16,42,58,95,4.4,61,Light Rain,16.9,2022-12-22 13:00:00,13
18,29,47,95,4.5,63,Rain,19.1,2022-12-22 14:00:00,14
16,49,65,97,5.8,53,Heavy Drizzle,21.3,2022-12-22 15:00:00,15
15,60,75,97,7.4,61,Light Rain,20.7,2022-12-22 16:00:00,16
21,78,99,97,8.7,63,Rain,20.9,2022-12-22 17:00:00,17
26,133,159,96,9.7,63,Rain,20.4,2022-12-22 18:00:00,18
21,61,82,95,10.4,63,Rain,21.6,2022-12-22 19:00:00,19
10,49,59,96,10.9,63,Rain,23.2,2022-12-22 20:00:00,20
7,25,32,96,11.5,63,Rain,21.8,2022-12-22 21:00:00,21
12,26,38,97,12.0,63,Rain,20.9,2022-12-22 22:00:00,22
12,31,43,98,12.0,63,Rain,14.6,2022-12-22 23:00:00,23
15,15,30,99,11.8,63,Rain,6.2,2022-12-23 00:00:00,0
9,18,27,99,10.8,55,Heavy Drizzle,7.8,2022-12-23 01:00:00,1
5,9,14,100,9.1,51,Light Drizzle,10.5,2022-12-23 02:00:00,2
1,6,7,99,7.0,3,Cloudy,13.2,2022-12-23 03:00:00,3
2,5,7,98,6.3,3,Cloudy,17.5,2022-12-23 04:00:00,4
4,16,20,98,5.9,3,Cloudy,19.8,2022-12-23 05:00:00,5
14,25,39,97,5.8,3,Cloudy,18.7,2022-12-23 06:00:00,6
11,64,75,96,6.0,3,Cloudy,21.1,2022-12-23 07:00:00,7
12,40,52,96,6.3,51,Light Drizzle,20.2,2022-12-23 08:00:00,8
10,50,60,96,6.5,55,Heavy Drizzle,21.9,2022-12-23 09:00:00,9
21,45,66,92,3.9,55,Heavy Drizzle,24.1,2022-12-23 10:00:00,10
23,96,119,64,-1.6,51,Light Drizzle,32.4,2022-12-23 11:00:00,11
36,116,152,44,-1.7,0,Clear,28.9,2022-12-23 12:00:00,12
53,108,161,36,-1.9,0,Clear,32.1,2022-12-23 13:00:00,13
50,116,166,33,-2.4,0,Clear,33.3,2022-12-23 14:00:00,14
46,122,168,31,-3.8,0,Clear,32.0,2022-12-23 15:00:00,15
28,104,132,28,-4.8,0,Clear,30.7,2022-12-23 16:00:00,16
36,78,114,25,-5.9,0,Clear,29.2,2022-12-23 17:00:00,17
23,72,95,24,-7.1,1,Mostly Clear,27.8,2022-12-23 18:00:00,18
15,55,70,24,-8.2,0,Clear,27.5,2022-12-23 19:00:00,19
6,38,44,25,-9.1,0,Clear,27.0,2022-12-23 20:00:00,20
6,27,33,25,-9.8,0,Clear,26.7,2022-12-23 21:00:00,21
13,24,37,26,-10.3,0,Clear,26.7,2022-12-23 22:00:00,22
7,20,27,26,-10.4,0,Clear,26.0,2022-12-23 23:00:00,23
3,6,9,27,-10.6,0,Clear,24.9,2022-12-24 00:00:00,0
6,5,11,27,-10.6,0,Clear,23.0,2022-12-24 01:00:00,1
3,6,9,27,-10.6,0,Clear,23.4,2022-12-24 02:00:00,2
3,5,8,30,-11.2,0,Clear,21.2,2022-12-24 03:00:00,3
2,12,14,31,-11.6,0,Clear,20.2,2022-12-24 04:00:00,4
4,12,16,31,-12.1,0,Clear,19.8,2022-12-24 05:00:00,5
6,10,16,32,-12.6,0,Clear,12.6,2022-12-24 06:00:00,6
6,24,30,32,-12.8,0,Clear,16.9,2022-12-24 07:00:00,7
3,31,34,32,-12.8,0,Clear,16.3,2022-12-24 08:00:00,8
14,46,60,32,-12.6,0,Clear,15.4,2022-12-24 09:00:00,9
16,58,74,32,-11.7,0,Clear,16.2,2022-12-24 10:00:00,10
26,64,90,30,-10.4,0,Clear,17.7,2022-12-24 11:00:00,11
18,72,90,29,-9.0,0,Clear,17.4,2022-12-24 12:00:00,12
23,70,93,28,-7.7,1,Mostly Clear,19.2,2022-12-24 13:00:00,13
31,70,101,27,-6.5,0,Clear,18.4,2022-12-24 14:00:00,14
39,79,118,28,-6.0,0,Clear,18.2,2022-12-24 15:00:00,15
18,55,73,28,-5.3,0,Clear,17.0,2022-12-24 16:00:00,16
21,55,76,29,-5.1,0,Clear,15.5,2022-12-24 17:00:00,17
28,41,69,31,-5.5,0,Clear,8.8,2022-12-24 18:00:00,18
5,23,28,33,-6.0,0,Clear,5.2,2022-12-24 19:00:00,19
11,16,27,37,-6.5,0,Clear,4.8,2022-12-24 20:00:00,20
14,12,26,42,-7.2,0,Clear,4.2,2022-12-24 21:00:00,21
6,7,13,46,-7.4,0,Clear,2.7,2022-12-24 22:00:00,22
9,17,26,49,-7.5,0,Clear,2.9,2022-12-24 23:00:00,23
2,13,15,50,-7.5,0,Clear,2.6,2022-12-25 00:00:00,0
3,4,7,51,-7.4,0,Clear,2.5,2022-12-25 01:00:00,1
0,2,2,52,-7.3,0,Clear,5.0,2022-12-25 02:00:00,2
2,5,7,53,-8.2,0,Clear,7.0,2022-12-25 03:00:00,3
3,3,6,56,-8.3,0,Clear,7.4,2022-12-25 04:00:00,4
1,1,2,60,-8.4,0,Clear,8.2,2022-12-25 05:00:00,5
5,9,14,62,-8.3,0,Clear,3.5,2022-12-25 06:00:00,6
2,6,8,65,-8.3,0,Clear,6.1,2022-12-25 07:00:00,7
4,12,16,66,-8.4,0,Clear,7.1,2022-12-25 08:00:00,8
11,30,41,66,-8.1,0,Clear,6.6,2022-12-25 09:00:00,9
14,26,40,54,-6.1,0,Clear,5.8,2022-12-25 10:00:00,10
12,23,35,39,-4.4,0,Clear,10.2,2022-12-25 11:00:00,11
37,29,66,36,-3.1,0,Clear,13.0,2022-12-25 12:00:00,12
31,45,76,34,-1.9,0,Clear,12.3,2022-12-25 13:00:00,13
48,45,93,33,-0.9,0,Clear,12.6,2022-12-25 14:00:00,14
62,52,114,32,-0.2,0,Clear,13.0,2022-12-25 15:00:00,15
40,60,100,32,0.0,0,Clear,11.9,2022-12-25 16:00:00,16
32,59,91,34,-0.4,0,Clear,7.9,2022-12-25 17:00:00,17
18,51,69,40,-1.5,0,Clear,4.8,2022-12-25 18:00:00,18
9,24,33,47,-3.2,0,Clear,5.2,2022-12-25 19:00:00,19
10,32,42,49,-3.9,0,Clear,7.0,2022-12-25 20:00:00,20
12,13,25,52,-4.9,0,Clear,7.1,2022-12-25 21:00:00,21
8,16,24,50,-5.5,0,Clear,8.6,2022-12-25 22:00:00,22
7,10,17,48,-5.8,0,Clear,8.8,2022-12-25 23:00:00,23
8,17,25,47,-5.7,0,Clear,7.4,2022-12-26 00:00:00,0
4,4,8,46,-5.8,0,Clear,6.6,2022-12-26 01:00:00,1
1,4,5,46,-6.0,0,Clear,7.2,2022-12-26 02:00:00,2
4,4,8,56,-6.8,0,Clear,6.9,2022-12-26 03:00:00,3
1,4,5,57,-7.0,0,Clear,7.6,2022-12-26 04:00:00,4
1,6,7,57,-7.1,0,Clear,7.4,2022-12-26 05:00:00,5
6,12,18,57,-7.3,0,Clear,7.9,2022-12-26 06:00:00,6
5,23,28,57,-7.5,0,Clear,7.9,2022-12-26 07:00:00,7
11,54,65,57,-7.8,0,Clear,7.6,2022-12-26 08:00:00,8
16,42,58,56,-7.4,0,Clear,6.9,2022-12-26 09:00:00,9
24,47,71,46,-5.2,0,Clear,3.1,2022-12-26 10:00:00,10
43,72,115,39,-3.6,1,Mostly Clear,4.7,2022-12-26 11:00:00,11
53,97,150,34,-2.0,1,Mostly Clear,5.4,2022-12-26 12:00:00,12
67,81,148,32,-0.6,1,Mostly Clear,7.8,2022-12-26 13:00:00,13
47,116,163,31,0.3,1,Mostly Clear,8.0,2022-12-26 14:00:00,14
65,118,183,32,1.4,2,Partly Cloudy,6.4,2022-12-26 15:00:00,15
68,123,191,34,1.1,3,Cloudy,6.1,2022-12-26 16:00:00,16
54,101,155,41,0.5,2,Partly Cloudy,4.4,2022-12-26 17:00:00,17
32,99,131,47,-0.5,3,Cloudy,4.7,2022-12-26 18:00:00,18
38,80,118,52,-1.3,2,Partly Cloudy,4.8,2022-12-26 19:00:00,19
13,44,57,58,-2.3,1,Mostly Clear,5.4,2022-12-26 20:00:00,20
18,40,58,66,-3.3,1,Mostly Clear,5.2,2022-12-26 21:00:00,21
17,34,51,70,-3.6,2,Partly Cloudy,5.2,2022-12-26 22:00:00,22
13,18,31,73,-3.7,1,Mostly Clear,5.1,2022-12-26 23:00:00,23
9,15,24,70,-3.1,1,Mostly Clear,6.3,2022-12-27 00:00:00,0
6,6,12,68,-3.0,1,Mostly Clear,4.9,2022-12-27 01:00:00,1
1,3,4,68,-3.2,2,Partly Cloudy,3.3,2022-12-27 02:00:00,2
4,2,6,62,-1.9,1,Mostly Clear,2.9,2022-12-27 03:00:00,3
2,6,8,61,-1.9,0,Clear,4.6,2022-12-27 04:00:00,4
2,28,30,62,-2.0,0,Clear,3.7,2022-12-27 05:00:00,5
15,44,59,62,-2.2,0,Clear,2.9,2022-12-27 06:00:00,6
21,92,113,62,-2.7,0,Clear,1.9,2022-12-27 07:00:00,7
19,120,139,61,-3.0,0,Clear,3.6,2022-12-27 08:00:00,8
49,105,154,60,-3.1,0,Clear,3.7,2022-12-27 09:00:00,9
64,81,145,50,-1.1,0,Clear,3.0,2022-12-27 10:00:00,10
92,123,215,41,1.4,0,Clear,3.0,2022-12-27 11:00:00,11
92,168,260,41,2.8,0,Clear,2.8,2022-12-27 12:00:00,12
106,159,265,41,3.8,0,Clear,2.6,2022-12-27 13:00:00,13
126,172,298,42,4.4,0,Clear,3.1,2022-12-27 14:00:00,14
140,178,318,38,5.2,0,Clear,3.1,2022-12-27 15:00:00,15
125,218,343,39,5.1,0,Clear,2.3,2022-12-27 16:00:00,16
120,236,356,45,4.4,0,Clear,4.2,2022-12-27 17:00:00,17
67,174,241,54,2.5,0,Clear,6.3,2022-12-27 18:00:00,18
46,129,175,61,0.4,0,Clear,5.6,2022-12-27 19:00:00,19
39,76,115,69,-1.3,1,Mostly Clear,6.9,2022-12-27 20:00:00,20
31,71,102,75,-2.3,1,Mostly Clear,8.4,2022-12-27 21:00:00,21
27,52,79,77,-2.8,0,Clear,7.9,2022-12-27 22:00:00,22
18,34,52,77,-3.0,0,Clear,8.4,2022-12-27 23:00:00,23
8,17,25,77,-3.1,0,Clear,6.8,2022-12-28 00:00:00,0
3,10,13,78,-3.3,0,Clear,6.3,2022-12-28 01:00:00,1
3,4,7,78,-3.3,0,Clear,8.0,2022-12-28 02:00:00,2
4,0,4,80,-3.6,0,Clear,7.7,2022-12-28 03:00:00,3
2,11,13,80,-3.6,0,Clear,6.8,2022-12-28 04:00:00,4
11,27,38,80,-3.7,0,Clear,6.8,2022-12-28 05:00:00,5
9,68,77,81,-3.9,0,Clear,7.2,2022-12-28 06:00:00,6
18,102,120,81,-3.9,0,Clear,7.6,2022-12-28 07:00:00,7
37,164,201,80,-3.8,0,Clear,6.7,2022-12-28 08:00:00,8
90,136,226,79,-3.5,0,Clear,8.0,2022-12-28 09:00:00,9
108,137,245,63,0.0,0,Clear,8.5,2022-12-28 10:00:00,10
119,157,276,53,2.9,0,Clear,8.8,2022-12-28 11:00:00,11
160,161,321,47,5.3,0,Clear,8.7,2022-12-28 12:00:00,12
193,190,383,43,7.1,1,Mostly Clear,9.6,2022-12-28 13:00:00,13
203,188,391,41,8.2,0,Clear,9.4,2022-12-28 14:00:00,14
235,225,460,42,8.7,0,Clear,9.3,2022-12-28 15:00:00,15
190,257,447,46,8.4,0,Clear,7.4,2022-12-28 16:00:00,16
177,247,424,56,6.8,0,Clear,7.6,2022-12-28 17:00:00,17
74,218,292,64,4.5,0,Clear,9.6,2022-12-28 18:00:00,18
75,131,206,70,2.9,0,Clear,9.4,2022-12-28 19:00:00,19
45,89,134,76,1.7,1,Mostly Clear,8.4,2022-12-28 20:00:00,20
59,67,126,81,0.7,1,Mostly Clear,9.4,2022-12-28 21:00:00,21
28,61,89,83,0.1,1,Mostly Clear,10.5,2022-12-28 22:00:00,22
21,46,67,85,-0.2,1,Mostly Clear,11.2,2022-12-28 23:00:00,23
7,24,31,86,-0.2,1,Mostly Clear,11.4,2022-12-29 00:00:00,0
4,6,10,87,-0.3,1,Mostly Clear,11.4,2022-12-29 01:00:00,1
1,3,4,88,-0.4,1,Mostly Clear,10.8,2022-12-29 02:00:00,2
3,2,5,85,-0.2,1,Mostly Clear,10.6,2022-12-29 03:00:00,3
4,6,10,86,-0.3,1,Mostly Clear,10.9,2022-12-29 04:00:00,4
7,23,30,87,-0.4,1,Mostly Clear,10.6,2022-12-29 05:00:00,5
10,64,74,88,-0.6,1,Mostly Clear,8.9,2022-12-29 06:00:00,6
40,104,144,90,-1.0,1,Mostly Clear,7.7,2022-12-29 07:00:00,7
48,171,219,91,-1.2,0,Clear,7.2,2022-12-29 08:00:00,8
59,133,192,91,-1.2,0,Clear,5.7,2022-12-29 09:00:00,9
145,157,302,85,1.4,0,Clear,5.2,2022-12-29 10:00:00,10
181,182,363,72,4.5,0,Clear,4.9,2022-12-29 11:00:00,11
230,195,425,65,6.4,0,Clear,4.8,2022-12-29 12:00:00,12
260,202,462,64,8.1,0,Clear,4.3,2022-12-29 13:00:00,13
281,255,536,62,9.1,0,Clear,4.1,2022-12-29 14:00:00,14
333,249,582,58,10.2,0,Clear,4.0,2022-12-29 15:00:00,15
217,284,501,60,10.3,0,Clear,4.9,2022-12-29 16:00:00,16
186,313,499,67,9.2,0,Clear,6.9,2022-12-29 17:00:00,17
123,233,356,75,6.9,0,Clear,10.4,2022-12-29 18:00:00,18
112,176,288,84,4.7,0,Clear,9.7,2022-12-29 19:00:00,19
82,124,206,87,3.2,0,Clear,9.6,2022-12-29 20:00:00,20
64,114,178,88,2.4,0,Clear,9.7,2022-12-29 21:00:00,21
46,86,132,88,1.8,0,Clear,10.0,2022-12-29 22:00:00,22
32,45,77,90,1.4,0,Clear,10.0,2022-12-29 23:00:00,23
21,28,49,92,1.1,0,Clear,10.0,2022-12-30 00:00:00,0
20,28,48,94,0.8,0,Clear,10.0,2022-12-30 01:00:00,1
8,22,30,95,0.5,0,Clear,9.5,2022-12-30 02:00:00,2
4,9,13,93,0.7,0,Clear,8.2,2022-12-30 03:00:00,3
1,5,6,94,0.6,0,Clear,8.0,2022-12-30 04:00:00,4
7,32,39,95,0.4,0,Clear,8.4,2022-12-30 05:00:00,5
12,67,79,95,0.4,0,Clear,7.6,2022-12-30 06:00:00,6
23,101,124,96,0.2,0,Clear,6.9,2022-12-30 07:00:00,7
47,174,221,96,0.1,0,Clear,7.3,2022-12-30 08:00:00,8
91,140,231,96,0.2,0,Clear,8.6,2022-12-30 09:00:00,9
138,178,316,93,3.3,0,Clear,8.9,2022-12-30 10:00:00,10
193,216,409,83,7.1,0,Clear,7.1,2022-12-30 11:00:00,11
271,261,532,75,9.8,0,Clear,7.6,2022-12-30 12:00:00,12
304,280,584,69,12.0,0,Clear,8.2,2022-12-30 13:00:00,13
379,332,711,65,13.6,0,Clear,8.0,2022-12-30 14:00:00,14
395,334,729,62,15.1,0,Clear,9.0,2022-12-30 15:00:00,15
340,359,699,65,15.2,0,Clear,8.6,2022-12-30 16:00:00,16
260,330,590,72,13.9,0,Clear,8.5,2022-12-30 17:00:00,17
141,241,382,83,11.5,1,Mostly Clear,10.8,2022-12-30 18:00:00,18
134,212,346,90,10.0,1,Mostly Clear,10.1,2022-12-30 19:00:00,19
76,148,224,93,9.4,1,Mostly Clear,10.8,2022-12-30 20:00:00,20
70,88,158,94,9.2,1,Mostly Clear,12.0,2022-12-30 21:00:00,21
55,102,157,95,9.1,1,Mostly Clear,13.0,2022-12-30 22:00:00,22
66,78,144,96,8.7,1,Mostly Clear,12.6,2022-12-30 23:00:00,23
35,57,92,97,8.0,1,Mostly Clear,12.0,2022-12-31 00:00:00,0
32,20,52,98,7.4,1,Mostly Clear,10.1,2022-12-31 01:00:00,1
40,16,56,98,6.9,1,Mostly Clear,8.8,2022-12-31 02:00:00,2
13,12,25,100,7.7,1,Mostly Clear,9.1,2022-12-31 03:00:00,3
4,8,12,100,7.5,3,Cloudy,8.0,2022-12-31 04:00:00,4
5,17,22,100,7.6,3,Cloudy,8.7,2022-12-31 05:00:00,5
9,44,53,100,7.8,3,Cloudy,8.9,2022-12-31 06:00:00,6
22,67,89,100,8.2,51,Light Drizzle,6.5,2022-12-31 07:00:00,7
43,100,143,100,8.4,3,Cloudy,6.9,2022-12-31 08:00:00,8
80,126,206,100,8.7,3,Cloudy,8.4,2022-12-31 09:00:00,9
162,188,350,100,9.7,3,Cloudy,8.6,2022-12-31 10:00:00,10
150,216,366,99,11.2,3,Cloudy,8.4,2022-12-31 11:00:00,11
191,241,432,96,12.3,3,Cloudy,10.1,2022-12-31 12:00:00,12
162,216,378,97,12.7,51,Light Drizzle,11.8,2022-12-31 13:00:00,13
149,175,324,99,12.8,3,Cloudy,11.9,2022-12-31 14:00:00,14
83,122,205,98,13.5,53,Heavy Drizzle,11.0,2022-12-31 15:00:00,15
76,97,173,98,13.4,53,Heavy Drizzle,9.0,2022-12-31 16:00:00,16
38,75,113,97,13.4,53,Heavy Drizzle,9.3,2022-12-31 17:00:00,17
32,72,104,98,13.2,61,Light Rain,9.8,2022-12-31 18:00:00,18
17,53,70,97,13.1,63,Rain,10.2,2022-12-31 19:00:00,19
32,56,88,97,12.9,61,Light Rain,10.1,2022-12-31 20:00:00,20
18,65,83,98,12.5,51,Light Drizzle,11.8,2022-12-31 21:00:00,21
37,57,94,97,12.3,53,Heavy Drizzle,8.6,2022-12-31 22:00:00,22
51,57,108,97,11.8,53,Heavy Drizzle,8.7,2022-12-31 23:00:00,23
57,77,134,97,10.7,0,Clear,11.4,2023-01-01 00:00:00,0
96,100,196,97,10.1,0,Clear,12.7,2023-01-01 01:00:00,1
107,74,181,95,9.9,0,Clear,14.6,2023-01-01 02:00:00,2
46,34,80,94,10.1,0,Clear,14.7,2023-01-01 03:00:00,3
11,15,26,94,9.5,0,Clear,13.4,2023-01-01 04:00:00,4
4,17,21,95,8.8,0,Clear,12.9,2023-01-01 05:00:00,5
15,23,38,95,8.3,0,Clear,10.5,2023-01-01 06:00:00,6
14,31,45,96,7.5,1,Mostly Clear,9.3,2023-01-01 07:00:00,7
33,59,92,96,7.2,1,Mostly Clear,8.0,2023-01-01 08:00:00,8
68,122,190,96,6.5,0,Clear,8.0,2023-01-01 09:00:00,9
145,164,309,94,7.9,0,Clear,8.0,2023-01-01 10:00:00,10
207,214,421,85,9.6,0,Clear,6.1,2023-01-01 11:00:00,11
321,226,547,77,10.7,0,Clear,7.6,2023-01-01 12:00:00,12
403,285,688,70,11.9,0,Clear,9.4,2023-01-01 13:00:00,13
423,256,679,64,12.9,0,Clear,8.8,2023-01-01 14:00:00,14
439,338,777,54,16.5,1,Mostly Clear,6.2,2023-01-01 15:00:00,15
416,344,760,54,16.6,0,Clear,4.6,2023-01-01 16:00:00,16
272,234,506,61,15.5,0,Clear,6.2,2023-01-01 17:00:00,17
144,191,335,68,13.7,0,Clear,7.1,2023-01-01 18:00:00,18
146,124,270,77,11.8,0,Clear,8.9,2023-01-01 19:00:00,19
75,81,156,83,10.4,1,Mostly Clear,10.2,2023-01-01 20:00:00,20
54,89,143,85,9.3,1,Mostly Clear,10.7,2023-01-01 21:00:00,21
47,65,112,86,8.2,1,Mostly Clear,9.5,2023-01-01 22:00:00,22
30,51,81,88,7.4,0,Clear,8.4,2023-01-01 23:00:00,23
26,33,59,88,6.9,0,Clear,7.2,2023-01-02 00:00:00,0
8,9,17,89,6.6,0,Clear,7.9,2023-01-02 01:00:00,1
3,9,12,91,6.2,1,Mostly Clear,8.3,2023-01-02 02:00:00,2
7,4,11,91,5.7,1,Mostly Clear,7.9,2023-01-02 03:00:00,3
3,5,8,92,5.9,1,Mostly Clear,8.6,2023-01-02 04:00:00,4
13,15,28,93,6.1,2,Partly Cloudy,7.9,2023-01-02 05:00:00,5
13,28,41,94,6.1,1,Mostly Clear,11.3,2023-01-02 06:00:00,6
26,52,78,95,6.1,2,Partly Cloudy,8.4,2023-01-02 07:00:00,7
45,93,138,94,6.3,1,Mostly Clear,3.4,2023-01-02 08:00:00,8
95,154,249,88,8.9,1,Mostly Clear,3.9,2023-01-02 09:00:00,9
141,219,360,89,9.4,0,Clear,5.1,2023-01-02 10:00:00,10
276,318,594,83,12.3,0,Clear,4.7,2023-01-02 11:00:00,11
389,343,732,76,14.2,0,Clear,5.6,2023-01-02 12:00:00,12
390,353,743,72,15.4,0,Clear,7.2,2023-01-02 13:00:00,13
400,344,744,69,16.3,1,Mostly Clear,8.5,2023-01-02 14:00:00,14
425,385,810,59,17.6,1,Mostly Clear,9.4,2023-01-02 15:00:00,15
404,366,770,63,17.2,1,Mostly Clear,9.0,2023-01-02 16:00:00,16
251,326,577,68,16.1,1,Mostly Clear,8.1,2023-01-02 17:00:00,17
165,236,401,76,14.3,1,Mostly Clear,8.3,2023-01-02 18:00:00,18
111,178,289,82,13.0,2,Partly Cloudy,8.6,2023-01-02 19:00:00,19
83,136,219,85,12.3,2,Partly Cloudy,8.2,2023-01-02 20:00:00,20
73,86,159,86,12.1,2,Partly Cloudy,7.8,2023-01-02 21:00:00,21
65,80,145,87,11.8,2,Partly Cloudy,7.3,2023-01-02 22:00:00,22
21,35,56,91,11.1,1,Mostly Clear,8.0,2023-01-02 23:00:00,23
16,11,27,92,11.1,2,Partly Cloudy,8.0,2023-01-03 00:00:00,0
7,7,14,93,11.0,2,Partly Cloudy,7.6,2023-01-03 01:00:00,1
2,7,9,94,11.2,3,Cloudy,7.7,2023-01-03 02:00:00,2
0,4,4,95,11.5,3,Cloudy,7.6,2023-01-03 03:00:00,3
7,15,22,96,11.5,2,Partly Cloudy,7.9,2023-01-03 04:00:00,4
20,60,80,97,11.2,1,Mostly Clear,7.9,2023-01-03 05:00:00,5
29,146,175,98,10.8,1,Mostly Clear,5.8,2023-01-03 06:00:00,6
69,346,415,98,10.6,3,Cloudy,8.3,2023-01-03 07:00:00,7
123,543,666,98,10.6,2,Partly Cloudy,9.1,2023-01-03 08:00:00,8
116,248,364,98,11.0,3,Cloudy,11.3,2023-01-03 09:00:00,9
83,160,243,97,12.4,3,Cloudy,12.3,2023-01-03 10:00:00,10
122,188,310,95,13.7,51,Light Drizzle,11.4,2023-01-03 11:00:00,11
132,153,285,91,14.8,51,Light Drizzle,13.7,2023-01-03 12:00:00,12
154,187,341,90,15.4,51,Light Drizzle,13.0,2023-01-03 13:00:00,13
238,237,475,89,15.9,3,Cloudy,16.3,2023-01-03 14:00:00,14
244,266,510,85,17.2,53,Heavy Drizzle,18.2,2023-01-03 15:00:00,15
315,421,736,83,17.7,53,Heavy Drizzle,19.4,2023-01-03 16:00:00,16
310,618,928,78,18.0,1,Mostly Clear,19.3,2023-01-03 17:00:00,17
200,496,696,76,17.8,2,Partly Cloudy,17.6,2023-01-03 18:00:00,18
167,299,466,77,17.6,1,Mostly Clear,18.8,2023-01-03 19:00:00,19
114,194,308,80,17.5,1,Mostly Clear,19.6,2023-01-03 20:00:00,20
69,159,228,82,17.6,1,Mostly Clear,20.0,2023-01-03 21:00:00,21
56,109,165,83,17.7,1,Mostly Clear,20.3,2023-01-03 22:00:00,22
42,50,92,84,17.7,1,Mostly Clear,18.5,2023-01-03 23:00:00,23
26,21,47,85,17.7,3,Cloudy,21.0,2023-01-04 00:00:00,0
22,9,31,87,17.4,1,Mostly Clear,19.9,2023-01-04 01:00:00,1
4,8,12,89,17.1,1,Mostly Clear,16.0,2023-01-04 02:00:00,2
3,4,7,84,16.5,1,Mostly Clear,13.4,2023-01-04 03:00:00,3
2,14,16,88,15.7,1,Mostly Clear,11.0,2023-01-04 04:00:00,4
22,56,78,91,15.0,1,Mostly Clear,10.2,2023-01-04 05:00:00,5
35,166,201,93,14.4,1,Mostly Clear,9.2,2023-01-04 06:00:00,6
78,400,478,93,14.0,1,Mostly Clear,7.3,2023-01-04 07:00:00,7
179,664,843,93,13.7,1,Mostly Clear,7.1,2023-01-04 08:00:00,8
128,326,454,94,13.6,1,Mostly Clear,7.8,2023-01-04 09:00:00,9
143,202,345,92,14.7,1,Mostly Clear,6.4,2023-01-04 10:00:00,10
126,180,306,87,16.3,1,Mostly Clear,6.9,2023-01-04 11:00:00,11
148,231,379,83,17.4,3,Cloudy,8.6,2023-01-04 12:00:00,12
117,150,267,83,17.8,3,Cloudy,9.1,2023-01-04 13:00:00,13
139,205,344,84,18.2,2,Partly Cloudy,10.4,2023-01-04 14:00:00,14
171,274,445,94,16.4,55,Heavy Drizzle,8.7,2023-01-04 15:00:00,15
212,398,610,96,16.2,53,Heavy Drizzle,10.4,2023-01-04 16:00:00,16
295,643,938,96,16.3,51,Light Drizzle,10.5,2023-01-04 17:00:00,17
216,487,703,97,16.2,51,Light Drizzle,11.2,2023-01-04 18:00:00,18
141,336,477,98,16.3,3,Cloudy,12.6,2023-01-04 19:00:00,19
96,233,329,97,16.4,3,Cloudy,12.9,2023-01-04 20:00:00,20
80,156,236,95,15.6,2,Partly Cloudy,13.2,2023-01-04 21:00:00,21
70,95,165,95,15.2,1,Mostly Clear,13.6,2023-01-04 22:00:00,22
35,45,80,96,15.0,1,Mostly Clear,14.0,2023-01-04 23:00:00,23
15,12,27,97,14.9,51,Light Drizzle,13.0,2023-01-05 00:00:00,0
11,13,24,97,14.8,51,Light Drizzle,11.1,2023-01-05 01:00:00,1
2,5,7,97,14.2,1,Mostly Clear,9.4,2023-01-05 02:00:00,2
6,4,10,98,13.5,1,Mostly Clear,9.1,2023-01-05 03:00:00,3
7,9,16,96,13.0,0,Clear,10.0,2023-01-05 04:00:00,4
14,54,68,94,12.3,0,Clear,10.2,2023-01-05 05:00:00,5
34,152,186,93,11.5,1,Mostly Clear,10.0,2023-01-05 06:00:00,6
100,334,434,93,10.7,1,Mostly Clear,10.5,2023-01-05 07:00:00,7
167,576,743,94,9.6,3,Cloudy,8.4,2023-01-05 08:00:00,8
138,317,455,95,9.0,3,Cloudy,6.2,2023-01-05 09:00:00,9
115,175,290,95,10.5,3,Cloudy,3.2,2023-01-05 10:00:00,10
150,174,324,86,13.6,2,Partly Cloudy,2.5,2023-01-05 11:00:00,11
156,241,397,67,15.3,2,Partly Cloudy,2.6,2023-01-05 12:00:00,12
161,240,401,58,16.2,1,Mostly Clear,3.1,2023-01-05 13:00:00,13
253,254,507,55,16.8,51,Light Drizzle,4.9,2023-01-05 14:00:00,14
296,304,600,58,16.1,51,Light Drizzle,6.4,2023-01-05 15:00:00,15
300,467,767,56,15.9,1,Mostly Clear,7.2,2023-01-05 16:00:00,16
338,672,1010,60,15.0,1,Mostly Clear,4.0,2023-01-05 17:00:00,17
234,564,798,77,13.3,51,Light Drizzle,7.5,2023-01-05 18:00:00,18
143,328,471,74,12.1,51,Light Drizzle,4.0,2023-01-05 19:00:00,19
116,239,355,87,9.6,51,Light Drizzle,5.9,2023-01-05 20:00:00,20
72,149,221,90,8.7,1,Mostly Clear,5.9,2023-01-05 21:00:00,21
85,115,200,93,7.6,51,Light Drizzle,8.4,2023-01-05 22:00:00,22
41,57,98,94,7.2,51,Light Drizzle,11.6,2023-01-05 23:00:00,23
18,18,36,94,7.3,0,Clear,12.3,2023-01-06 00:00:00,0
4,12,16,93,7.3,0,Clear,11.3,2023-01-06 01:00:00,1
5,6,11,92,7.1,51,Light Drizzle,8.6,2023-01-06 02:00:00,2
8,4,12,94,5.7,0,Clear,7.5,2023-01-06 03:00:00,3
6,12,18,94,5.1,1,Mostly Clear,7.7,2023-01-06 04:00:00,4
14,45,59,93,5.6,2,Partly Cloudy,7.9,2023-01-06 05:00:00,5
44,129,173,86,7.2,2,Partly Cloudy,4.1,2023-01-06 06:00:00,6
69,263,332,94,5.5,2,Partly Cloudy,6.0,2023-01-06 07:00:00,7
114,395,509,94,5.5,51,Light Drizzle,12.0,2023-01-06 08:00:00,8
88,270,358,92,5.6,51,Light Drizzle,11.0,2023-01-06 09:00:00,9
89,183,272,86,6.4,1,Mostly Clear,11.2,2023-01-06 10:00:00,10
106,205,311,74,7.2,0,Clear,13.2,2023-01-06 11:00:00,11
142,223,365,63,7.8,1,Mostly Clear,19.0,2023-01-06 12:00:00,12
146,206,352,55,8.6,0,Clear,20.3,2023-01-06 13:00:00,13
131,231,362,50,9.1,1,Mostly Clear,20.1,2023-01-06 14:00:00,14
156,308,464,49,9.9,1,Mostly Clear,19.8,2023-01-06 15:00:00,15
222,408,630,46,9.5,3,Cloudy,18.5,2023-01-06 16:00:00,16
232,524,756,43,9.0,3,Cloudy,17.4,2023-01-06 17:00:00,17
154,399,553,43,8.2,3,Cloudy,14.5,2023-01-06 18:00:00,18
133,276,409,46,7.5,3,Cloudy,13.2,2023-01-06 19:00:00,19
65,152,217,49,6.5,3,Cloudy,11.0,2023-01-06 20:00:00,20
77,130,207,55,5.3,2,Partly Cloudy,9.0,2023-01-06 21:00:00,21
46,88,134,63,4.0,1,Mostly Clear,6.9,2023-01-06 22:00:00,22
50,113,163,70,2.8,0,Clear,6.8,2023-01-06 23:00:00,23
45,77,122,74,1.9,0,Clear,7.3,2023-01-07 00:00:00,0
48,47,95,77,1.2,0,Clear,7.4,2023-01-07 01:00:00,1
30,31,61,79,0.7,0,Clear,7.9,2023-01-07 02:00:00,2
10,17,27,80,1.0,0,Clear,7.9,2023-01-07 03:00:00,3
2,6,8,82,0.7,0,Clear,8.4,2023-01-07 04:00:00,4
4,14,18,82,0.4,0,Clear,7.7,2023-01-07 05:00:00,5
8,33,41,83,0.0,0,Clear,6.5,2023-01-07 06:00:00,6
19,70,89,84,-0.4,0,Clear,6.9,2023-01-07 07:00:00,7
59,146,205,85,-0.7,0,Clear,7.2,2023-01-07 08:00:00,8
116,239,355,85,-0.6,0,Clear,7.6,2023-01-07 09:00:00,9
133,289,422,81,2.5,0,Clear,8.4,2023-01-07 10:00:00,10
218,315,533,63,5.8,1,Mostly Clear,8.3,2023-01-07 11:00:00,11
270,352,622,54,6.8,2,Partly Cloudy,14.0,2023-01-07 12:00:00,12
328,345,673,50,7.4,2,Partly Cloudy,12.8,2023-01-07 13:00:00,13
320,353,673,47,7.8,2,Partly Cloudy,13.5,2023-01-07 14:00:00,14
300,359,659,42,8.8,3,Cloudy,14.7,2023-01-07 15:00:00,15
289,387,676,40,8.6,2,Partly Cloudy,14.8,2023-01-07 16:00:00,16
197,333,530,41,8.2,2,Partly Cloudy,13.7,2023-01-07 17:00:00,17
134,236,370,44,7.1,3,Cloudy,10.9,2023-01-07 18:00:00,18
95,200,295,47,6.1,1,Mostly Clear,11.9,2023-01-07 19:00:00,19
68,132,200,50,5.3,0,Clear,13.8,2023-01-07 20:00:00,20
56,110,166,53,4.2,0,Clear,13.8,2023-01-07 21:00:00,21
63,86,149,57,3.5,0,Clear,13.3,2023-01-07 22:00:00,22
50,83,133,61,2.8,0,Clear,11.5,2023-01-07 23:00:00,23
45,81,126,65,2.1,0,Clear,11.8,2023-01-08 00:00:00,0
52,39,91,69,1.6,0,Clear,11.5,2023-01-08 01:00:00,1
41,51,92,72,1.1,0,Clear,10.9,2023-01-08 02:00:00,2
16,16,32,76,0.6,0,Clear,9.2,2023-01-08 03:00:00,3
6,6,12,81,-0.2,0,Clear,8.4,2023-01-08 04:00:00,4
3,11,14,85,-1.0,0,Clear,7.9,2023-01-08 05:00:00,5
9,14,23,87,-1.7,0,Clear,7.1,2023-01-08 06:00:00,6
13,50,63,88,-2.1,0,Clear,6.4,2023-01-08 07:00:00,7
35,86,121,87,-1.9,0,Clear,5.6,2023-01-08 08:00:00,8
68,191,259,85,-1.0,1,Mostly Clear,5.3,2023-01-08 09:00:00,9
135,214,349,85,0.6,1,Mostly Clear,2.8,2023-01-08 10:00:00,10
147,281,428,71,3.0,1,Mostly Clear,1.8,2023-01-08 11:00:00,11
188,322,510,64,4.6,1,Mostly Clear,2.9,2023-01-08 12:00:00,12
170,282,452,59,5.6,1,Mostly Clear,4.9,2023-01-08 13:00:00,13
164,301,465,56,6.4,2,Partly Cloudy,7.9,2023-01-08 14:00:00,14
195,285,480,55,6.3,3,Cloudy,9.8,2023-01-08 15:00:00,15
149,278,427,57,5.8,3,Cloudy,10.1,2023-01-08 16:00:00,16
105,225,330,61,5.3,3,Cloudy,7.2,2023-01-08 17:00:00,17
80,218,298,65,4.9,3,Cloudy,5.8,2023-01-08 18:00:00,18
61,163,224,69,4.5,3,Cloudy,7.6,2023-01-08 19:00:00,19
47,93,140,72,4.3,3,Cloudy,8.7,2023-01-08 20:00:00,20
35,72,107,78,4.0,51,Light Drizzle,10.8,2023-01-08 21:00:00,21
32,42,74,91,3.2,53,Heavy Drizzle,10.8,2023-01-08 22:00:00,22
22,37,59,99,2.1,53,Heavy Drizzle,10.4,2023-01-08 23:00:00,23
4,11,15,99,2.1,71,Light Snow,9.7,2023-01-09 00:00:00,0
3,8,11,99,2.4,71,Light Snow,9.1,2023-01-09 01:00:00,1
5,3,8,98,2.7,71,Light Snow,9.0,2023-01-09 02:00:00,2
2,5,7,98,2.9,51,Light Drizzle,8.0,2023-01-09 03:00:00,3
0,7,7,98,3.0,51,Light Drizzle,7.2,2023-01-09 04:00:00,4
10,39,49,98,2.8,51,Light Drizzle,6.5,2023-01-09 05:00:00,5
37,135,172,98,2.4,2,Partly Cloudy,6.8,2023-01-09 06:00:00,6
76,298,374,98,1.7,2,Partly Cloudy,8.0,2023-01-09 07:00:00,7
108,468,576,96,1.1,1,Mostly Clear,8.4,2023-01-09 08:00:00,8
78,269,347,94,1.1,1,Mostly Clear,8.5,2023-01-09 09:00:00,9
44,159,203,91,2.1,0,Clear,9.2,2023-01-09 10:00:00,10
88,154,242,81,3.6,0,Clear,11.6,2023-01-09 11:00:00,11
117,217,334,71,4.8,0,Clear,15.5,2023-01-09 12:00:00,12
118,195,313,62,5.9,0,Clear,16.3,2023-01-09 13:00:00,13
122,226,348,54,6.8,0,Clear,16.1,2023-01-09 14:00:00,14
139,302,441,50,8.5,0,Clear,16.3,2023-01-09 15:00:00,15
150,381,531,46,8.5,0,Clear,16.7,2023-01-09 16:00:00,16
168,565,733,47,7.8,0,Clear,14.7,2023-01-09 17:00:00,17
162,493,655,49,6.5,0,Clear,10.3,2023-01-09 18:00:00,18
113,362,475,51,5.2,0,Clear,10.7,2023-01-09 19:00:00,19
78,165,243,54,4.4,0,Clear,12.0,2023-01-09 20:00:00,20
51,171,222,56,3.6,0,Clear,12.8,2023-01-09 21:00:00,21
58,85,143,58,2.8,0,Clear,12.2,2023-01-09 22:00:00,22
23,48,71,60,2.2,0,Clear,13.2,2023-01-09 23:00:00,23
10,18,28,60,1.8,0,Clear,14.0,2023-01-10 00:00:00,0
5,11,16,61,1.4,0,Clear,13.8,2023-01-10 01:00:00,1
3,5,8,62,1.1,0,Clear,13.2,2023-01-10 02:00:00,2
0,4,4,64,0.8,0,Clear,12.2,2023-01-10 03:00:00,3
1,7,8,66,0.4,0,Clear,11.2,2023-01-10 04:00:00,4
18,60,78,72,-0.3,0,Clear,8.2,2023-01-10 05:00:00,5
35,148,183,79,-1.2,1,Mostly Clear,7.1,2023-01-10 06:00:00,6
73,368,441,79,-1.4,1,Mostly Clear,6.7,2023-01-10 07:00:00,7
160,593,753,79,-1.4,2,Partly Cloudy,7.0,2023-01-10 08:00:00,8
98,311,409,78,-0.9,2,Partly Cloudy,6.6,2023-01-10 09:00:00,9
74,177,251,81,0.8,2,Partly Cloudy,4.5,2023-01-10 10:00:00,10
78,189,267,66,3.2,2,Partly Cloudy,3.1,2023-01-10 11:00:00,11
89,232,321,62,4.6,1,Mostly Clear,4.9,2023-01-10 12:00:00,12
85,209,294,57,6.1,1,Mostly Clear,5.7,2023-01-10 13:00:00,13
101,219,320,54,6.9,1,Mostly Clear,3.2,2023-01-10 14:00:00,14
129,299,428,48,7.8,2,Partly Cloudy,1.8,2023-01-10 15:00:00,15
179,419,598,47,7.8,1,Mostly Clear,2.5,2023-01-10 16:00:00,16
203,685,888,51,7.3,1,Mostly Clear,2.6,2023-01-10 17:00:00,17
168,536,704,58,6.2,2,Partly Cloudy,4.8,2023-01-10 18:00:00,18
131,369,500,67,4.5,2,Partly Cloudy,5.3,2023-01-10 19:00:00,19
68,243,311,74,3.2,1,Mostly Clear,6.4,2023-01-10 20:00:00,20
56,176,232,80,2.4,2,Partly Cloudy,6.2,2023-01-10 21:00:00,21
62,109,171,84,1.8,2,Partly Cloudy,5.6,2023-01-10 22:00:00,22
37,53,90,85,1.5,1,Mostly Clear,6.0,2023-01-10 23:00:00,23
13,23,36,81,2.2,0,Clear,6.5,2023-01-11 00:00:00,0
3,3,6,80,2.6,0,Clear,7.8,2023-01-11 01:00:00,1
1,3,4,82,2.2,0,Clear,6.7,2023-01-11 02:00:00,2
3,3,6,83,1.9,0,Clear,6.2,2023-01-11 03:00:00,3
1,8,9,85,1.6,0,Clear,1.3,2023-01-11 04:00:00,4
18,53,71,94,-2.0,0,Clear,6.0,2023-01-11 05:00:00,5
34,151,185,90,-0.1,0,Clear,7.3,2023-01-11 06:00:00,6
87,327,414,92,-1.1,0,Clear,6.5,2023-01-11 07:00:00,7
155,623,778,91,-0.0,1,Mostly Clear,6.0,2023-01-11 08:00:00,8
102,350,452,93,-0.6,1,Mostly Clear,6.5,2023-01-11 09:00:00,9
80,178,258,92,1.5,1,Mostly Clear,6.5,2023-01-11 10:00:00,10
64,173,237,77,4.5,1,Mostly Clear,5.6,2023-01-11 11:00:00,11
82,236,318,68,5.8,1,Mostly Clear,6.8,2023-01-11 12:00:00,12
81,222,303,63,6.6,1,Mostly Clear,8.8,2023-01-11 13:00:00,13
98,227,325,62,6.8,2,Partly Cloudy,10.0,2023-01-11 14:00:00,14
118,279,397,61,6.8,3,Cloudy,11.0,2023-01-11 15:00:00,15
134,407,541,61,6.8,3,Cloudy,10.7,2023-01-11 16:00:00,16
212,646,858,65,6.2,3,Cloudy,10.5,2023-01-11 17:00:00,17
178,557,735,70,5.5,3,Cloudy,8.4,2023-01-11 18:00:00,18
153,335,488,75,4.6,2,Partly Cloudy,8.7,2023-01-11 19:00:00,19
77,211,288,80,4.1,1,Mostly Clear,7.9,2023-01-11 20:00:00,20
68,191,259,85,3.5,51,Light Drizzle,7.9,2023-01-11 21:00:00,21
46,66,112,90,3.0,51,Light Drizzle,8.9,2023-01-11 22:00:00,22
24,51,75,92,3.2,55,Heavy Drizzle,10.5,2023-01-11 23:00:00,23
11,19,30,94,3.4,51,Light Drizzle,11.1,2023-01-12 00:00:00,0
4,8,12,95,3.8,51,Light Drizzle,10.7,2023-01-12 01:00:00,1
4,6,10,95,4.0,53,Heavy Drizzle,10.2,2023-01-12 02:00:00,2
6,5,11,95,4.2,51,Light Drizzle,10.7,2023-01-12 03:00:00,3
2,10,12,96,4.4,3,Cloudy,9.9,2023-01-12 04:00:00,4
16,48,64,96,4.6,3,Cloudy,9.7,2023-01-12 05:00:00,5
34,123,157,96,4.4,3,Cloudy,7.9,2023-01-12 06:00:00,6
72,312,384,96,4.8,3,Cloudy,7.4,2023-01-12 07:00:00,7
142,552,694,97,4.7,3,Cloudy,6.6,2023-01-12 08:00:00,8
111,310,421,97,4.7,3,Cloudy,7.2,2023-01-12 09:00:00,9
56,168,224,96,5.6,2,Partly Cloudy,7.1,2023-01-12 10:00:00,10
67,236,303,91,7.0,3,Cloudy,8.8,2023-01-12 11:00:00,11
133,217,350,86,8.6,3,Cloudy,9.3,2023-01-12 12:00:00,12
132,250,382,79,10.0,3,Cloudy,8.6,2023-01-12 13:00:00,13
93,205,298,75,11.0,3,Cloudy,8.7,2023-01-12 14:00:00,14
108,248,356,77,10.8,3,Cloudy,8.6,2023-01-12 15:00:00,15
125,372,497,79,10.8,53,Heavy Drizzle,7.8,2023-01-12 16:00:00,16
191,619,810,86,10.2,51,Light Drizzle,10.2,2023-01-12 17:00:00,17
159,462,621,87,9.9,3,Cloudy,9.7,2023-01-12 18:00:00,18
130,319,449,87,10.4,3,Cloudy,9.8,2023-01-12 19:00:00,19
79,194,273,90,11.6,3,Cloudy,12.6,2023-01-12 20:00:00,20
37,125,162,93,12.9,51,Light Drizzle,15.5,2023-01-12 21:00:00,21
22,58,80,93,13.8,51,Light Drizzle,15.1,2023-01-12 22:00:00,22
12,43,55,93,14.3,53,Heavy Drizzle,15.3,2023-01-12 23:00:00,23
5,20,25,93,14.5,61,Light Rain,12.2,2023-01-13 00:00:00,0
8,21,29,92,14.2,63,Rain,17.1,2023-01-13 01:00:00,1
3,5,8,92,13.5,63,Rain,23.9,2023-01-13 02:00:00,2
2,8,10,95,12.9,53,Heavy Drizzle,23.0,2023-01-13 03:00:00,3
2,9,11,95,12.6,51,Light Drizzle,21.1,2023-01-13 04:00:00,4
12,26,38,95,12.1,53,Heavy Drizzle,19.9,2023-01-13 05:00:00,5
17,61,78,97,11.5,53,Heavy Drizzle,15.0,2023-01-13 06:00:00,6
37,203,240,97,10.9,53,Heavy Drizzle,15.9,2023-01-13 07:00:00,7
85,342,427,91,8.3,51,Light Drizzle,20.8,2023-01-13 08:00:00,8
110,272,382,84,5.9,1,Mostly Clear,19.5,2023-01-13 09:00:00,9
96,173,269,77,6.1,1,Mostly Clear,16.8,2023-01-13 10:00:00,10
121,210,331,66,7.1,1,Mostly Clear,19.2,2023-01-13 11:00:00,11
164,292,456,60,8.1,1,Mostly Clear,21.1,2023-01-13 12:00:00,12
114,291,405,56,9.0,1,Mostly Clear,22.8,2023-01-13 13:00:00,13
187,283,470,53,9.7,1,Mostly Clear,23.2,2023-01-13 14:00:00,14
162,350,512,56,9.4,1,Mostly Clear,22.7,2023-01-13 15:00:00,15
158,388,546,56,8.5,3,Cloudy,22.3,2023-01-13 16:00:00,16
167,445,612,55,7.4,3,Cloudy,22.1,2023-01-13 17:00:00,17
142,381,523,54,6.5,3,Cloudy,18.8,2023-01-13 18:00:00,18
104,289,393,54,6.0,3,Cloudy,17.6,2023-01-13 19:00:00,19
72,165,237,54,5.6,3,Cloudy,15.2,2023-01-13 20:00:00,20
63,121,184,53,5.4,3,Cloudy,15.7,2023-01-13 21:00:00,21
44,101,145,53,4.9,3,Cloudy,16.5,2023-01-13 22:00:00,22
50,109,159,54,4.4,3,Cloudy,18.0,2023-01-13 23:00:00,23
35,84,119,54,3.8,3,Cloudy,19.4,2023-01-14 00:00:00,0
24,49,73,55,3.3,3,Cloudy,19.8,2023-01-14 01:00:00,1
19,34,53,55,2.7,3,Cloudy,19.3,2023-01-14 02:00:00,2
8,14,22,55,2.5,2,Partly Cloudy,18.3,2023-01-14 03:00:00,3
2,10,12,55,2.0,1,Mostly Clear,17.9,2023-01-14 04:00:00,4
6,10,16,56,1.6,2,Partly Cloudy,17.6,2023-01-14 05:00:00,5
10,28,38,55,1.4,3,Cloudy,13.2,2023-01-14 06:00:00,6
25,71,96,55,1.2,3,Cloudy,14.7,2023-01-14 07:00:00,7
46,117,163,56,1.0,3,Cloudy,17.2,2023-01-14 08:00:00,8
92,179,271,57,1.0,3,Cloudy,18.6,2023-01-14 09:00:00,9
114,225,339,56,1.7,3,Cloudy,19.0,2023-01-14 10:00:00,10
113,241,354,52,2.4,3,Cloudy,19.5,2023-01-14 11:00:00,11
119,305,424,51,3.1,3,Cloudy,20.8,2023-01-14 12:00:00,12
129,248,377,50,3.5,3,Cloudy,22.1,2023-01-14 13:00:00,13
132,287,419,48,4.2,3,Cloudy,23.7,2023-01-14 14:00:00,14
129,284,413,48,3.2,3,Cloudy,23.2,2023-01-14 15:00:00,15
119,243,362,47,3.2,3,Cloudy,22.7,2023-01-14 16:00:00,16
94,196,290,46,3.1,3,Cloudy,21.6,2023-01-14 17:00:00,17
79,187,266,47,2.9,2,Partly Cloudy,20.2,2023-01-14 18:00:00,18
54,167,221,47,2.5,2,Partly Cloudy,16.6,2023-01-14 19:00:00,19
40,134,174,48,2.1,2,Partly Cloudy,20.2,2023-01-14 20:00:00,20
39,90,129,49,1.5,0,Clear,24.6,2023-01-14 21:00:00,21
41,77,118,51,0.9,0,Clear,22.1,2023-01-14 22:00:00,22
33,88,121,52,0.3,0,Clear,17.8,2023-01-14 23:00:00,23
27,61,88,54,-0.2,1,Mostly Clear,16.6,2023-01-15 00:00:00,0
29,39,68,55,-0.6,1,Mostly Clear,18.8,2023-01-15 01:00:00,1
20,30,50,56,-0.8,0,Clear,21.6,2023-01-15 02:00:00,2
10,11,21,56,-0.7,0,Clear,22.7,2023-01-15 03:00:00,3
5,6,11,56,-0.8,0,Clear,21.8,2023-01-15 04:00:00,4
5,10,15,56,-0.9,0,Clear,20.7,2023-01-15 05:00:00,5
9,12,21,56,-0.9,0,Clear,15.6,2023-01-15 06:00:00,6
15,45,60,57,-1.0,0,Clear,17.2,2023-01-15 07:00:00,7
38,85,123,57,-1.1,0,Clear,17.4,2023-01-15 08:00:00,8
78,151,229,59,-0.9,0,Clear,17.1,2023-01-15 09:00:00,9
140,238,378,58,-0.1,0,Clear,18.4,2023-01-15 10:00:00,10
148,263,411,54,1.3,0,Clear,19.3,2023-01-15 11:00:00,11
186,310,496,51,2.7,0,Clear,19.2,2023-01-15 12:00:00,12
196,260,456,48,4.1,0,Clear,18.8,2023-01-15 13:00:00,13
217,259,476,46,5.1,0,Clear,18.7,2023-01-15 14:00:00,14
220,319,539,46,6.0,0,Clear,18.5,2023-01-15 15:00:00,15
170,293,463,44,6.4,0,Clear,18.7,2023-01-15 16:00:00,16
113,259,372,44,6.0,0,Clear,15.5,2023-01-15 17:00:00,17
82,212,294,46,4.8,0,Clear,12.0,2023-01-15 18:00:00,18
57,156,213,48,3.6,0,Clear,12.4,2023-01-15 19:00:00,19
49,129,178,49,2.8,0,Clear,12.7,2023-01-15 20:00:00,20
46,89,135,51,2.0,0,Clear,14.2,2023-01-15 21:00:00,21
40,66,106,52,1.3,0,Clear,15.1,2023-01-15 22:00:00,22
49,56,105,53,0.6,0,Clear,14.8,2023-01-15 23:00:00,23
22,28,50,55,-0.1,0,Clear,13.9,2023-01-16 00:00:00,0
10,22,32,56,-0.7,0,Clear,12.9,2023-01-16 01:00:00,1
5,7,12,58,-1.3,0,Clear,12.2,2023-01-16 02:00:00,2
2,4,6,57,-1.4,0,Clear,11.3,2023-01-16 03:00:00,3
1,6,7,59,-2.0,0,Clear,10.7,2023-01-16 04:00:00,4
6,23,29,61,-2.4,0,Clear,10.3,2023-01-16 05:00:00,5
16,38,54,61,-2.7,0,Clear,11.6,2023-01-16 06:00:00,6
21,75,96,60,-2.7,0,Clear,13.3,2023-01-16 07:00:00,7
29,118,147,62,-2.8,0,Clear,13.5,2023-01-16 08:00:00,8
70,154,224,67,-2.7,0,Clear,13.0,2023-01-16 09:00:00,9
132,223,355,54,0.8,0,Clear,12.7,2023-01-16 10:00:00,10
156,302,458,43,3.5,0,Clear,11.7,2023-01-16 11:00:00,11
219,333,552,39,5.6,0,Clear,12.7,2023-01-16 12:00:00,12
225,346,571,36,7.4,0,Clear,13.2,2023-01-16 13:00:00,13
289,389,678,35,8.9,0,Clear,13.0,2023-01-16 14:00:00,14
283,357,640,32,10.6,0,Clear,12.2,2023-01-16 15:00:00,15
244,430,674,32,10.9,0,Clear,13.7,2023-01-16 16:00:00,16
188,386,574,37,10.2,0,Clear,10.8,2023-01-16 17:00:00,17
109,273,382,41,8.2,1,Mostly Clear,8.2,2023-01-16 18:00:00,18
83,239,322,45,6.5,1,Mostly Clear,8.9,2023-01-16 19:00:00,19
58,153,211,51,5.2,1,Mostly Clear,9.3,2023-01-16 20:00:00,20
49,114,163,58,4.3,1,Mostly Clear,8.4,2023-01-16 21:00:00,21
45,69,114,65,3.3,1,Mostly Clear,7.6,2023-01-16 22:00:00,22
29,41,70,65,2.9,1,Mostly Clear,8.3,2023-01-16 23:00:00,23
10,16,26,58,3.6,1,Mostly Clear,7.6,2023-01-17 00:00:00,0
2,8,10,59,3.7,2,Partly Cloudy,5.1,2023-01-17 01:00:00,1
0,10,10,73,1.5,2,Partly Cloudy,3.7,2023-01-17 02:00:00,2
1,4,5,70,1.4,2,Partly Cloudy,7.3,2023-01-17 03:00:00,3
1,11,12,72,1.4,1,Mostly Clear,7.2,2023-01-17 04:00:00,4
16,46,62,73,1.3,2,Partly Cloudy,7.6,2023-01-17 05:00:00,5
32,136,168,73,1.6,3,Cloudy,5.5,2023-01-17 06:00:00,6
51,276,327,71,2.0,3,Cloudy,6.7,2023-01-17 07:00:00,7
81,394,475,67,3.0,3,Cloudy,7.0,2023-01-17 08:00:00,8
49,203,252,78,3.3,53,Heavy Drizzle,8.2,2023-01-17 09:00:00,9
24,114,138,89,3.5,53,Heavy Drizzle,7.0,2023-01-17 10:00:00,10
21,101,122,92,3.9,53,Heavy Drizzle,6.5,2023-01-17 11:00:00,11
37,120,157,93,4.5,55,Heavy Drizzle,5.4,2023-01-17 12:00:00,12
54,169,223,93,5.2,53,Heavy Drizzle,7.1,2023-01-17 13:00:00,13
59,166,225,91,5.8,51,Light Drizzle,9.2,2023-01-17 14:00:00,14
92,260,352,91,8.2,3,Cloudy,10.2,2023-01-17 15:00:00,15
132,412,544,89,9.0,3,Cloudy,9.9,2023-01-17 16:00:00,16
170,639,809,89,9.2,3,Cloudy,9.7,2023-01-17 17:00:00,17
156,546,702,94,8.4,3,Cloudy,4.7,2023-01-17 18:00:00,18
105,389,494,97,7.4,2,Partly Cloudy,6.3,2023-01-17 19:00:00,19
62,231,293,98,6.8,2,Partly Cloudy,6.3,2023-01-17 20:00:00,20
67,213,280,98,6.5,1,Mostly Clear,7.0,2023-01-17 21:00:00,21
48,113,161,98,6.2,2,Partly Cloudy,8.7,2023-01-17 22:00:00,22
25,45,70,97,6.2,1,Mostly Clear,9.8,2023-01-17 23:00:00,23
12,18,30,97,6.2,0,Clear,10.9,2023-01-18 00:00:00,0
4,6,10,97,6.4,0,Clear,12.3,2023-01-18 01:00:00,1
2,5,7,97,6.6,0,Clear,12.5,2023-01-18 02:00:00,2
3,3,6,96,7.0,51,Light Drizzle,12.1,2023-01-18 03:00:00,3
1,16,17,97,6.8,0,Clear,11.2,2023-01-18 04:00:00,4
21,49,70,96,6.2,0,Clear,10.2,2023-01-18 05:00:00,5
31,159,190,97,5.5,0,Clear,12.9,2023-01-18 06:00:00,6
73,412,485,97,4.7,0,Clear,10.6,2023-01-18 07:00:00,7
143,622,765,97,4.2,0,Clear,10.3,2023-01-18 08:00:00,8
101,332,433,96,4.6,0,Clear,10.8,2023-01-18 09:00:00,9
84,202,286,90,6.9,0,Clear,10.7,2023-01-18 10:00:00,10
77,201,278,77,8.6,0,Clear,9.7,2023-01-18 11:00:00,11
104,274,378,67,9.3,0,Clear,15.3,2023-01-18 12:00:00,12
104,271,375,63,10.0,1,Mostly Clear,17.4,2023-01-18 13:00:00,13
123,275,398,60,10.4,1,Mostly Clear,16.8,2023-01-18 14:00:00,14
156,336,492,53,13.6,0,Clear,16.3,2023-01-18 15:00:00,15
198,481,679,52,13.4,0,Clear,15.8,2023-01-18 16:00:00,16
242,734,976,55,12.6,1,Mostly Clear,12.8,2023-01-18 17:00:00,17
188,646,834,60,10.7,1,Mostly Clear,8.4,2023-01-18 18:00:00,18
159,432,591,64,9.1,0,Clear,8.2,2023-01-18 19:00:00,19
95,260,355,67,8.0,0,Clear,9.5,2023-01-18 20:00:00,20
61,210,271,69,6.9,0,Clear,8.7,2023-01-18 21:00:00,21
58,136,194,72,6.0,0,Clear,7.9,2023-01-18 22:00:00,22
17,49,66,75,5.2,1,Mostly Clear,7.3,2023-01-18 23:00:00,23
16,34,50,77,4.8,2,Partly Cloudy,7.8,2023-01-19 00:00:00,0
8,9,17,79,4.6,3,Cloudy,6.1,2023-01-19 01:00:00,1
4,7,11,83,4.5,51,Light Drizzle,4.8,2023-01-19 02:00:00,2
2,4,6,80,4.7,3,Cloudy,5.0,2023-01-19 03:00:00,3
2,11,13,82,4.8,3,Cloudy,5.1,2023-01-19 04:00:00,4
17,57,74,84,4.6,3,Cloudy,6.1,2023-01-19 05:00:00,5
29,150,179,83,4.6,1,Mostly Clear,3.6,2023-01-19 06:00:00,6
73,285,358,84,4.2,2,Partly Cloudy,6.1,2023-01-19 07:00:00,7
102,514,616,81,4.5,51,Light Drizzle,5.9,2023-01-19 08:00:00,8
84,339,423,81,4.8,51,Light Drizzle,7.9,2023-01-19 09:00:00,9
56,194,250,88,4.9,55,Heavy Drizzle,10.7,2023-01-19 10:00:00,10
53,201,254,92,5.1,61,Light Rain,11.8,2023-01-19 11:00:00,11
75,205,280,93,5.6,53,Heavy Drizzle,12.6,2023-01-19 12:00:00,12
83,180,263,93,6.5,51,Light Drizzle,10.7,2023-01-19 13:00:00,13
53,152,205,96,7.0,53,Heavy Drizzle,9.2,2023-01-19 14:00:00,14
94,202,296,85,8.7,51,Light Drizzle,7.7,2023-01-19 15:00:00,15
99,297,396,89,9.6,51,Light Drizzle,4.7,2023-01-19 16:00:00,16
136,498,634,94,9.9,53,Heavy Drizzle,2.3,2023-01-19 17:00:00,17
81,328,409,96,9.9,51,Light Drizzle,4.3,2023-01-19 18:00:00,18
55,277,332,97,9.9,61,Light Rain,3.6,2023-01-19 19:00:00,19
62,218,280,97,10.2,61,Light Rain,3.4,2023-01-19 20:00:00,20
72,173,245,98,10.0,61,Light Rain,8.0,2023-01-19 21:00:00,21
51,133,184,97,9.8,61,Light Rain,8.2,2023-01-19 22:00:00,22
13,68,81,97,9.5,51,Light Drizzle,5.9,2023-01-19 23:00:00,23
30,32,62,97,9.2,3,Cloudy,7.0,2023-01-20 00:00:00,0
16,21,37,97,9.4,3,Cloudy,8.6,2023-01-20 01:00:00,1
4,11,15,95,9.3,3,Cloudy,10.0,2023-01-20 02:00:00,2
3,9,12,97,8.0,2,Partly Cloudy,13.6,2023-01-20 03:00:00,3
3,16,19,90,7.8,2,Partly Cloudy,15.5,2023-01-20 04:00:00,4
15,44,59,87,7.2,1,Mostly Clear,15.5,2023-01-20 05:00:00,5
29,117,146,87,6.3,2,Partly Cloudy,14.0,2023-01-20 06:00:00,6
57,304,361,83,5.9,1,Mostly Clear,12.1,2023-01-20 07:00:00,7
109,469,578,78,5.2,0,Clear,10.2,2023-01-20 08:00:00,8
116,276,392,73,4.9,0,Clear,11.9,2023-01-20 09:00:00,9
78,208,286,67,5.9,0,Clear,14.2,2023-01-20 10:00:00,10
122,239,361,54,7.3,0,Clear,15.5,2023-01-20 11:00:00,11
131,298,429,45,8.4,1,Mostly Clear,24.0,2023-01-20 12:00:00,12
114,255,369,43,8.9,1,Mostly Clear,22.8,2023-01-20 13:00:00,13
160,276,436,43,9.0,2,Partly Cloudy,23.6,2023-01-20 14:00:00,14
143,365,508,44,9.6,0,Clear,23.7,2023-01-20 15:00:00,15
175,430,605,44,9.2,0,Clear,23.4,2023-01-20 16:00:00,16
236,526,762,45,8.4,0,Clear,22.4,2023-01-20 17:00:00,17
161,461,622,45,7.3,3,Cloudy,18.3,2023-01-20 18:00:00,18
119,339,458,46,6.3,3,Cloudy,16.6,2023-01-20 19:00:00,19
57,210,267,48,5.5,1,Mostly Clear,14.6,2023-01-20 20:00:00,20
62,147,209,49,4.9,1,Mostly Clear,14.6,2023-01-20 21:00:00,21
79,138,217,51,4.4,0,Clear,15.0,2023-01-20 22:00:00,22
53,131,184,54,3.8,0,Clear,14.2,2023-01-20 23:00:00,23
41,73,114,56,3.4,0,Clear,14.7,2023-01-21 00:00:00,0
54,60,114,58,3.0,0,Clear,16.0,2023-01-21 01:00:00,1
11,32,43,59,2.8,0,Clear,15.5,2023-01-21 02:00:00,2
4,16,20,62,2.7,0,Clear,14.0,2023-01-21 03:00:00,3
2,8,10,64,2.4,0,Clear,13.4,2023-01-21 04:00:00,4
7,8,15,65,2.1,1,Mostly Clear,13.2,2023-01-21 05:00:00,5
19,31,50,68,1.7,3,Cloudy,10.8,2023-01-21 06:00:00,6
28,75,103,70,1.4,3,Cloudy,11.9,2023-01-21 07:00:00,7
64,138,202,72,1.2,3,Cloudy,10.4,2023-01-21 08:00:00,8
111,235,346,75,1.2,2,Partly Cloudy,9.4,2023-01-21 09:00:00,9
133,336,469,70,3.0,2,Partly Cloudy,9.8,2023-01-21 10:00:00,10
163,364,527,58,4.8,1,Mostly Clear,13.2,2023-01-21 11:00:00,11
212,428,640,54,5.7,2,Partly Cloudy,15.9,2023-01-21 12:00:00,12
186,403,589,52,6.3,3,Cloudy,13.9,2023-01-21 13:00:00,13
206,376,582,51,6.6,3,Cloudy,12.5,2023-01-21 14:00:00,14
224,399,623,49,6.7,3,Cloudy,10.8,2023-01-21 15:00:00,15
221,313,534,48,6.8,3,Cloudy,9.7,2023-01-21 16:00:00,16
164,327,491,48,6.5,3,Cloudy,8.7,2023-01-21 17:00:00,17
106,240,346,50,6.1,3,Cloudy,6.9,2023-01-21 18:00:00,18
105,233,338,62,5.5,3,Cloudy,3.1,2023-01-21 19:00:00,19
68,177,245,66,4.9,2,Partly Cloudy,4.0,2023-01-21 20:00:00,20
74,116,190,55,5.1,1,Mostly Clear,1.5,2023-01-21 21:00:00,21
72,120,192,60,4.2,1,Mostly Clear,2.3,2023-01-21 22:00:00,22
64,114,178,78,1.4,0,Clear,5.2,2023-01-21 23:00:00,23
65,94,159,82,0.4,1,Mostly Clear,7.1,2023-01-22 00:00:00,0
46,66,112,84,-0.3,1,Mostly Clear,6.6,2023-01-22 01:00:00,1
32,36,68,86,-0.6,1,Mostly Clear,7.6,2023-01-22 02:00:00,2
18,20,38,85,-0.7,1,Mostly Clear,6.9,2023-01-22 03:00:00,3
2,8,10,87,-0.7,1,Mostly Clear,8.2,2023-01-22 04:00:00,4
3,13,16,89,-0.7,1,Mostly Clear,8.9,2023-01-22 05:00:00,5
11,15,26,91,-0.6,1,Mostly Clear,9.1,2023-01-22 06:00:00,6
8,56,64,91,-0.5,1,Mostly Clear,8.4,2023-01-22 07:00:00,7
33,89,122,91,-0.1,1,Mostly Clear,10.1,2023-01-22 08:00:00,8
77,181,258,90,0.5,1,Mostly Clear,10.2,2023-01-22 09:00:00,9
133,257,390,84,2.5,1,Mostly Clear,10.3,2023-01-22 10:00:00,10
124,237,361,75,4.4,3,Cloudy,11.6,2023-01-22 11:00:00,11
120,263,383,68,5.6,3,Cloudy,11.2,2023-01-22 12:00:00,12
137,253,390,65,6.4,2,Partly Cloudy,10.5,2023-01-22 13:00:00,13
149,233,382,69,6.2,51,Light Drizzle,10.5,2023-01-22 14:00:00,14
120,233,353,82,5.4,53,Heavy Drizzle,12.5,2023-01-22 15:00:00,15
77,185,262,92,4.7,53,Heavy Drizzle,13.0,2023-01-22 16:00:00,16
51,152,203,95,4.5,51,Light Drizzle,10.0,2023-01-22 17:00:00,17
16,79,95,96,4.3,51,Light Drizzle,8.0,2023-01-22 18:00:00,18
17,71,88,97,4.3,53,Heavy Drizzle,7.6,2023-01-22 19:00:00,19
12,42,54,97,4.4,61,Light Rain,8.1,2023-01-22 20:00:00,20
14,55,69,97,4.3,61,Light Rain,8.9,2023-01-22 21:00:00,21
12,51,63,97,4.2,53,Heavy Drizzle,8.7,2023-01-22 22:00:00,22
12,23,35,97,4.2,51,Light Drizzle,9.9,2023-01-22 23:00:00,23
8,14,22,97,4.2,51,Light Drizzle,9.5,2023-01-23 00:00:00,0
1,6,7,98,4.2,51,Light Drizzle,7.0,2023-01-23 01:00:00,1
2,2,4,98,4.1,51,Light Drizzle,4.2,2023-01-23 02:00:00,2
0,5,5,98,3.5,51,Light Drizzle,6.9,2023-01-23 03:00:00,3
3,10,13,98,3.4,51,Light Drizzle,8.9,2023-01-23 04:00:00,4
8,28,36,98,3.4,51,Light Drizzle,10.2,2023-01-23 05:00:00,5
12,86,98,98,3.4,53,Heavy Drizzle,9.1,2023-01-23 06:00:00,6
29,193,222,97,3.3,53,Heavy Drizzle,11.5,2023-01-23 07:00:00,7
68,398,466,97,3.0,51,Light Drizzle,13.1,2023-01-23 08:00:00,8
52,242,294,96,3.1,51,Light Drizzle,13.9,2023-01-23 09:00:00,9
60,173,233,95,4.0,51,Light Drizzle,13.7,2023-01-23 10:00:00,10
56,179,235,89,4.7,51,Light Drizzle,18.9,2023-01-23 11:00:00,11
68,221,289,75,6.1,2,Partly Cloudy,24.5,2023-01-23 12:00:00,12
83,218,301,67,6.8,3,Cloudy,24.0,2023-01-23 13:00:00,13
79,201,280,61,7.4,2,Partly Cloudy,22.2,2023-01-23 14:00:00,14
100,251,351,61,7.5,1,Mostly Clear,22.1,2023-01-23 15:00:00,15
106,373,479,56,7.7,1,Mostly Clear,23.2,2023-01-23 16:00:00,16
141,527,668,53,7.4,3,Cloudy,23.3,2023-01-23 17:00:00,17
121,504,625,51,6.3,3,Cloudy,21.3,2023-01-23 18:00:00,18
73,353,426,52,5.2,3,Cloudy,19.8,2023-01-23 19:00:00,19
70,244,314,53,4.4,3,Cloudy,17.7,2023-01-23 20:00:00,20
35,150,185,55,3.9,2,Partly Cloudy,16.2,2023-01-23 21:00:00,21
29,86,115,57,3.3,2,Partly Cloudy,14.8,2023-01-23 22:00:00,22
15,39,54,60,2.7,0,Clear,12.6,2023-01-23 23:00:00,23
8,13,21,63,2.1,0,Clear,11.3,2023-01-24 00:00:00,0
1,3,4,67,1.4,2,Partly Cloudy,11.6,2023-01-24 01:00:00,1
0,4,4,71,0.8,0,Clear,10.1,2023-01-24 02:00:00,2
2,2,4,76,0.5,0,Clear,8.3,2023-01-24 03:00:00,3
3,9,12,80,-0.4,0,Clear,9.6,2023-01-24 04:00:00,4
14,64,78,82,-1.0,0,Clear,10.4,2023-01-24 05:00:00,5
28,158,186,83,-1.6,2,Partly Cloudy,10.9,2023-01-24 06:00:00,6
65,404,469,84,-2.0,2,Partly Cloudy,9.3,2023-01-24 07:00:00,7
151,689,840,83,-1.9,1,Mostly Clear,7.7,2023-01-24 08:00:00,8
73,321,394,83,-1.6,1,Mostly Clear,8.4,2023-01-24 09:00:00,9
58,173,231,73,1.7,0,Clear,8.2,2023-01-24 10:00:00,10
83,184,267,59,4.1,0,Clear,9.8,2023-01-24 11:00:00,11
92,262,354,52,5.6,0,Clear,12.0,2023-01-24 12:00:00,12
100,245,345,48,7.0,1,Mostly Clear,12.3,2023-01-24 13:00:00,13
103,210,313,45,8.2,1,Mostly Clear,13.0,2023-01-24 14:00:00,14
120,297,417,44,9.2,1,Mostly Clear,13.0,2023-01-24 15:00:00,15
158,507,665,43,9.5,1,Mostly Clear,12.0,2023-01-24 16:00:00,16
239,737,976,44,9.2,0,Clear,8.8,2023-01-24 17:00:00,17
184,623,807,51,8.1,0,Clear,5.4,2023-01-24 18:00:00,18
115,399,514,68,5.8,0,Clear,6.7,2023-01-24 19:00:00,19
72,277,349,70,4.2,0,Clear,6.3,2023-01-24 20:00:00,20
71,209,280,73,3.3,0,Clear,4.4,2023-01-24 21:00:00,21
34,122,156,68,4.2,1,Mostly Clear,6.6,2023-01-24 22:00:00,22
27,52,79,80,1.5,0,Clear,7.3,2023-01-24 23:00:00,23
7,22,29,88,-0.5,1,Mostly Clear,9.6,2023-01-25 00:00:00,0
0,10,10,88,-0.9,1,Mostly Clear,9.2,2023-01-25 01:00:00,1
4,4,8,88,-0.7,1,Mostly Clear,11.5,2023-01-25 02:00:00,2
3,8,11,86,0.2,1,Mostly Clear,11.3,2023-01-25 03:00:00,3
4,7,11,87,0.3,3,Cloudy,11.2,2023-01-25 04:00:00,4
11,45,56,85,0.9,3,Cloudy,10.1,2023-01-25 05:00:00,5
31,157,188,84,1.1,1,Mostly Clear,12.3,2023-01-25 06:00:00,6
79,349,428,83,1.4,2,Partly Cloudy,11.5,2023-01-25 07:00:00,7
143,614,757,83,1.6,2,Partly Cloudy,14.8,2023-01-25 08:00:00,8
91,382,473,85,1.7,3,Cloudy,11.5,2023-01-25 09:00:00,9
42,180,222,84,2.6,3,Cloudy,9.7,2023-01-25 10:00:00,10
40,158,198,81,3.5,3,Cloudy,13.0,2023-01-25 11:00:00,11
21,127,148,84,4.4,51,Light Drizzle,16.9,2023-01-25 12:00:00,12
14,49,63,87,4.7,71,Light Snow,13.7,2023-01-25 13:00:00,13
8,49,57,92,5.0,53,Heavy Drizzle,15.5,2023-01-25 14:00:00,14
22,103,125,94,4.4,63,Rain,15.8,2023-01-25 15:00:00,15
29,138,167,94,4.9,63,Rain,19.4,2023-01-25 16:00:00,16
64,275,339,95,5.9,61,Light Rain,20.3,2023-01-25 17:00:00,17
55,264,319,97,7.4,61,Light Rain,12.5,2023-01-25 18:00:00,18
54,234,288,98,9.1,63,Rain,10.2,2023-01-25 19:00:00,19
35,166,201,98,10.5,51,Light Drizzle,11.4,2023-01-25 20:00:00,20
30,100,130,100,10.6,61,Light Rain,10.8,2023-01-25 21:00:00,21
42,86,128,100,9.7,55,Heavy Drizzle,8.5,2023-01-25 22:00:00,22
18,52,70,100,8.8,53,Heavy Drizzle,8.6,2023-01-25 23:00:00,23
12,21,33,100,8.2,55,Heavy Drizzle,11.2,2023-01-26 00:00:00,0
3,10,13,99,7.4,61,Light Rain,13.4,2023-01-26 01:00:00,1
4,4,8,98,6.8,55,Heavy Drizzle,13.1,2023-01-26 02:00:00,2
3,3,6,97,6.7,3,Cloudy,13.4,2023-01-26 03:00:00,3
3,5,8,93,6.4,2,Partly Cloudy,15.8,2023-01-26 04:00:00,4
20,58,78,88,5.5,1,Mostly Clear,18.2,2023-01-26 05:00:00,5
36,136,172,84,4.4,0,Clear,18.1,2023-01-26 06:00:00,6
66,355,421,81,3.6,0,Clear,15.8,2023-01-26 07:00:00,7
141,601,742,80,3.0,0,Clear,13.8,2023-01-26 08:00:00,8
98,349,447,79,2.8,0,Clear,15.3,2023-01-26 09:00:00,9
69,224,293,75,4.2,0,Clear,14.9,2023-01-26 10:00:00,10
85,217,302,64,6.1,0,Clear,20.2,2023-01-26 11:00:00,11
81,233,314,51,7.5,3,Cloudy,26.0,2023-01-26 12:00:00,12
89,224,313,46,8.2,2,Partly Cloudy,25.6,2023-01-26 13:00:00,13
97,230,327,44,8.5,2,Partly Cloudy,22.8,2023-01-26 14:00:00,14
99,284,383,44,8.9,51,Light Drizzle,23.8,2023-01-26 15:00:00,15
147,429,576,43,8.9,2,Partly Cloudy,23.8,2023-01-26 16:00:00,16
189,708,897,43,8.6,0,Clear,18.7,2023-01-26 17:00:00,17
174,567,741,45,7.6,2,Partly Cloudy,13.7,2023-01-26 18:00:00,18
117,404,521,48,6.3,1,Mostly Clear,13.5,2023-01-26 19:00:00,19
79,269,348,51,5.1,0,Clear,10.9,2023-01-26 20:00:00,20
81,220,301,54,4.2,0,Clear,9.1,2023-01-26 21:00:00,21
65,120,185,55,3.6,0,Clear,8.4,2023-01-26 22:00:00,22
32,85,117,57,3.1,0,Clear,8.7,2023-01-26 23:00:00,23
27,51,78,60,2.4,0,Clear,9.4,2023-01-27 00:00:00,0
6,11,17,64,1.7,0,Clear,10.1,2023-01-27 01:00:00,1
3,12,15,68,1.1,0,Clear,10.8,2023-01-27 02:00:00,2
2,7,9,68,1.0,0,Clear,11.5,2023-01-27 03:00:00,3
0,13,13,70,0.6,0,Clear,11.4,2023-01-27 04:00:00,4
10,49,59,73,-0.0,0,Clear,10.7,2023-01-27 05:00:00,5
21,116,137,78,-0.9,0,Clear,8.3,2023-01-27 06:00:00,6
60,291,351,81,-1.7,0,Clear,7.6,2023-01-27 07:00:00,7
93,412,505,79,-1.8,0,Clear,7.2,2023-01-27 08:00:00,8
75,270,345,76,-0.9,0,Clear,7.9,2023-01-27 09:00:00,9
67,202,269,71,1.6,0,Clear,8.4,2023-01-27 10:00:00,10
80,222,302,55,3.6,0,Clear,15.3,2023-01-27 11:00:00,11
100,260,360,44,4.7,1,Mostly Clear,15.4,2023-01-27 12:00:00,12
103,286,389,42,5.1,3,Cloudy,15.1,2023-01-27 13:00:00,13
141,291,432,41,5.5,3,Cloudy,14.1,2023-01-27 14:00:00,14
155,310,465,37,6.0,3,Cloudy,13.6,2023-01-27 15:00:00,15
154,405,559,36,6.0,3,Cloudy,12.8,2023-01-27 16:00:00,16
176,549,725,35,6.0,2,Partly Cloudy,11.4,2023-01-27 17:00:00,17
138,399,537,40,5.2,0,Clear,6.0,2023-01-27 18:00:00,18
121,332,453,47,3.4,0,Clear,8.5,2023-01-27 19:00:00,19
79,197,276,53,2.2,0,Clear,8.5,2023-01-27 20:00:00,20
50,164,214,56,1.4,0,Clear,7.6,2023-01-27 21:00:00,21
44,106,150,58,0.9,0,Clear,8.6,2023-01-27 22:00:00,22
48,106,154,59,0.7,0,Clear,10.4,2023-01-27 23:00:00,23
40,75,115,59,0.6,0,Clear,11.4,2023-01-28 00:00:00,0
51,50,101,59,0.5,0,Clear,12.5,2023-01-28 01:00:00,1
29,33,62,58,0.8,0,Clear,13.7,2023-01-28 02:00:00,2
7,11,18,56,1.2,0,Clear,14.8,2023-01-28 03:00:00,3
2,11,13,55,1.2,0,Clear,14.5,2023-01-28 04:00:00,4
5,12,17,56,1.2,0,Clear,13.8,2023-01-28 05:00:00,5
15,27,42,58,1.1,0,Clear,12.3,2023-01-28 06:00:00,6
39,71,110,59,1.0,0,Clear,12.9,2023-01-28 07:00:00,7
67,159,226,62,0.8,0,Clear,12.2,2023-01-28 08:00:00,8
95,276,371,65,1.1,0,Clear,12.5,2023-01-28 09:00:00,9
163,316,479,63,3.3,0,Clear,12.3,2023-01-28 10:00:00,10
260,407,667,55,6.3,0,Clear,12.0,2023-01-28 11:00:00,11
333,436,769,51,8.5,0,Clear,11.2,2023-01-28 12:00:00,12
358,442,800,48,10.5,1,Mostly Clear,10.9,2023-01-28 13:00:00,13
401,425,826,44,11.7,2,Partly Cloudy,12.0,2023-01-28 14:00:00,14
424,430,854,43,12.6,2,Partly Cloudy,12.6,2023-01-28 15:00:00,15
399,439,838,42,12.8,1,Mostly Clear,12.1,2023-01-28 16:00:00,16
293,373,666,46,12.2,1,Mostly Clear,7.9,2023-01-28 17:00:00,17
163,310,473,52,10.9,0,Clear,8.0,2023-01-28 18:00:00,18
130,259,389,59,8.6,0,Clear,9.0,2023-01-28 19:00:00,19
104,192,296,63,7.2,0,Clear,8.6,2023-01-28 20:00:00,20
92,133,225,67,6.2,0,Clear,8.4,2023-01-28 21:00:00,21
67,116,183,71,5.3,0,Clear,8.7,2023-01-28 22:00:00,22
74,98,172,74,4.6,0,Clear,9.4,2023-01-28 23:00:00,23
81,101,182,77,4.1,1,Mostly Clear,9.9,2023-01-29 00:00:00,0
54,74,128,78,4.0,1,Mostly Clear,11.4,2023-01-29 01:00:00,1
33,28,61,79,3.9,1,Mostly Clear,12.0,2023-01-29 02:00:00,2
13,13,26,75,3.8,1,Mostly Clear,12.1,2023-01-29 03:00:00,3
5,10,15,75,3.7,1,Mostly Clear,12.0,2023-01-29 04:00:00,4
5,13,18,77,3.4,1,Mostly Clear,11.8,2023-01-29 05:00:00,5
15,18,33,78,3.1,2,Partly Cloudy,11.5,2023-01-29 06:00:00,6
16,59,75,76,3.4,3,Cloudy,10.8,2023-01-29 07:00:00,7
33,109,142,74,4.0,1,Mostly Clear,11.7,2023-01-29 08:00:00,8
117,191,308,73,4.6,2,Partly Cloudy,11.3,2023-01-29 09:00:00,9
160,259,419,71,5.4,2,Partly Cloudy,11.9,2023-01-29 10:00:00,10
164,312,476,68,6.7,3,Cloudy,15.2,2023-01-29 11:00:00,11
80,209,289,65,7.6,3,Cloudy,14.6,2023-01-29 12:00:00,12
95,226,321,67,7.6,51,Light Drizzle,15.3,2023-01-29 13:00:00,13
68,194,262,71,8.0,51,Light Drizzle,15.0,2023-01-29 14:00:00,14
86,208,294,81,8.0,51,Light Drizzle,13.8,2023-01-29 15:00:00,15
86,250,336,89,7.6,53,Heavy Drizzle,13.8,2023-01-29 16:00:00,16
124,234,358,93,7.4,51,Light Drizzle,12.2,2023-01-29 17:00:00,17
78,248,326,95,7.3,51,Light Drizzle,9.1,2023-01-29 18:00:00,18
65,156,221,96,7.0,2,Partly Cloudy,8.9,2023-01-29 19:00:00,19
44,140,184,97,6.7,2,Partly Cloudy,8.1,2023-01-29 20:00:00,20
26,78,104,98,6.3,2,Partly Cloudy,6.6,2023-01-29 21:00:00,21
40,87,127,98,6.3,2,Partly Cloudy,7.4,2023-01-29 22:00:00,22
25,40,65,98,6.0,2,Partly Cloudy,8.2,2023-01-29 23:00:00,23
15,10,25,98,5.8,1,Mostly Clear,6.6,2023-01-30 00:00:00,0
6,17,23,99,5.4,1,Mostly Clear,6.6,2023-01-30 01:00:00,1
0,2,2,99,4.9,2,Partly Cloudy,6.5,2023-01-30 02:00:00,2
4,5,9,99,4.9,3,Cloudy,2.8,2023-01-30 03:00:00,3
3,7,10,100,4.1,3,Cloudy,4.4,2023-01-30 04:00:00,4
12,48,60,99,4.3,3,Cloudy,1.1,2023-01-30 05:00:00,5
33,156,189,99,4.3,3,Cloudy,1.6,2023-01-30 06:00:00,6
53,296,349,99,3.9,3,Cloudy,4.1,2023-01-30 07:00:00,7
124,521,645,99,3.9,3,Cloudy,5.2,2023-01-30 08:00:00,8
73,297,370,99,4.1,2,Partly Cloudy,0.7,2023-01-30 09:00:00,9
51,161,212,97,6.0,2,Partly Cloudy,3.1,2023-01-30 10:00:00,10
82,217,299,95,7.8,1,Mostly Clear,3.1,2023-01-30 11:00:00,11
88,236,324,89,9.2,1,Mostly Clear,4.6,2023-01-30 12:00:00,12
112,241,353,79,11.0,0,Clear,5.4,2023-01-30 13:00:00,13
135,232,367,71,12.7,0,Clear,5.1,2023-01-30 14:00:00,14
187,360,547,62,13.7,0,Clear,4.7,2023-01-30 15:00:00,15
184,474,658,59,14.2,2,Partly Cloudy,4.6,2023-01-30 16:00:00,16
240,729,969,61,13.9,3,Cloudy,5.7,2023-01-30 17:00:00,17
196,582,778,68,12.5,2,Partly Cloudy,6.2,2023-01-30 18:00:00,18
151,455,606,78,10.2,0,Clear,7.0,2023-01-30 19:00:00,19
79,301,380,86,9.0,1,Mostly Clear,9.0,2023-01-30 20:00:00,20
66,208,274,90,8.3,1,Mostly Clear,9.0,2023-01-30 21:00:00,21
55,120,175,92,7.9,1,Mostly Clear,9.4,2023-01-30 22:00:00,22
22,40,62,94,7.6,0,Clear,9.3,2023-01-30 23:00:00,23
14,17,31,94,7.7,1,Mostly Clear,10.0,2023-01-31 00:00:00,0
3,4,7,95,7.8,1,Mostly Clear,10.1,2023-01-31 01:00:00,1
4,10,14,96,7.6,2,Partly Cloudy,9.5,2023-01-31 02:00:00,2
2,5,7,97,7.4,2,Partly Cloudy,7.3,2023-01-31 03:00:00,3
5,9,14,97,7.2,2,Partly Cloudy,10.2,2023-01-31 04:00:00,4
11,65,76,93,7.0,3,Cloudy,13.7,2023-01-31 05:00:00,5
35,159,194,84,6.9,51,Light Drizzle,9.9,2023-01-31 06:00:00,6
82,337,419,78,6.7,3,Cloudy,8.7,2023-01-31 07:00:00,7
63,294,357,74,6.4,3,Cloudy,11.7,2023-01-31 08:00:00,8
32,173,205,74,5.8,51,Light Drizzle,11.5,2023-01-31 09:00:00,9
30,107,137,81,4.9,53,Heavy Drizzle,10.1,2023-01-31 10:00:00,10
27,90,117,88,4.1,53,Heavy Drizzle,9.3,2023-01-31 11:00:00,11
31,121,152,88,3.9,53,Heavy Drizzle,8.8,2023-01-31 12:00:00,12
21,111,132,88,3.8,53,Heavy Drizzle,7.4,2023-01-31 13:00:00,13
33,107,140,90,3.5,53,Heavy Drizzle,6.1,2023-01-31 14:00:00,14
53,198,251,92,4.1,53,Heavy Drizzle,6.9,2023-01-31 15:00:00,15
60,281,341,92,3.8,51,Light Drizzle,6.5,2023-01-31 16:00:00,16
112,491,603,89,3.6,3,Cloudy,7.4,2023-01-31 17:00:00,17
93,421,514,89,3.5,3,Cloudy,6.3,2023-01-31 18:00:00,18
75,290,365,89,3.3,3,Cloudy,4.8,2023-01-31 19:00:00,19
55,234,289,88,3.3,3,Cloudy,5.1,2023-01-31 20:00:00,20
39,154,193,92,3.1,51,Light Drizzle,6.9,2023-01-31 21:00:00,21
38,124,162,93,2.9,51,Light Drizzle,6.1,2023-01-31 22:00:00,22
23,53,76,94,2.7,51,Light Drizzle,5.5,2023-01-31 23:00:00,23
6,22,28,93,2.7,3,Cloudy,4.9,2023-02-01 00:00:00,0
0,8,8,94,2.6,51,Light Drizzle,5.2,2023-02-01 01:00:00,1
2,2,4,94,2.4,71,Light Snow,6.2,2023-02-01 02:00:00,2
4,6,10,95,1.8,71,Light Snow,7.0,2023-02-01 03:00:00,3
3,10,13,96,1.4,73,Snow,8.4,2023-02-01 04:00:00,4
12,47,59,95,1.1,73,Snow,7.9,2023-02-01 05:00:00,5
22,133,155,93,0.8,73,Snow,7.6,2023-02-01 06:00:00,6
65,329,394,91,0.7,73,Snow,7.8,2023-02-01 07:00:00,7
87,548,635,87,0.4,71,Light Snow,8.0,2023-02-01 08:00:00,8
80,345,425,84,0.6,71,Light Snow,8.7,2023-02-01 09:00:00,9
58,188,246,77,0.8,1,Mostly Clear,11.6,2023-02-01 10:00:00,10
70,193,263,57,1.4,0,Clear,13.1,2023-02-01 11:00:00,11
49,259,308,45,2.4,1,Mostly Clear,12.5,2023-02-01 12:00:00,12
73,260,333,38,3.4,1,Mostly Clear,12.1,2023-02-01 13:00:00,13
82,232,314,36,3.8,0,Clear,11.6,2023-02-01 14:00:00,14
111,329,440,34,4.0,1,Mostly Clear,11.0,2023-02-01 15:00:00,15
125,405,530,34,4.0,0,Clear,10.2,2023-02-01 16:00:00,16
203,632,835,33,3.8,0,Clear,9.7,2023-02-01 17:00:00,17
145,512,657,35,3.1,0,Clear,6.1,2023-02-01 18:00:00,18
95,355,450,48,1.7,0,Clear,5.7,2023-02-01 19:00:00,19
65,244,309,58,0.1,0,Clear,6.2,2023-02-01 20:00:00,20
53,181,234,57,-0.7,1,Mostly Clear,5.6,2023-02-01 21:00:00,21
37,125,162,49,0.3,1,Mostly Clear,4.2,2023-02-01 22:00:00,22
30,44,74,53,0.1,1,Mostly Clear,3.3,2023-02-01 23:00:00,23
11,16,27,58,-0.2,1,Mostly Clear,5.4,2023-02-02 00:00:00,0
2,14,16,62,-0.4,1,Mostly Clear,4.0,2023-02-02 01:00:00,1
4,3,7,63,-0.5,1,Mostly Clear,6.3,2023-02-02 02:00:00,2
3,5,8,71,-1.6,1,Mostly Clear,6.5,2023-02-02 03:00:00,3
3,8,11,62,-0.6,1,Mostly Clear,6.4,2023-02-02 04:00:00,4
13,47,60,60,-0.4,2,Partly Cloudy,4.7,2023-02-02 05:00:00,5
21,125,146,61,-0.4,2,Partly Cloudy,4.0,2023-02-02 06:00:00,6
53,321,374,60,-0.3,3,Cloudy,4.3,2023-02-02 07:00:00,7
130,581,711,61,-0.3,3,Cloudy,3.6,2023-02-02 08:00:00,8
85,314,399,63,-0.1,1,Mostly Clear,4.6,2023-02-02 09:00:00,9
53,172,225,59,1.1,1,Mostly Clear,2.8,2023-02-02 10:00:00,10
63,203,266,48,3.1,1,Mostly Clear,2.1,2023-02-02 11:00:00,11
79,252,331,48,4.0,1,Mostly Clear,3.6,2023-02-02 12:00:00,12
76,244,320,51,5.0,1,Mostly Clear,6.3,2023-02-02 13:00:00,13
78,220,298,52,5.8,1,Mostly Clear,6.8,2023-02-02 14:00:00,14
95,300,395,48,5.2,1,Mostly Clear,8.1,2023-02-02 15:00:00,15
117,385,502,49,5.4,1,Mostly Clear,9.2,2023-02-02 16:00:00,16
150,610,760,52,5.1,1,Mostly Clear,9.3,2023-02-02 17:00:00,17
145,519,664,58,4.3,1,Mostly Clear,7.6,2023-02-02 18:00:00,18
96,350,446,63,3.5,1,Mostly Clear,7.9,2023-02-02 19:00:00,19
68,249,317,68,2.8,1,Mostly Clear,10.1,2023-02-02 20:00:00,20
53,195,248,72,2.5,1,Mostly Clear,10.5,2023-02-02 21:00:00,21
47,113,160,77,2.2,1,Mostly Clear,11.4,2023-02-02 22:00:00,22
32,66,98,83,2.0,1,Mostly Clear,10.7,2023-02-02 23:00:00,23
23,35,58,84,1.7,1,Mostly Clear,10.5,2023-02-03 00:00:00,0
13,25,38,73,1.5,1,Mostly Clear,10.2,2023-02-03 01:00:00,1
2,4,6,49,1.8,1,Mostly Clear,11.5,2023-02-03 02:00:00,2
6,5,11,63,1.9,1,Mostly Clear,14.1,2023-02-03 03:00:00,3
0,9,9,48,1.9,1,Mostly Clear,15.6,2023-02-03 04:00:00,4
11,37,48,47,1.8,1,Mostly Clear,15.4,2023-02-03 05:00:00,5
23,114,137,50,1.4,3,Cloudy,9.7,2023-02-03 06:00:00,6
34,235,269,55,0.9,3,Cloudy,12.3,2023-02-03 07:00:00,7
79,366,445,57,0.5,3,Cloudy,17.6,2023-02-03 08:00:00,8
56,225,281,49,-0.3,2,Partly Cloudy,22.7,2023-02-03 09:00:00,9
39,174,213,36,-1.0,0,Clear,24.2,2023-02-03 10:00:00,10
48,172,220,32,-1.1,0,Clear,25.7,2023-02-03 11:00:00,11
60,194,254,31,-0.9,1,Mostly Clear,26.2,2023-02-03 12:00:00,12
58,242,300,28,-0.4,1,Mostly Clear,26.0,2023-02-03 13:00:00,13
70,175,245,27,-0.1,0,Clear,26.3,2023-02-03 14:00:00,14
71,228,299,27,-0.5,0,Clear,27.6,2023-02-03 15:00:00,15
83,292,375,26,-0.6,1,Mostly Clear,29.1,2023-02-03 16:00:00,16
92,345,437,24,-1.1,0,Clear,27.8,2023-02-03 17:00:00,17
57,272,329,23,-2.0,0,Clear,23.7,2023-02-03 18:00:00,18
58,210,268,23,-2.9,0,Clear,23.2,2023-02-03 19:00:00,19
27,102,129,23,-3.7,0,Clear,24.8,2023-02-03 20:00:00,20
16,92,108,24,-4.4,0,Clear,25.2,2023-02-03 21:00:00,21
20,74,94,24,-5.1,0,Clear,24.4,2023-02-03 22:00:00,22
19,68,87,24,-5.6,0,Clear,23.4,2023-02-03 23:00:00,23
19,41,60,23,-6.1,0,Clear,22.4,2023-02-04 00:00:00,0
8,26,34,24,-6.4,0,Clear,21.7,2023-02-04 01:00:00,1
8,11,19,24,-6.6,0,Clear,20.0,2023-02-04 02:00:00,2
1,4,5,26,-7.1,0,Clear,18.2,2023-02-04 03:00:00,3
4,5,9,27,-7.3,0,Clear,16.3,2023-02-04 04:00:00,4
6,10,16,28,-7.4,0,Clear,14.8,2023-02-04 05:00:00,5
10,25,35,29,-7.5,1,Mostly Clear,9.4,2023-02-04 06:00:00,6
14,44,58,30,-7.4,1,Mostly Clear,10.5,2023-02-04 07:00:00,7
35,78,113,30,-7.4,0,Clear,8.1,2023-02-04 08:00:00,8
46,154,200,31,-7.3,0,Clear,6.0,2023-02-04 09:00:00,9
55,193,248,30,-6.3,0,Clear,5.4,2023-02-04 10:00:00,10
99,209,308,28,-5.0,0,Clear,2.2,2023-02-04 11:00:00,11
114,208,322,26,-3.5,0,Clear,4.0,2023-02-04 12:00:00,12
119,207,326,24,-2.0,0,Clear,7.3,2023-02-04 13:00:00,13
109,236,345,23,-0.8,0,Clear,9.9,2023-02-04 14:00:00,14
121,244,365,28,-0.5,0,Clear,12.1,2023-02-04 15:00:00,15
77,262,339,30,0.0,0,Clear,13.7,2023-02-04 16:00:00,16
73,242,315,28,0.2,0,Clear,14.6,2023-02-04 17:00:00,17
68,166,234,29,-0.5,0,Clear,8.3,2023-02-04 18:00:00,18
50,116,166,34,-1.8,0,Clear,9.2,2023-02-04 19:00:00,19
41,90,131,37,-2.1,0,Clear,12.2,2023-02-04 20:00:00,20
33,88,121,39,-2.1,0,Clear,14.5,2023-02-04 21:00:00,21
40,90,130,40,-2.0,0,Clear,15.5,2023-02-04 22:00:00,22
27,89,116,40,-1.8,1,Mostly Clear,15.6,2023-02-04 23:00:00,23
26,67,93,42,-1.5,1,Mostly Clear,16.2,2023-02-05 00:00:00,0
20,44,64,44,-1.3,1,Mostly Clear,16.7,2023-02-05 01:00:00,1
21,30,51,47,-1.1,1,Mostly Clear,16.6,2023-02-05 02:00:00,2
8,19,27,45,-1.0,1,Mostly Clear,16.1,2023-02-05 03:00:00,3
1,3,4,47,-0.8,1,Mostly Clear,15.4,2023-02-05 04:00:00,4
5,9,14,49,-0.6,1,Mostly Clear,14.6,2023-02-05 05:00:00,5
10,25,35,51,-0.5,2,Partly Cloudy,12.8,2023-02-05 06:00:00,6
9,51,60,54,-0.7,0,Clear,13.6,2023-02-05 07:00:00,7
31,96,127,57,-0.8,0,Clear,13.5,2023-02-05 08:00:00,8
77,175,252,58,-0.4,1,Mostly Clear,13.2,2023-02-05 09:00:00,9
112,262,374,55,1.7,1,Mostly Clear,12.3,2023-02-05 10:00:00,10
135,319,454,50,3.6,1,Mostly Clear,13.7,2023-02-05 11:00:00,11
163,345,508,49,5.1,1,Mostly Clear,13.7,2023-02-05 12:00:00,12
216,395,611,46,6.9,1,Mostly Clear,13.7,2023-02-05 13:00:00,13
254,380,634,43,8.3,1,Mostly Clear,14.2,2023-02-05 14:00:00,14
313,379,692,45,9.4,1,Mostly Clear,13.8,2023-02-05 15:00:00,15
240,389,629,47,9.6,1,Mostly Clear,14.2,2023-02-05 16:00:00,16
200,380,580,48,9.2,1,Mostly Clear,15.4,2023-02-05 17:00:00,17
126,254,380,48,8.4,2,Partly Cloudy,12.9,2023-02-05 18:00:00,18
73,193,266,50,7.3,2,Partly Cloudy,12.7,2023-02-05 19:00:00,19
78,140,218,53,7.1,2,Partly Cloudy,13.0,2023-02-05 20:00:00,20
66,99,165,56,7.2,3,Cloudy,14.6,2023-02-05 21:00:00,21
37,76,113,61,6.9,3,Cloudy,15.5,2023-02-05 22:00:00,22
23,38,61,65,6.7,2,Partly Cloudy,15.1,2023-02-05 23:00:00,23
12,14,26,69,6.3,0,Clear,14.2,2023-02-06 00:00:00,0
0,8,8,74,5.6,1,Mostly Clear,12.8,2023-02-06 01:00:00,1
0,2,2,76,5.4,1,Mostly Clear,12.5,2023-02-06 02:00:00,2
4,3,7,77,5.5,1,Mostly Clear,12.4,2023-02-06 03:00:00,3
4,11,15,75,5.3,2,Partly Cloudy,13.7,2023-02-06 04:00:00,4
11,53,64,72,4.9,0,Clear,15.3,2023-02-06 05:00:00,5
37,146,183,69,4.9,0,Clear,15.4,2023-02-06 06:00:00,6
62,351,413,72,4.8,0,Clear,16.0,2023-02-06 07:00:00,7
112,566,678,76,4.6,0,Clear,13.0,2023-02-06 08:00:00,8
86,332,418,78,4.9,0,Clear,11.5,2023-02-06 09:00:00,9
61,170,231,75,6.7,0,Clear,11.1,2023-02-06 10:00:00,10
69,194,263,68,8.4,0,Clear,13.0,2023-02-06 11:00:00,11
84,250,334,61,9.7,1,Mostly Clear,20.0,2023-02-06 12:00:00,12
78,221,299,58,10.3,2,Partly Cloudy,20.8,2023-02-06 13:00:00,13
72,223,295,56,10.4,2,Partly Cloudy,20.6,2023-02-06 14:00:00,14
110,263,373,53,11.1,3,Cloudy,20.4,2023-02-06 15:00:00,15
119,377,496,51,10.1,3,Cloudy,21.4,2023-02-06 16:00:00,16
168,587,755,52,9.3,3,Cloudy,18.6,2023-02-06 17:00:00,17
127,515,642,54,8.4,3,Cloudy,12.2,2023-02-06 18:00:00,18
96,367,463,58,6.8,3,Cloudy,10.9,2023-02-06 19:00:00,19
69,251,320,63,5.5,2,Partly Cloudy,9.9,2023-02-06 20:00:00,20
48,165,213,67,4.2,1,Mostly Clear,9.4,2023-02-06 21:00:00,21
38,100,138,73,3.1,0,Clear,8.7,2023-02-06 22:00:00,22
17,58,75,78,1.9,0,Clear,7.2,2023-02-06 23:00:00,23
6,14,20,85,0.6,0,Clear,6.3,2023-02-07 00:00:00,0
5,6,11,88,-0.5,1,Mostly Clear,6.3,2023-02-07 01:00:00,1
1,4,5,88,-1.2,0,Clear,6.2,2023-02-07 02:00:00,2
1,2,3,90,-1.4,1,Mostly Clear,6.0,2023-02-07 03:00:00,3
2,7,9,90,-1.3,1,Mostly Clear,6.2,2023-02-07 04:00:00,4
21,62,83,88,-0.7,1,Mostly Clear,6.3,2023-02-07 05:00:00,5
21,149,170,87,-0.2,1,Mostly Clear,5.7,2023-02-07 06:00:00,6
77,388,465,89,-0.6,1,Mostly Clear,5.4,2023-02-07 07:00:00,7
149,677,826,89,-1.0,1,Mostly Clear,4.7,2023-02-07 08:00:00,8
88,361,449,89,-0.4,1,Mostly Clear,6.1,2023-02-07 09:00:00,9
48,173,221,81,2.0,1,Mostly Clear,5.5,2023-02-07 10:00:00,10
71,216,287,71,4.0,1,Mostly Clear,7.7,2023-02-07 11:00:00,11
66,231,297,65,5.8,1,Mostly Clear,9.6,2023-02-07 12:00:00,12
88,262,350,61,7.4,1,Mostly Clear,11.9,2023-02-07 13:00:00,13
97,238,335,58,8.7,1,Mostly Clear,12.3,2023-02-07 14:00:00,14
101,305,406,58,8.9,1,Mostly Clear,13.4,2023-02-07 15:00:00,15
132,462,594,57,9.4,1,Mostly Clear,14.1,2023-02-07 16:00:00,16
214,681,895,57,9.7,1,Mostly Clear,11.6,2023-02-07 17:00:00,17
179,577,756,61,8.9,2,Partly Cloudy,6.9,2023-02-07 18:00:00,18
108,457,565,65,7.8,2,Partly Cloudy,8.4,2023-02-07 19:00:00,19
100,289,389,67,7.6,3,Cloudy,8.9,2023-02-07 20:00:00,20
68,180,248,68,7.8,3,Cloudy,9.7,2023-02-07 21:00:00,21
51,130,181,68,8.2,3,Cloudy,11.8,2023-02-07 22:00:00,22
38,88,126,68,8.6,2,Partly Cloudy,12.6,2023-02-07 23:00:00,23
13,28,41,70,8.6,2,Partly Cloudy,12.0,2023-02-08 00:00:00,0
5,11,16,70,8.8,2,Partly Cloudy,9.1,2023-02-08 01:00:00,1
2,9,11,72,8.5,2,Partly Cloudy,7.2,2023-02-08 02:00:00,2
6,1,7,76,7.0,2,Partly Cloudy,7.9,2023-02-08 03:00:00,3
2,12,14,79,6.3,2,Partly Cloudy,8.9,2023-02-08 04:00:00,4
16,49,65,79,6.1,2,Partly Cloudy,9.1,2023-02-08 05:00:00,5
33,161,194,78,6.2,1,Mostly Clear,8.1,2023-02-08 06:00:00,6
80,435,515,79,5.9,1,Mostly Clear,8.0,2023-02-08 07:00:00,7
160,694,854,81,5.9,2,Partly Cloudy,8.4,2023-02-08 08:00:00,8
114,411,525,85,6.4,2,Partly Cloudy,7.6,2023-02-08 09:00:00,9
80,234,314,81,9.5,1,Mostly Clear,8.5,2023-02-08 10:00:00,10
101,244,345,71,12.3,0,Clear,7.9,2023-02-08 11:00:00,11
117,320,437,63,13.0,0,Clear,12.4,2023-02-08 12:00:00,12
140,309,449,58,13.5,0,Clear,13.3,2023-02-08 13:00:00,13
156,312,468,53,13.9,0,Clear,14.0,2023-02-08 14:00:00,14
181,393,574,44,16.9,1,Mostly Clear,12.3,2023-02-08 15:00:00,15
226,554,780,43,16.7,1,Mostly Clear,9.9,2023-02-08 16:00:00,16
334,796,1130,47,16.0,1,Mostly Clear,7.1,2023-02-08 17:00:00,17
242,731,973,54,14.4,1,Mostly Clear,5.5,2023-02-08 18:00:00,18
222,499,721,61,12.0,0,Clear,6.4,2023-02-08 19:00:00,19
105,343,448,69,9.8,0,Clear,7.2,2023-02-08 20:00:00,20
102,290,392,74,8.2,1,Mostly Clear,8.3,2023-02-08 21:00:00,21
77,140,217,78,6.8,1,Mostly Clear,8.8,2023-02-08 22:00:00,22
37,67,104,82,5.9,1,Mostly Clear,8.6,2023-02-08 23:00:00,23
19,39,58,84,5.3,1,Mostly Clear,8.8,2023-02-09 00:00:00,0
2,15,17,86,4.6,0,Clear,9.4,2023-02-09 01:00:00,1
4,10,14,86,4.4,0,Clear,9.1,2023-02-09 02:00:00,2
5,2,7,83,3.9,1,Mostly Clear,9.3,2023-02-09 03:00:00,3
2,9,11,85,4.5,2,Partly Cloudy,10.2,2023-02-09 04:00:00,4
14,61,75,86,5.4,3,Cloudy,9.3,2023-02-09 05:00:00,5
30,149,179,89,5.6,3,Cloudy,8.4,2023-02-09 06:00:00,6
88,409,497,88,6.0,3,Cloudy,9.3,2023-02-09 07:00:00,7
182,673,855,88,6.1,3,Cloudy,10.3,2023-02-09 08:00:00,8
113,417,530,86,7.0,3,Cloudy,11.5,2023-02-09 09:00:00,9
72,230,302,82,9.2,3,Cloudy,11.9,2023-02-09 10:00:00,10
81,252,333,74,11.7,3,Cloudy,11.7,2023-02-09 11:00:00,11
127,290,417,70,13.7,3,Cloudy,13.3,2023-02-09 12:00:00,12
118,282,400,68,15.7,2,Partly Cloudy,14.1,2023-02-09 13:00:00,13
124,266,390,67,16.8,3,Cloudy,14.8,2023-02-09 14:00:00,14
173,349,522,64,17.3,1,Mostly Clear,16.4,2023-02-09 15:00:00,15
229,525,754,65,17.7,2,Partly Cloudy,16.9,2023-02-09 16:00:00,16
284,814,1098,63,18.0,1,Mostly Clear,21.2,2023-02-09 17:00:00,17
241,637,878,63,17.7,1,Mostly Clear,18.4,2023-02-09 18:00:00,18
185,502,687,65,17.2,2,Partly Cloudy,17.3,2023-02-09 19:00:00,19
111,332,443,66,17.1,3,Cloudy,18.0,2023-02-09 20:00:00,20
134,276,410,69,17.0,1,Mostly Clear,18.2,2023-02-09 21:00:00,21
93,174,267,72,16.9,1,Mostly Clear,19.6,2023-02-09 22:00:00,22
74,86,160,73,16.8,1,Mostly Clear,20.7,2023-02-09 23:00:00,23
41,67,108,74,16.7,1,Mostly Clear,20.8,2023-02-10 00:00:00,0
26,28,54,75,16.6,1,Mostly Clear,21.3,2023-02-10 01:00:00,1
2,13,15,76,16.3,1,Mostly Clear,20.6,2023-02-10 02:00:00,2
4,8,12,77,16.4,1,Mostly Clear,19.1,2023-02-10 03:00:00,3
2,5,7,80,15.8,1,Mostly Clear,16.5,2023-02-10 04:00:00,4
13,41,54,85,14.7,0,Clear,13.3,2023-02-10 05:00:00,5
45,150,195,89,13.5,0,Clear,9.7,2023-02-10 06:00:00,6
67,338,405,81,12.3,0,Clear,10.7,2023-02-10 07:00:00,7
152,523,675,67,11.1,0,Clear,13.2,2023-02-10 08:00:00,8
124,356,480,62,10.6,0,Clear,16.3,2023-02-10 09:00:00,9
135,231,366,55,10.9,0,Clear,17.0,2023-02-10 10:00:00,10
142,268,410,52,11.3,0,Clear,19.4,2023-02-10 11:00:00,11
213,366,579,49,12.0,0,Clear,18.3,2023-02-10 12:00:00,12
175,365,540,47,12.8,0,Clear,17.0,2023-02-10 13:00:00,13
207,344,551,46,13.5,1,Mostly Clear,16.6,2023-02-10 14:00:00,14
255,434,689,44,14.9,0,Clear,17.3,2023-02-10 15:00:00,15
273,534,807,44,14.7,0,Clear,18.2,2023-02-10 16:00:00,16
305,696,1001,44,14.0,0,Clear,17.0,2023-02-10 17:00:00,17
249,488,737,46,12.8,0,Clear,13.5,2023-02-10 18:00:00,18
188,383,571,49,11.3,1,Mostly Clear,14.0,2023-02-10 19:00:00,19
121,225,346,52,10.0,0,Clear,14.0,2023-02-10 20:00:00,20
88,149,237,54,9.0,1,Mostly Clear,15.3,2023-02-10 21:00:00,21
51,129,180,56,8.2,1,Mostly Clear,15.0,2023-02-10 22:00:00,22
66,124,190,58,7.6,1,Mostly Clear,15.0,2023-02-10 23:00:00,23
52,108,160,58,7.3,1,Mostly Clear,16.4,2023-02-11 00:00:00,0
34,63,97,59,6.7,1,Mostly Clear,18.7,2023-02-11 01:00:00,1
18,34,52,59,6.1,1,Mostly Clear,19.5,2023-02-11 02:00:00,2
14,26,40,55,6.5,0,Clear,19.4,2023-02-11 03:00:00,3
3,4,7,54,5.7,0,Clear,18.2,2023-02-11 04:00:00,4
3,18,21,54,5.0,0,Clear,16.1,2023-02-11 05:00:00,5
14,38,52,56,4.4,1,Mostly Clear,12.1,2023-02-11 06:00:00,6
24,74,98,57,3.9,1,Mostly Clear,11.7,2023-02-11 07:00:00,7
58,178,236,58,3.3,1,Mostly Clear,10.5,2023-02-11 08:00:00,8
124,273,397,60,3.2,1,Mostly Clear,10.4,2023-02-11 09:00:00,9
183,306,489,51,3.9,0,Clear,13.4,2023-02-11 10:00:00,10
215,370,585,48,4.7,0,Clear,12.4,2023-02-11 11:00:00,11
287,400,687,45,5.8,1,Mostly Clear,10.3,2023-02-11 12:00:00,12
317,397,714,43,6.9,1,Mostly Clear,8.0,2023-02-11 13:00:00,13
393,465,858,41,7.9,0,Clear,6.8,2023-02-11 14:00:00,14
352,406,758,41,9.0,1,Mostly Clear,5.1,2023-02-11 15:00:00,15
346,392,738,40,9.2,1,Mostly Clear,4.7,2023-02-11 16:00:00,16
244,367,611,39,9.0,1,Mostly Clear,4.9,2023-02-11 17:00:00,17
160,327,487,40,8.4,1,Mostly Clear,2.3,2023-02-11 18:00:00,18
126,239,365,57,7.1,1,Mostly Clear,4.1,2023-02-11 19:00:00,19
97,174,271,62,5.6,1,Mostly Clear,4.4,2023-02-11 20:00:00,20
83,137,220,63,4.8,1,Mostly Clear,5.8,2023-02-11 21:00:00,21
54,114,168,66,4.2,1,Mostly Clear,4.6,2023-02-11 22:00:00,22
63,97,160,70,3.8,1,Mostly Clear,5.9,2023-02-11 23:00:00,23
55,81,136,70,3.5,1,Mostly Clear,7.1,2023-02-12 00:00:00,0
44,67,111,71,3.4,1,Mostly Clear,6.6,2023-02-12 01:00:00,1
36,63,99,72,3.2,1,Mostly Clear,4.1,2023-02-12 02:00:00,2
11,23,34,70,2.9,2,Partly Cloudy,7.0,2023-02-12 03:00:00,3
3,8,11,75,2.8,2,Partly Cloudy,3.9,2023-02-12 04:00:00,4
10,12,22,77,2.7,3,Cloudy,4.9,2023-02-12 05:00:00,5
8,26,34,79,2.7,2,Partly Cloudy,3.2,2023-02-12 06:00:00,6
13,52,65,79,2.9,3,Cloudy,4.2,2023-02-12 07:00:00,7
21,69,90,81,2.9,3,Cloudy,2.3,2023-02-12 08:00:00,8
32,96,128,77,3.4,3,Cloudy,5.6,2023-02-12 09:00:00,9
57,173,230,73,4.1,3,Cloudy,6.4,2023-02-12 10:00:00,10
40,118,158,68,4.6,51,Light Drizzle,6.9,2023-02-12 11:00:00,11
46,139,185,69,4.6,51,Light Drizzle,8.0,2023-02-12 12:00:00,12
39,100,139,73,4.8,51,Light Drizzle,11.5,2023-02-12 13:00:00,13
33,94,127,76,4.8,51,Light Drizzle,12.2,2023-02-12 14:00:00,14
18,49,67,90,3.9,61,Light Rain,12.5,2023-02-12 15:00:00,15
22,98,120,89,4.2,61,Light Rain,15.1,2023-02-12 16:00:00,16
33,115,148,92,3.8,61,Light Rain,16.7,2023-02-12 17:00:00,17
33,84,117,91,3.6,61,Light Rain,15.1,2023-02-12 18:00:00,18
14,38,52,92,3.5,61,Light Rain,13.8,2023-02-12 19:00:00,19
12,25,37,92,3.5,61,Light Rain,17.2,2023-02-12 20:00:00,20
10,35,45,92,3.5,61,Light Rain,19.1,2023-02-12 21:00:00,21
42,100,142,92,3.5,61,Light Rain,19.7,2023-02-12 22:00:00,22
24,48,72,92,3.5,55,Heavy Drizzle,19.1,2023-02-12 23:00:00,23
7,17,24,92,3.6,61,Light Rain,17.6,2023-02-13 00:00:00,0
3,10,13,92,3.5,53,Heavy Drizzle,17.3,2023-02-13 01:00:00,1
0,5,5,92,3.3,53,Heavy Drizzle,17.7,2023-02-13 02:00:00,2
2,6,8,90,3.3,51,Light Drizzle,19.1,2023-02-13 03:00:00,3
1,10,11,88,3.2,51,Light Drizzle,18.8,2023-02-13 04:00:00,4
14,49,63,81,3.2,2,Partly Cloudy,18.2,2023-02-13 05:00:00,5
26,129,155,74,3.4,1,Mostly Clear,16.9,2023-02-13 06:00:00,6
56,323,379,68,3.3,0,Clear,14.8,2023-02-13 07:00:00,7
125,544,669,65,3.1,0,Clear,13.8,2023-02-13 08:00:00,8
116,341,457,63,3.7,0,Clear,13.8,2023-02-13 09:00:00,9
82,216,298,58,6.1,0,Clear,14.2,2023-02-13 10:00:00,10
95,237,332,46,8.8,1,Mostly Clear,13.9,2023-02-13 11:00:00,11
136,256,392,39,10.7,0,Clear,12.6,2023-02-13 12:00:00,12
127,250,377,34,12.3,0,Clear,13.2,2023-02-13 13:00:00,13
111,255,366,31,13.5,0,Clear,12.7,2023-02-13 14:00:00,14
135,341,476,28,14.0,2,Partly Cloudy,15.2,2023-02-13 15:00:00,15
162,444,606,27,14.0,3,Cloudy,15.9,2023-02-13 16:00:00,16
214,677,891,32,13.1,2,Partly Cloudy,12.4,2023-02-13 17:00:00,17
178,597,775,36,11.8,0,Clear,12.7,2023-02-13 18:00:00,18
111,398,509,40,9.8,0,Clear,13.8,2023-02-13 19:00:00,19
65,243,308,42,8.7,0,Clear,14.5,2023-02-13 20:00:00,20
60,226,286,44,7.9,0,Clear,14.0,2023-02-13 21:00:00,21
33,107,140,45,7.2,0,Clear,12.6,2023-02-13 22:00:00,22
51,77,128,48,6.5,0,Clear,11.7,2023-02-13 23:00:00,23
3,15,18,53,5.8,0,Clear,12.1,2023-02-14 00:00:00,0
4,5,9,59,4.9,0,Clear,11.7,2023-02-14 01:00:00,1
1,5,6,64,4.0,0,Clear,10.5,2023-02-14 02:00:00,2
0,3,3,64,3.4,0,Clear,9.5,2023-02-14 03:00:00,3
4,8,12,68,2.4,0,Clear,8.4,2023-02-14 04:00:00,4
22,56,78,71,1.7,0,Clear,8.2,2023-02-14 05:00:00,5
32,163,195,74,1.2,0,Clear,7.6,2023-02-14 06:00:00,6
88,433,521,77,0.5,0,Clear,8.3,2023-02-14 07:00:00,7
181,696,877,79,0.2,0,Clear,9.7,2023-02-14 08:00:00,8
107,444,551,77,1.9,0,Clear,5.7,2023-02-14 09:00:00,9
78,220,298,66,6.2,1,Mostly Clear,4.7,2023-02-14 10:00:00,10
98,220,318,55,8.6,1,Mostly Clear,6.2,2023-02-14 11:00:00,11
125,311,436,49,10.0,0,Clear,5.9,2023-02-14 12:00:00,12
126,309,435,46,11.2,0,Clear,5.0,2023-02-14 13:00:00,13
176,319,495,43,12.2,1,Mostly Clear,5.8,2023-02-14 14:00:00,14
181,389,570,38,14.2,0,Clear,6.6,2023-02-14 15:00:00,15
227,534,761,36,14.6,0,Clear,7.5,2023-02-14 16:00:00,16
323,893,1216,37,14.4,0,Clear,7.1,2023-02-14 17:00:00,17
250,651,901,43,13.1,1,Mostly Clear,5.2,2023-02-14 18:00:00,18
145,402,547,50,10.8,1,Mostly Clear,9.0,2023-02-14 19:00:00,19
74,274,348,55,9.4,1,Mostly Clear,9.8,2023-02-14 20:00:00,20
77,166,243,59,8.3,1,Mostly Clear,12.0,2023-02-14 21:00:00,21
56,157,213,60,7.9,1,Mostly Clear,11.9,2023-02-14 22:00:00,22
66,101,167,61,7.7,2,Partly Cloudy,12.5,2023-02-14 23:00:00,23
20,35,55,60,7.8,3,Cloudy,12.9,2023-02-15 00:00:00,0
2,18,20,60,7.9,3,Cloudy,13.4,2023-02-15 01:00:00,1
3,5,8,62,8.1,2,Partly Cloudy,14.1,2023-02-15 02:00:00,2
6,7,13,60,8.6,2,Partly Cloudy,13.8,2023-02-15 03:00:00,3
6,12,18,60,8.7,3,Cloudy,15.3,2023-02-15 04:00:00,4
24,59,83,59,8.7,2,Partly Cloudy,16.7,2023-02-15 05:00:00,5
30,194,224,60,8.4,3,Cloudy,13.9,2023-02-15 06:00:00,6
88,331,419,61,8.5,3,Cloudy,13.0,2023-02-15 07:00:00,7
170,627,797,70,7.8,53,Heavy Drizzle,14.1,2023-02-15 08:00:00,8
119,393,512,79,7.5,53,Heavy Drizzle,15.7,2023-02-15 09:00:00,9
76,213,289,82,8.2,53,Heavy Drizzle,17.7,2023-02-15 10:00:00,10
100,233,333,81,9.9,1,Mostly Clear,15.5,2023-02-15 11:00:00,11
118,341,459,70,12.4,1,Mostly Clear,19.2,2023-02-15 12:00:00,12
127,295,422,61,14.9,1,Mostly Clear,20.3,2023-02-15 13:00:00,13
141,316,457,56,16.6,0,Clear,20.8,2023-02-15 14:00:00,14
190,358,548,50,18.6,0,Clear,20.8,2023-02-15 15:00:00,15
210,534,744,49,19.1,0,Clear,20.0,2023-02-15 16:00:00,16
312,861,1173,51,18.8,0,Clear,18.4,2023-02-15 17:00:00,17
236,660,896,53,17.7,1,Mostly Clear,16.8,2023-02-15 18:00:00,18
168,475,643,53,16.8,1,Mostly Clear,17.1,2023-02-15 19:00:00,19
111,368,479,54,16.3,1,Mostly Clear,19.0,2023-02-15 20:00:00,20
109,243,352,55,15.7,1,Mostly Clear,19.5,2023-02-15 21:00:00,21
69,174,243,58,15.2,0,Clear,18.9,2023-02-15 22:00:00,22
45,96,141,62,14.3,1,Mostly Clear,18.1,2023-02-15 23:00:00,23
23,32,55,68,13.3,1,Mostly Clear,15.5,2023-02-16 00:00:00,0
8,16,24,74,12.3,0,Clear,13.8,2023-02-16 01:00:00,1
6,5,11,79,11.4,1,Mostly Clear,12.2,2023-02-16 02:00:00,2
4,4,8,82,11.6,1,Mostly Clear,10.3,2023-02-16 03:00:00,3
4,11,15,88,10.2,1,Mostly Clear,8.7,2023-02-16 04:00:00,4
26,61,87,91,9.1,0,Clear,8.3,2023-02-16 05:00:00,5
36,151,187,94,8.3,1,Mostly Clear,6.9,2023-02-16 06:00:00,6
90,384,474,95,7.9,1,Mostly Clear,7.7,2023-02-16 07:00:00,7
169,665,834,96,7.7,1,Mostly Clear,9.5,2023-02-16 08:00:00,8
140,399,539,95,8.7,2,Partly Cloudy,10.0,2023-02-16 09:00:00,9
90,236,326,88,11.9,2,Partly Cloudy,5.4,2023-02-16 10:00:00,10
90,225,315,84,13.3,3,Cloudy,4.8,2023-02-16 11:00:00,11
32,91,123,82,14.1,51,Light Drizzle,5.8,2023-02-16 12:00:00,12
32,106,138,84,14.5,53,Heavy Drizzle,4.8,2023-02-16 13:00:00,13
33,99,132,87,15.3,61,Light Rain,2.5,2023-02-16 14:00:00,14
68,253,321,92,15.0,61,Light Rain,4.5,2023-02-16 15:00:00,15
109,374,483,93,15.2,61,Light Rain,5.4,2023-02-16 16:00:00,16
161,570,731,94,15.0,55,Heavy Drizzle,8.7,2023-02-16 17:00:00,17
159,469,628,94,15.6,51,Light Drizzle,3.6,2023-02-16 18:00:00,18
108,394,502,96,14.9,3,Cloudy,3.6,2023-02-16 19:00:00,19
85,292,377,97,14.6,3,Cloudy,3.4,2023-02-16 20:00:00,20
81,219,300,95,14.7,2,Partly Cloudy,5.5,2023-02-16 21:00:00,21
72,125,197,93,15.0,3,Cloudy,5.3,2023-02-16 22:00:00,22
48,84,132,90,15.5,51,Light Drizzle,7.6,2023-02-16 23:00:00,23
19,58,77,88,15.6,51,Light Drizzle,9.0,2023-02-17 00:00:00,0
25,19,44,86,15.5,51,Light Drizzle,13.0,2023-02-17 01:00:00,1
11,8,19,86,15.5,3,Cloudy,16.1,2023-02-17 02:00:00,2
7,11,18,90,14.7,3,Cloudy,20.3,2023-02-17 03:00:00,3
1,8,9,89,14.9,51,Light Drizzle,21.2,2023-02-17 04:00:00,4
3,19,22,91,14.9,51,Light Drizzle,20.8,2023-02-17 05:00:00,5
9,54,63,93,15.1,53,Heavy Drizzle,14.8,2023-02-17 06:00:00,6
11,75,86,94,15.4,61,Light Rain,11.1,2023-02-17 07:00:00,7
43,138,181,95,15.6,61,Light Rain,14.2,2023-02-17 08:00:00,8
42,150,192,96,15.5,63,Rain,15.5,2023-02-17 09:00:00,9
57,141,198,96,15.5,63,Rain,16.3,2023-02-17 10:00:00,10
54,179,233,96,15.8,53,Heavy Drizzle,17.9,2023-02-17 11:00:00,11
90,197,287,96,15.6,53,Heavy Drizzle,22.1,2023-02-17 12:00:00,12
79,231,310,87,11.5,53,Heavy Drizzle,24.0,2023-02-17 13:00:00,13
105,271,376,77,9.7,3,Cloudy,19.4,2023-02-17 14:00:00,14
130,300,430,63,11.7,3,Cloudy,23.4,2023-02-17 15:00:00,15
121,350,471,52,10.4,3,Cloudy,26.5,2023-02-17 16:00:00,16
176,435,611,46,8.5,51,Light Drizzle,26.2,2023-02-17 17:00:00,17
129,323,452,43,7.1,1,Mostly Clear,26.6,2023-02-17 18:00:00,18
71,247,318,42,5.9,3,Cloudy,26.6,2023-02-17 19:00:00,19
66,155,221,43,4.6,3,Cloudy,26.0,2023-02-17 20:00:00,20
43,110,153,43,3.6,2,Partly Cloudy,23.4,2023-02-17 21:00:00,21
35,86,121,43,2.8,1,Mostly Clear,22.9,2023-02-17 22:00:00,22
52,82,134,43,2.1,1,Mostly Clear,22.1,2023-02-17 23:00:00,23
29,54,83,44,1.5,0,Clear,21.1,2023-02-18 00:00:00,0
24,44,68,43,1.0,1,Mostly Clear,20.9,2023-02-18 01:00:00,1
27,23,50,42,0.4,0,Clear,20.6,2023-02-18 02:00:00,2
8,5,13,42,-0.3,0,Clear,19.6,2023-02-18 03:00:00,3
4,12,16,42,-0.7,0,Clear,17.6,2023-02-18 04:00:00,4
10,13,23,42,-1.1,0,Clear,15.3,2023-02-18 05:00:00,5
13,29,42,42,-1.4,0,Clear,6.9,2023-02-18 06:00:00,6
35,89,124,43,-1.7,0,Clear,7.3,2023-02-18 07:00:00,7
44,125,169,49,-2.0,0,Clear,8.5,2023-02-18 08:00:00,8
89,221,310,51,-1.4,0,Clear,11.6,2023-02-18 09:00:00,9
136,259,395,42,0.4,0,Clear,11.3,2023-02-18 10:00:00,10
198,294,492,40,1.9,0,Clear,10.4,2023-02-18 11:00:00,11
269,315,584,38,3.6,0,Clear,10.1,2023-02-18 12:00:00,12
277,329,606,36,5.2,0,Clear,10.5,2023-02-18 13:00:00,13
335,348,683,35,6.6,0,Clear,10.4,2023-02-18 14:00:00,14
312,350,662,37,6.7,0,Clear,9.8,2023-02-18 15:00:00,15
323,351,674,36,7.5,0,Clear,9.8,2023-02-18 16:00:00,16
262,331,593,35,7.8,0,Clear,9.7,2023-02-18 17:00:00,17
127,241,368,38,7.3,0,Clear,8.1,2023-02-18 18:00:00,18
108,210,318,44,5.7,0,Clear,8.0,2023-02-18 19:00:00,19
71,154,225,49,4.5,0,Clear,8.8,2023-02-18 20:00:00,20
75,122,197,53,3.7,0,Clear,9.0,2023-02-18 21:00:00,21
53,123,176,58,2.9,0,Clear,8.6,2023-02-18 22:00:00,22
42,93,135,64,2.2,1,Mostly Clear,7.5,2023-02-18 23:00:00,23
49,92,141,70,1.5,1,Mostly Clear,6.8,2023-02-19 00:00:00,0
43,50,93,72,1.4,1,Mostly Clear,7.6,2023-02-19 01:00:00,1
21,35,56,72,1.7,1,Mostly Clear,8.5,2023-02-19 02:00:00,2
15,18,33,71,1.7,1,Mostly Clear,7.8,2023-02-19 03:00:00,3
3,12,15,71,1.7,1,Mostly Clear,8.0,2023-02-19 04:00:00,4
6,9,15,71,1.8,1,Mostly Clear,7.9,2023-02-19 05:00:00,5
6,29,35,71,1.9,1,Mostly Clear,7.9,2023-02-19 06:00:00,6
17,47,64,70,2.1,2,Partly Cloudy,9.4,2023-02-19 07:00:00,7
45,100,145,71,2.2,3,Cloudy,10.1,2023-02-19 08:00:00,8
146,175,321,69,3.2,3,Cloudy,12.6,2023-02-19 09:00:00,9
215,272,487,63,5.2,2,Partly Cloudy,12.6,2023-02-19 10:00:00,10
295,273,568,56,7.2,1,Mostly Clear,15.2,2023-02-19 11:00:00,11
344,351,695,51,9.4,1,Mostly Clear,15.7,2023-02-19 12:00:00,12
410,383,793,46,11.0,1,Mostly Clear,16.8,2023-02-19 13:00:00,13
527,362,889,44,11.9,0,Clear,17.8,2023-02-19 14:00:00,14
504,412,916,38,13.9,0,Clear,18.8,2023-02-19 15:00:00,15
477,410,887,36,14.5,0,Clear,19.5,2023-02-19 16:00:00,16
448,373,821,38,14.2,0,Clear,18.0,2023-02-19 17:00:00,17
255,307,562,40,13.3,0,Clear,13.3,2023-02-19 18:00:00,18
151,217,368,45,12.1,0,Clear,14.4,2023-02-19 19:00:00,19
94,144,238,52,11.7,0,Clear,17.4,2023-02-19 20:00:00,20
66,154,220,61,11.7,0,Clear,19.6,2023-02-19 21:00:00,21
75,138,213,67,11.5,0,Clear,20.3,2023-02-19 22:00:00,22
54,89,143,72,11.0,1,Mostly Clear,19.5,2023-02-19 23:00:00,23
39,53,92,76,10.4,1,Mostly Clear,17.8,2023-02-20 00:00:00,0
13,20,33,79,9.8,1,Mostly Clear,15.3,2023-02-20 01:00:00,1
6,13,19,82,9.3,1,Mostly Clear,13.3,2023-02-20 02:00:00,2
6,7,13,81,9.0,1,Mostly Clear,12.3,2023-02-20 03:00:00,3
1,8,9,84,8.5,1,Mostly Clear,11.7,2023-02-20 04:00:00,4
13,20,33,85,8.1,1,Mostly Clear,11.2,2023-02-20 05:00:00,5
18,61,79,85,8.0,1,Mostly Clear,10.0,2023-02-20 06:00:00,6
41,112,153,85,8.0,2,Partly Cloudy,9.7,2023-02-20 07:00:00,7
65,201,266,84,8.0,2,Partly Cloudy,9.4,2023-02-20 08:00:00,8
102,238,340,82,8.4,1,Mostly Clear,9.9,2023-02-20 09:00:00,9
176,259,435,77,9.4,1,Mostly Clear,11.0,2023-02-20 10:00:00,10
219,343,562,68,11.3,1,Mostly Clear,11.5,2023-02-20 11:00:00,11
270,311,581,62,12.7,1,Mostly Clear,11.1,2023-02-20 12:00:00,12
271,378,649,55,14.1,1,Mostly Clear,13.0,2023-02-20 13:00:00,13
324,370,694,51,14.5,1,Mostly Clear,13.1,2023-02-20 14:00:00,14
304,397,701,47,15.8,2,Partly Cloudy,14.0,2023-02-20 15:00:00,15
299,402,701,48,15.9,2,Partly Cloudy,11.1,2023-02-20 16:00:00,16
263,435,698,53,15.4,2,Partly Cloudy,9.7,2023-02-20 17:00:00,17
172,385,557,57,14.6,2,Partly Cloudy,9.1,2023-02-20 18:00:00,18
125,271,396,64,12.6,0,Clear,8.8,2023-02-20 19:00:00,19
87,174,261,68,11.4,0,Clear,9.2,2023-02-20 20:00:00,20
44,141,185,71,10.8,0,Clear,8.7,2023-02-20 21:00:00,21
40,88,128,75,10.2,0,Clear,8.2,2023-02-20 22:00:00,22
23,42,65,78,9.7,1,Mostly Clear,9.2,2023-02-20 23:00:00,23
10,15,25,81,9.2,1,Mostly Clear,10.7,2023-02-21 00:00:00,0
8,8,16,82,8.9,2,Partly Cloudy,10.3,2023-02-21 01:00:00,1
1,3,4,83,9.0,1,Mostly Clear,6.9,2023-02-21 02:00:00,2
2,3,5,88,8.9,53,Heavy Drizzle,7.2,2023-02-21 03:00:00,3
5,12,17,92,8.9,51,Light Drizzle,9.5,2023-02-21 04:00:00,4
17,48,65,94,8.5,1,Mostly Clear,10.2,2023-02-21 05:00:00,5
40,170,210,94,7.6,2,Partly Cloudy,6.2,2023-02-21 06:00:00,6
82,377,459,92,7.4,0,Clear,2.5,2023-02-21 07:00:00,7
165,637,802,97,5.9,0,Clear,3.1,2023-02-21 08:00:00,8
121,305,426,98,6.6,1,Mostly Clear,3.1,2023-02-21 09:00:00,9
113,199,312,89,9.3,0,Clear,2.3,2023-02-21 10:00:00,10
119,217,336,79,11.6,0,Clear,2.5,2023-02-21 11:00:00,11
143,277,420,67,14.0,1,Mostly Clear,6.9,2023-02-21 12:00:00,12
155,258,413,58,15.4,51,Light Drizzle,10.5,2023-02-21 13:00:00,13
162,261,423,59,14.7,53,Heavy Drizzle,17.3,2023-02-21 14:00:00,14
167,353,520,41,16.3,51,Light Drizzle,25.1,2023-02-21 15:00:00,15
231,485,716,42,15.6,2,Partly Cloudy,19.3,2023-02-21 16:00:00,16
318,832,1150,43,15.6,0,Clear,16.4,2023-02-21 17:00:00,17
239,640,879,42,14.9,1,Mostly Clear,15.1,2023-02-21 18:00:00,18
137,412,549,41,13.6,1,Mostly Clear,12.7,2023-02-21 19:00:00,19
101,280,381,43,12.4,0,Clear,11.9,2023-02-21 20:00:00,20
103,246,349,45,11.0,0,Clear,11.2,2023-02-21 21:00:00,21
72,129,201,46,9.5,0,Clear,10.0,2023-02-21 22:00:00,22
31,65,96,49,7.9,0,Clear,7.2,2023-02-21 23:00:00,23
9,21,30,56,6.1,0,Clear,8.2,2023-02-22 00:00:00,0
4,8,12,59,4.8,0,Clear,7.7,2023-02-22 01:00:00,1
6,5,11,60,4.1,0,Clear,7.9,2023-02-22 02:00:00,2
2,3,5,59,4.3,0,Clear,7.3,2023-02-22 03:00:00,3
2,12,14,60,4.0,0,Clear,7.6,2023-02-22 04:00:00,4
22,67,89,64,3.3,0,Clear,6.9,2023-02-22 05:00:00,5
36,182,218,66,2.6,2,Partly Cloudy,8.4,2023-02-22 06:00:00,6
84,385,469,64,3.1,3,Cloudy,8.6,2023-02-22 07:00:00,7
128,629,757,68,3.8,0,Clear,9.8,2023-02-22 08:00:00,8
46,210,256,72,5.2,3,Cloudy,8.4,2023-02-22 09:00:00,9
43,186,229,56,7.7,3,Cloudy,4.7,2023-02-22 10:00:00,10
70,223,293,62,7.6,51,Light Drizzle,5.7,2023-02-22 11:00:00,11
91,256,347,65,7.8,51,Light Drizzle,7.6,2023-02-22 12:00:00,12
95,280,375,56,9.4,3,Cloudy,10.9,2023-02-22 13:00:00,13
113,251,364,48,11.2,2,Partly Cloudy,12.7,2023-02-22 14:00:00,14
137,318,455,62,10.4,2,Partly Cloudy,12.3,2023-02-22 15:00:00,15
173,400,573,57,11.2,3,Cloudy,12.6,2023-02-22 16:00:00,16
245,709,954,58,11.2,3,Cloudy,13.1,2023-02-22 17:00:00,17
226,602,828,61,10.9,3,Cloudy,9.1,2023-02-22 18:00:00,18
152,427,579,65,10.2,2,Partly Cloudy,9.9,2023-02-22 19:00:00,19
98,318,416,68,9.8,2,Partly Cloudy,9.0,2023-02-22 20:00:00,20
75,241,316,71,9.6,2,Partly Cloudy,9.4,2023-02-22 21:00:00,21
73,125,198,76,9.3,1,Mostly Clear,7.6,2023-02-22 22:00:00,22
36,76,112,83,8.8,0,Clear,8.0,2023-02-22 23:00:00,23
7,35,42,88,8.8,0,Clear,8.1,2023-02-23 00:00:00,0
5,12,17,91,10.3,2,Partly Cloudy,7.1,2023-02-23 01:00:00,1
2,5,7,92,13.1,51,Light Drizzle,7.2,2023-02-23 02:00:00,2
4,15,19,85,9.0,51,Light Drizzle,8.6,2023-02-23 03:00:00,3
1,12,13,92,11.0,2,Partly Cloudy,12.6,2023-02-23 04:00:00,4
17,45,62,93,13.4,3,Cloudy,17.3,2023-02-23 05:00:00,5
35,157,192,92,15.0,3,Cloudy,6.9,2023-02-23 06:00:00,6
94,393,487,91,15.9,3,Cloudy,6.8,2023-02-23 07:00:00,7
194,693,887,91,16.0,3,Cloudy,8.4,2023-02-23 08:00:00,8
123,371,494,91,16.4,3,Cloudy,8.0,2023-02-23 09:00:00,9
127,234,361,89,16.7,3,Cloudy,7.1,2023-02-23 10:00:00,10
158,289,447,86,17.8,3,Cloudy,6.8,2023-02-23 11:00:00,11
200,301,501,82,18.4,1,Mostly Clear,7.6,2023-02-23 12:00:00,12
210,342,552,71,20.3,0,Clear,9.5,2023-02-23 13:00:00,13
267,374,641,56,22.3,0,Clear,12.3,2023-02-23 14:00:00,14
334,473,807,52,23.6,0,Clear,11.9,2023-02-23 15:00:00,15
417,609,1026,48,24.1,0,Clear,9.8,2023-02-23 16:00:00,16
621,1017,1638,51,23.7,0,Clear,5.6,2023-02-23 17:00:00,17
396,761,1157,56,22.4,0,Clear,4.7,2023-02-23 18:00:00,18
235,479,714,67,19.4,0,Clear,10.1,2023-02-23 19:00:00,19
181,351,532,72,17.8,0,Clear,8.3,2023-02-23 20:00:00,20
197,321,518,75,16.8,0,Clear,9.3,2023-02-23 21:00:00,21
140,208,348,74,16.1,0,Clear,11.6,2023-02-23 22:00:00,22
54,111,165,71,15.8,0,Clear,9.5,2023-02-23 23:00:00,23
46,51,97,69,15.7,0,Clear,12.8,2023-02-24 00:00:00,0
25,22,47,68,15.4,0,Clear,14.5,2023-02-24 01:00:00,1
9,15,24,68,15.0,0,Clear,14.6,2023-02-24 02:00:00,2
11,8,19,61,14.6,0,Clear,14.9,2023-02-24 03:00:00,3
5,14,19,58,14.9,0,Clear,17.2,2023-02-24 04:00:00,4
15,41,56,60,15.4,0,Clear,18.4,2023-02-24 05:00:00,5
42,152,194,61,14.9,0,Clear,19.4,2023-02-24 06:00:00,6
87,297,384,52,13.5,0,Clear,18.8,2023-02-24 07:00:00,7
146,427,573,47,11.7,0,Clear,16.6,2023-02-24 08:00:00,8
121,313,434,45,10.2,0,Clear,19.6,2023-02-24 09:00:00,9
113,231,344,43,9.1,0,Clear,21.9,2023-02-24 10:00:00,10
155,252,407,42,8.9,0,Clear,22.2,2023-02-24 11:00:00,11
172,319,491,41,9.3,0,Clear,22.2,2023-02-24 12:00:00,12
209,301,510,38,9.9,0,Clear,22.2,2023-02-24 13:00:00,13
222,315,537,36,10.4,0,Clear,22.0,2023-02-24 14:00:00,14
197,372,569,36,11.5,0,Clear,22.2,2023-02-24 15:00:00,15
222,420,642,34,11.3,0,Clear,21.6,2023-02-24 16:00:00,16
274,581,855,33,10.5,1,Mostly Clear,20.7,2023-02-24 17:00:00,17
191,488,679,33,9.6,1,Mostly Clear,13.5,2023-02-24 18:00:00,18
129,354,483,33,8.6,1,Mostly Clear,11.5,2023-02-24 19:00:00,19
75,227,302,34,7.5,0,Clear,11.4,2023-02-24 20:00:00,20
84,147,231,35,6.3,0,Clear,11.3,2023-02-24 21:00:00,21
73,131,204,37,5.2,1,Mostly Clear,10.9,2023-02-24 22:00:00,22
46,121,167,38,4.3,1,Mostly Clear,10.1,2023-02-24 23:00:00,23
32,93,125,40,3.6,1,Mostly Clear,9.4,2023-02-25 00:00:00,0
28,76,104,41,2.9,1,Mostly Clear,8.8,2023-02-25 01:00:00,1
28,24,52,44,2.2,0,Clear,8.2,2023-02-25 02:00:00,2
8,21,29,52,2.0,1,Mostly Clear,8.1,2023-02-25 03:00:00,3
6,7,13,54,1.4,0,Clear,8.9,2023-02-25 04:00:00,4
5,12,17,58,0.8,0,Clear,8.3,2023-02-25 05:00:00,5
18,24,42,68,0.1,0,Clear,5.1,2023-02-25 06:00:00,6
21,73,94,70,-0.4,0,Clear,6.5,2023-02-25 07:00:00,7
46,174,220,75,-0.7,0,Clear,5.5,2023-02-25 08:00:00,8
90,231,321,66,1.6,0,Clear,10.4,2023-02-25 09:00:00,9
138,265,403,57,3.4,0,Clear,12.1,2023-02-25 10:00:00,10
93,238,331,55,4.9,3,Cloudy,12.6,2023-02-25 11:00:00,11
62,170,232,59,5.2,3,Cloudy,9.4,2023-02-25 12:00:00,12
83,178,261,64,5.5,71,Light Snow,10.7,2023-02-25 13:00:00,13
75,174,249,73,4.8,71,Light Snow,10.9,2023-02-25 14:00:00,14
110,247,357,81,3.6,71,Light Snow,9.2,2023-02-25 15:00:00,15
142,234,376,89,3.2,71,Light Snow,9.5,2023-02-25 16:00:00,16
119,287,406,88,3.1,51,Light Drizzle,9.6,2023-02-25 17:00:00,17
103,252,355,89,3.0,3,Cloudy,7.6,2023-02-25 18:00:00,18
79,225,304,89,3.0,3,Cloudy,5.1,2023-02-25 19:00:00,19
62,129,191,89,3.1,3,Cloudy,3.5,2023-02-25 20:00:00,20
74,100,174,89,3.1,3,Cloudy,2.2,2023-02-25 21:00:00,21
60,139,199,90,3.1,3,Cloudy,2.4,2023-02-25 22:00:00,22
60,141,201,90,3.1,3,Cloudy,3.4,2023-02-25 23:00:00,23
53,95,148,91,3.0,3,Cloudy,3.3,2023-02-26 00:00:00,0
42,55,97,91,3.1,3,Cloudy,3.6,2023-02-26 01:00:00,1
39,42,81,94,2.6,3,Cloudy,4.7,2023-02-26 02:00:00,2
10,25,35,88,2.4,3,Cloudy,6.3,2023-02-26 03:00:00,3
7,3,10,89,2.4,3,Cloudy,8.4,2023-02-26 04:00:00,4
6,8,14,90,2.5,3,Cloudy,9.7,2023-02-26 05:00:00,5
9,26,35,92,2.4,3,Cloudy,6.4,2023-02-26 06:00:00,6
16,55,71,92,2.7,3,Cloudy,7.6,2023-02-26 07:00:00,7
37,111,148,94,2.8,3,Cloudy,9.9,2023-02-26 08:00:00,8
104,227,331,92,3.4,3,Cloudy,11.0,2023-02-26 09:00:00,9
166,285,451,87,4.6,3,Cloudy,12.3,2023-02-26 10:00:00,10
201,366,567,81,6.1,3,Cloudy,13.2,2023-02-26 11:00:00,11
275,359,634,73,8.0,2,Partly Cloudy,13.3,2023-02-26 12:00:00,12
355,400,755,64,10.0,0,Clear,13.2,2023-02-26 13:00:00,13
340,366,706,57,11.7,0,Clear,13.2,2023-02-26 14:00:00,14
430,429,859,54,12.2,0,Clear,13.5,2023-02-26 15:00:00,15
379,471,850,48,13.5,0,Clear,14.8,2023-02-26 16:00:00,16
269,425,694,43,14.5,0,Clear,14.2,2023-02-26 17:00:00,17
165,314,479,46,13.8,0,Clear,8.7,2023-02-26 18:00:00,18
99,224,323,50,11.7,0,Clear,8.2,2023-02-26 19:00:00,19
53,159,212,51,10.0,0,Clear,8.4,2023-02-26 20:00:00,20
57,129,186,53,8.8,0,Clear,9.9,2023-02-26 21:00:00,21
46,102,148,59,7.5,0,Clear,11.7,2023-02-26 22:00:00,22
28,66,94,66,6.2,0,Clear,10.2,2023-02-26 23:00:00,23
12,17,29,71,5.0,0,Clear,8.9,2023-02-27 00:00:00,0
4,8,12,76,4.0,0,Clear,8.2,2023-02-27 01:00:00,1
3,7,10,80,3.1,0,Clear,8.2,2023-02-27 02:00:00,2
2,6,8,77,3.1,0,Clear,7.8,2023-02-27 03:00:00,3
2,12,14,79,2.6,0,Clear,7.7,2023-02-27 04:00:00,4
13,59,72,81,2.0,1,Mostly Clear,6.9,2023-02-27 05:00:00,5
39,170,209,83,1.5,1,Mostly Clear,6.6,2023-02-27 06:00:00,6
63,345,408,83,1.4,1,Mostly Clear,5.8,2023-02-27 07:00:00,7
112,532,644,83,1.1,1,Mostly Clear,5.6,2023-02-27 08:00:00,8
95,307,402,81,2.9,1,Mostly Clear,8.1,2023-02-27 09:00:00,9
59,183,242,61,6.0,1,Mostly Clear,9.5,2023-02-27 10:00:00,10
112,205,317,54,7.3,1,Mostly Clear,11.2,2023-02-27 11:00:00,11
104,224,328,51,8.5,1,Mostly Clear,12.1,2023-02-27 12:00:00,12
57,174,231,50,9.2,2,Partly Cloudy,12.3,2023-02-27 13:00:00,13
92,195,287,48,9.7,3,Cloudy,13.5,2023-02-27 14:00:00,14
118,299,417,73,8.2,61,Light Rain,12.3,2023-02-27 15:00:00,15
122,426,548,81,7.4,53,Heavy Drizzle,15.1,2023-02-27 16:00:00,16
81,374,455,74,7.7,3,Cloudy,16.8,2023-02-27 17:00:00,17
52,335,387,68,8.2,51,Light Drizzle,15.0,2023-02-27 18:00:00,18
42,197,239,72,7.3,55,Heavy Drizzle,14.6,2023-02-27 19:00:00,19
22,145,167,80,6.4,61,Light Rain,15.5,2023-02-27 20:00:00,20
31,119,150,90,5.6,55,Heavy Drizzle,15.2,2023-02-27 21:00:00,21
26,68,94,93,5.6,61,Light Rain,15.6,2023-02-27 22:00:00,22
11,23,34,95,5.8,61,Light Rain,16.5,2023-02-27 23:00:00,23
5,11,16,96,6.0,61,Light Rain,13.8,2023-02-28 00:00:00,0
1,5,6,97,6.2,61,Light Rain,9.4,2023-02-28 01:00:00,1
2,2,4,98,6.3,51,Light Drizzle,7.9,2023-02-28 02:00:00,2
3,6,9,97,5.1,51,Light Drizzle,6.7,2023-02-28 03:00:00,3
4,13,17,97,5.1,3,Cloudy,5.2,2023-02-28 04:00:00,4
16,55,71,98,5.0,3,Cloudy,6.9,2023-02-28 05:00:00,5
30,174,204,97,5.0,3,Cloudy,7.6,2023-02-28 06:00:00,6
94,398,492,97,5.0,3,Cloudy,7.1,2023-02-28 07:00:00,7
166,690,856,97,5.1,3,Cloudy,4.5,2023-02-28 08:00:00,8
88,360,448,96,5.5,3,Cloudy,3.9,2023-02-28 09:00:00,9
79,215,294,95,6.2,3,Cloudy,3.4,2023-02-28 10:00:00,10
79,227,306,92,7.4,3,Cloudy,2.4,2023-02-28 11:00:00,11
86,268,354,86,9.5,3,Cloudy,0.5,2023-02-28 12:00:00,12
127,264,391,74,12.0,3,Cloudy,2.5,2023-02-28 13:00:00,13
137,256,393,61,13.9,51,Light Drizzle,3.7,2023-02-28 14:00:00,14
188,352,540,71,12.8,3,Cloudy,11.3,2023-02-28 15:00:00,15
221,557,778,60,14.2,51,Light Drizzle,15.4,2023-02-28 16:00:00,16
363,853,1216,58,14.5,0,Clear,11.5,2023-02-28 17:00:00,17
222,705,927,60,13.8,0,Clear,7.9,2023-02-28 18:00:00,18
141,416,557,67,11.5,0,Clear,8.7,2023-02-28 19:00:00,19
112,306,418,72,9.7,0,Clear,10.4,2023-02-28 20:00:00,20
67,189,256,76,8.3,0,Clear,10.1,2023-02-28 21:00:00,21
58,153,211,79,7.0,0,Clear,8.6,2023-02-28 22:00:00,22
39,67,106,83,5.8,0,Clear,7.9,2023-02-28 23:00:00,23
13,24,37,86,4.7,0,Clear,8.5,2023-03-01 00:00:00,0
9,9,18,87,4.0,0,Clear,9.7,2023-03-01 01:00:00,1
0,4,4,87,3.5,0,Clear,10.0,2023-03-01 02:00:00,2
0,7,7,92,2.8,0,Clear,8.4,2023-03-01 03:00:00,3
3,8,11,90,3.1,0,Clear,8.2,2023-03-01 04:00:00,4
16,56,72,88,4.3,0,Clear,4.1,2023-03-01 05:00:00,5
37,173,210,91,4.0,0,Clear,2.3,2023-03-01 06:00:00,6
97,420,517,95,2.2,0,Clear,3.2,2023-03-01 07:00:00,7
199,688,887,97,1.4,0,Clear,4.4,2023-03-01 08:00:00,8
131,376,507,96,3.5,0,Clear,6.4,2023-03-01 09:00:00,9
95,209,304,80,7.6,2,Partly Cloudy,10.4,2023-03-01 10:00:00,10
80,265,345,68,9.2,2,Partly Cloudy,12.7,2023-03-01 11:00:00,11
126,271,397,60,10.7,2,Partly Cloudy,13.7,2023-03-01 12:00:00,12
113,281,394,54,11.9,0,Clear,14.4,2023-03-01 13:00:00,13
143,295,438,50,13.2,0,Clear,16.2,2023-03-01 14:00:00,14
141,363,504,53,13.5,1,Mostly Clear,17.6,2023-03-01 15:00:00,15
207,509,716,54,14.3,0,Clear,17.8,2023-03-01 16:00:00,16
336,831,1167,55,14.6,0,Clear,16.6,2023-03-01 17:00:00,17
242,670,912,59,14.0,0,Clear,10.3,2023-03-01 18:00:00,18
183,487,670,67,12.0,0,Clear,9.7,2023-03-01 19:00:00,19
93,299,392,76,10.5,0,Clear,11.0,2023-03-01 20:00:00,20
104,245,349,83,9.6,0,Clear,11.2,2023-03-01 21:00:00,21
74,173,247,88,9.2,1,Mostly Clear,11.3,2023-03-01 22:00:00,22
30,75,105,91,9.1,1,Mostly Clear,10.7,2023-03-01 23:00:00,23
18,32,50,92,9.2,1,Mostly Clear,11.2,2023-03-02 00:00:00,0
5,19,24,92,9.6,1,Mostly Clear,11.3,2023-03-02 01:00:00,1
7,7,14,92,10.3,2,Partly Cloudy,11.3,2023-03-02 02:00:00,2
3,4,7,93,9.1,3,Cloudy,9.0,2023-03-02 03:00:00,3
2,7,9,91,9.4,53,Heavy Drizzle,8.6,2023-03-02 04:00:00,4
17,38,55,90,9.4,61,Light Rain,7.0,2023-03-02 05:00:00,5
22,88,110,93,9.2,51,Light Drizzle,4.5,2023-03-02 06:00:00,6
83,339,422,94,9.4,51,Light Drizzle,5.6,2023-03-02 07:00:00,7
141,585,726,94,9.7,51,Light Drizzle,7.6,2023-03-02 08:00:00,8
96,399,495,94,10.5,51,Light Drizzle,9.8,2023-03-02 09:00:00,9
80,220,300,93,12.0,1,Mostly Clear,9.4,2023-03-02 10:00:00,10
130,233,363,87,14.3,1,Mostly Clear,9.7,2023-03-02 11:00:00,11
127,298,425,76,17.2,2,Partly Cloudy,12.5,2023-03-02 12:00:00,12
121,324,445,67,17.8,2,Partly Cloudy,16.5,2023-03-02 13:00:00,13
129,319,448,58,18.0,2,Partly Cloudy,16.1,2023-03-02 14:00:00,14
171,378,549,60,18.4,1,Mostly Clear,15.9,2023-03-02 15:00:00,15
222,505,727,52,18.2,1,Mostly Clear,15.1,2023-03-02 16:00:00,16
291,833,1124,51,17.2,1,Mostly Clear,13.5,2023-03-02 17:00:00,17
263,691,954,50,16.1,1,Mostly Clear,10.5,2023-03-02 18:00:00,18
138,494,632,51,14.2,1,Mostly Clear,7.9,2023-03-02 19:00:00,19
113,368,481,53,12.7,1,Mostly Clear,10.0,2023-03-02 20:00:00,20
121,295,416,56,11.5,1,Mostly Clear,8.9,2023-03-02 21:00:00,21
89,165,254,62,10.2,1,Mostly Clear,7.5,2023-03-02 22:00:00,22
54,112,166,69,9.1,1,Mostly Clear,7.1,2023-03-02 23:00:00,23
30,47,77,71,8.3,0,Clear,7.0,2023-03-03 00:00:00,0
13,17,30,76,6.6,1,Mostly Clear,7.8,2023-03-03 01:00:00,1
10,7,17,75,6.3,1,Mostly Clear,9.1,2023-03-03 02:00:00,2
4,4,8,69,6.5,0,Clear,10.2,2023-03-03 03:00:00,3
7,11,18,67,6.4,0,Clear,12.7,2023-03-03 04:00:00,4
16,42,58,66,6.2,0,Clear,14.1,2023-03-03 05:00:00,5
40,136,176,68,5.6,0,Clear,11.0,2023-03-03 06:00:00,6
72,338,410,71,5.2,0,Clear,12.8,2023-03-03 07:00:00,7
104,479,583,75,4.8,0,Clear,13.4,2023-03-03 08:00:00,8
87,311,398,73,5.8,2,Partly Cloudy,12.9,2023-03-03 09:00:00,9
56,203,259,68,7.0,3,Cloudy,11.2,2023-03-03 10:00:00,10
43,180,223,63,8.1,3,Cloudy,12.3,2023-03-03 11:00:00,11
57,149,206,63,8.2,3,Cloudy,14.5,2023-03-03 12:00:00,12
44,151,195,64,8.2,51,Light Drizzle,16.6,2023-03-03 13:00:00,13
51,150,201,70,7.9,51,Light Drizzle,14.8,2023-03-03 14:00:00,14
38,190,228,88,5.7,55,Heavy Drizzle,11.1,2023-03-03 15:00:00,15
42,173,215,92,5.5,53,Heavy Drizzle,14.8,2023-03-03 16:00:00,16
50,271,321,94,5.2,53,Heavy Drizzle,19.5,2023-03-03 17:00:00,17
44,168,212,95,5.0,53,Heavy Drizzle,19.1,2023-03-03 18:00:00,18
33,149,182,94,5.1,53,Heavy Drizzle,16.9,2023-03-03 19:00:00,19
25,75,100,94,5.7,51,Light Drizzle,19.2,2023-03-03 20:00:00,20
22,73,95,95,7.2,55,Heavy Drizzle,23.3,2023-03-03 21:00:00,21
27,59,86,97,9.2,55,Heavy Drizzle,22.1,2023-03-03 22:00:00,22
25,54,79,98,11.6,61,Light Rain,16.6,2023-03-03 23:00:00,23
36,72,108,98,14.0,61,Light Rain,9.1,2023-03-04 00:00:00,0
22,45,67,95,16.0,61,Light Rain,10.0,2023-03-04 01:00:00,1
25,29,54,94,16.6,53,Heavy Drizzle,18.1,2023-03-04 02:00:00,2
11,16,27,96,10.9,3,Cloudy,18.9,2023-03-04 03:00:00,3
5,11,16,94,10.0,3,Cloudy,18.7,2023-03-04 04:00:00,4
7,16,23,93,9.8,3,Cloudy,17.5,2023-03-04 05:00:00,5
27,36,63,86,9.8,2,Partly Cloudy,15.6,2023-03-04 06:00:00,6
35,95,130,74,9.3,3,Cloudy,18.4,2023-03-04 07:00:00,7
89,198,287,64,8.8,3,Cloudy,20.6,2023-03-04 08:00:00,8
165,338,503,58,8.8,3,Cloudy,22.4,2023-03-04 09:00:00,9
187,359,546,54,8.9,3,Cloudy,27.0,2023-03-04 10:00:00,10
315,389,704,53,9.3,3,Cloudy,26.3,2023-03-04 11:00:00,11
388,439,827,49,10.3,3,Cloudy,26.8,2023-03-04 12:00:00,12
377,421,798,47,11.3,3,Cloudy,26.9,2023-03-04 13:00:00,13
408,438,846,44,12.1,2,Partly Cloudy,28.4,2023-03-04 14:00:00,14
394,420,814,44,12.5,1,Mostly Clear,28.5,2023-03-04 15:00:00,15
356,415,771,44,12.5,0,Clear,28.3,2023-03-04 16:00:00,16
317,380,697,44,12.0,0,Clear,25.7,2023-03-04 17:00:00,17
188,312,500,46,11.2,0,Clear,16.9,2023-03-04 18:00:00,18
130,268,398,48,10.0,0,Clear,13.1,2023-03-04 19:00:00,19
124,224,348,51,8.9,0,Clear,10.6,2023-03-04 20:00:00,20
96,174,270,53,8.1,0,Clear,11.5,2023-03-04 21:00:00,21
93,164,257,57,7.3,0,Clear,11.2,2023-03-04 22:00:00,22
79,131,210,62,6.3,2,Partly Cloudy,7.9,2023-03-04 23:00:00,23
63,96,159,72,5.1,0,Clear,6.9,2023-03-05 00:00:00,0
64,80,144,78,4.0,0,Clear,6.6,2023-03-05 01:00:00,1
39,45,84,79,3.5,0,Clear,7.4,2023-03-05 02:00:00,2
14,17,31,80,3.6,0,Clear,7.1,2023-03-05 03:00:00,3
10,12,22,75,4.8,0,Clear,5.4,2023-03-05 04:00:00,4
5,5,10,77,4.7,0,Clear,3.1,2023-03-05 05:00:00,5
10,35,45,81,4.4,0,Clear,5.4,2023-03-05 06:00:00,6
21,80,101,88,2.9,0,Clear,6.2,2023-03-05 07:00:00,7
62,156,218,92,1.4,0,Clear,6.3,2023-03-05 08:00:00,8
193,253,446,88,4.1,0,Clear,7.5,2023-03-05 09:00:00,9
268,331,599,65,8.9,0,Clear,6.9,2023-03-05 10:00:00,10
339,440,779,54,11.6,0,Clear,9.0,2023-03-05 11:00:00,11
495,519,1014,46,13.8,0,Clear,13.0,2023-03-05 12:00:00,12
523,520,1043,41,15.1,0,Clear,18.5,2023-03-05 13:00:00,13
503,529,1032,38,15.5,0,Clear,22.0,2023-03-05 14:00:00,14
537,514,1051,37,16.1,0,Clear,19.0,2023-03-05 15:00:00,15
497,486,983,36,16.3,0,Clear,17.7,2023-03-05 16:00:00,16
449,540,989,36,16.0,0,Clear,16.0,2023-03-05 17:00:00,17
242,368,610,41,14.9,0,Clear,9.0,2023-03-05 18:00:00,18
127,245,372,46,12.7,0,Clear,7.6,2023-03-05 19:00:00,19
81,148,229,51,10.7,0,Clear,9.5,2023-03-05 20:00:00,20
96,135,231,54,9.3,1,Mostly Clear,10.1,2023-03-05 21:00:00,21
66,127,193,56,8.3,1,Mostly Clear,10.4,2023-03-05 22:00:00,22
29,40,69,57,7.5,0,Clear,9.4,2023-03-05 23:00:00,23
17,20,37,59,6.8,0,Clear,8.3,2023-03-06 00:00:00,0
6,6,12,61,6.0,0,Clear,7.6,2023-03-06 01:00:00,1
2,4,6,65,5.1,0,Clear,7.3,2023-03-06 02:00:00,2
3,5,8,74,4.1,0,Clear,7.5,2023-03-06 03:00:00,3
5,10,15,78,3.1,0,Clear,7.1,2023-03-06 04:00:00,4
11,63,74,80,2.4,0,Clear,6.4,2023-03-06 05:00:00,5
43,155,198,81,2.0,0,Clear,6.3,2023-03-06 06:00:00,6
63,366,429,85,1.1,0,Clear,5.1,2023-03-06 07:00:00,7
133,544,677,86,0.9,1,Mostly Clear,6.5,2023-03-06 08:00:00,8
118,318,436,79,4.0,1,Mostly Clear,6.1,2023-03-06 09:00:00,9
118,195,313,61,7.1,1,Mostly Clear,4.2,2023-03-06 10:00:00,10
139,198,337,54,8.8,0,Clear,1.0,2023-03-06 11:00:00,11
150,304,454,50,10.4,0,Clear,2.3,2023-03-06 12:00:00,12
164,302,466,48,11.8,0,Clear,2.4,2023-03-06 13:00:00,13
207,259,466,46,12.9,0,Clear,3.9,2023-03-06 14:00:00,14
237,376,613,45,13.4,0,Clear,4.3,2023-03-06 15:00:00,15
256,504,760,44,13.8,0,Clear,4.8,2023-03-06 16:00:00,16
351,730,1081,44,13.9,0,Clear,6.5,2023-03-06 17:00:00,17
223,651,874,47,13.3,0,Clear,4.3,2023-03-06 18:00:00,18
141,370,511,54,11.4,0,Clear,8.4,2023-03-06 19:00:00,19
99,251,350,61,9.5,0,Clear,10.0,2023-03-06 20:00:00,20
86,207,293,65,8.1,0,Clear,10.0,2023-03-06 21:00:00,21
46,121,167,68,7.3,0,Clear,10.5,2023-03-06 22:00:00,22
31,45,76,71,6.7,0,Clear,11.3,2023-03-06 23:00:00,23
7,20,27,75,6.4,0,Clear,12.0,2023-03-07 00:00:00,0
3,6,9,81,6.1,1,Mostly Clear,11.0,2023-03-07 01:00:00,1
1,5,6,89,5.9,51,Light Drizzle,5.5,2023-03-07 02:00:00,2
0,5,5,86,5.6,1,Mostly Clear,11.2,2023-03-07 03:00:00,3
2,16,18,78,5.9,0,Clear,14.3,2023-03-07 04:00:00,4
16,58,74,72,5.9,0,Clear,12.5,2023-03-07 05:00:00,5
38,172,210,72,5.2,0,Clear,8.9,2023-03-07 06:00:00,6
85,432,517,74,4.3,0,Clear,9.9,2023-03-07 07:00:00,7
173,698,871,78,3.7,0,Clear,11.2,2023-03-07 08:00:00,8
129,412,541,76,4.0,3,Cloudy,15.5,2023-03-07 09:00:00,9
76,177,253,70,4.6,3,Cloudy,15.8,2023-03-07 10:00:00,10
100,203,303,64,5.0,2,Partly Cloudy,15.8,2023-03-07 11:00:00,11
124,253,377,54,6.7,0,Clear,17.7,2023-03-07 12:00:00,12
123,269,392,44,8.8,0,Clear,20.8,2023-03-07 13:00:00,13
113,212,325,36,10.2,0,Clear,22.8,2023-03-07 14:00:00,14
173,359,532,31,11.1,0,Clear,25.0,2023-03-07 15:00:00,15
187,470,657,29,11.1,0,Clear,26.5,2023-03-07 16:00:00,16
266,718,984,28,10.6,0,Clear,27.3,2023-03-07 17:00:00,17
179,638,817,28,9.7,0,Clear,21.1,2023-03-07 18:00:00,18
131,404,535,27,8.3,0,Clear,19.4,2023-03-07 19:00:00,19
87,234,321,27,7.0,0,Clear,19.6,2023-03-07 20:00:00,20
62,178,240,29,5.9,0,Clear,20.4,2023-03-07 21:00:00,21
34,109,143,32,4.9,0,Clear,22.4,2023-03-07 22:00:00,22
30,56,86,37,3.9,0,Clear,24.1,2023-03-07 23:00:00,23
8,26,34,40,3.1,0,Clear,23.5,2023-03-08 00:00:00,0
2,3,5,43,2.4,0,Clear,21.5,2023-03-08 01:00:00,1
1,2,3,45,1.9,0,Clear,20.3,2023-03-08 02:00:00,2
5,3,8,41,2.1,0,Clear,20.0,2023-03-08 03:00:00,3
2,9,11,42,1.8,0,Clear,19.8,2023-03-08 04:00:00,4
16,53,69,44,1.5,0,Clear,19.5,2023-03-08 05:00:00,5
40,164,204,46,1.2,0,Clear,17.1,2023-03-08 06:00:00,6
60,396,456,48,0.9,0,Clear,17.3,2023-03-08 07:00:00,7
142,645,787,53,0.8,0,Clear,18.6,2023-03-08 08:00:00,8
105,363,468,54,1.8,0,Clear,17.9,2023-03-08 09:00:00,9
82,196,278,51,3.2,0,Clear,21.3,2023-03-08 10:00:00,10
88,218,306,49,4.8,0,Clear,19.8,2023-03-08 11:00:00,11
119,300,419,47,6.4,0,Clear,19.2,2023-03-08 12:00:00,12
128,289,417,45,8.0,0,Clear,18.2,2023-03-08 13:00:00,13
170,280,450,44,9.3,0,Clear,17.9,2023-03-08 14:00:00,14
146,364,510,41,10.2,0,Clear,18.2,2023-03-08 15:00:00,15
201,473,674,40,10.7,0,Clear,18.7,2023-03-08 16:00:00,16
271,800,1071,41,10.8,0,Clear,18.8,2023-03-08 17:00:00,17
219,633,852,42,10.3,0,Clear,13.2,2023-03-08 18:00:00,18
191,436,627,46,8.9,0,Clear,9.4,2023-03-08 19:00:00,19
100,292,392,50,7.6,0,Clear,9.7,2023-03-08 20:00:00,20
80,256,336,54,6.5,0,Clear,10.2,2023-03-08 21:00:00,21
63,151,214,57,5.7,0,Clear,10.7,2023-03-08 22:00:00,22
35,80,115,59,5.0,0,Clear,11.8,2023-03-08 23:00:00,23
11,30,41,60,4.5,0,Clear,12.6,2023-03-09 00:00:00,0
7,7,14,61,4.0,0,Clear,13.5,2023-03-09 01:00:00,1
4,5,9,62,3.4,0,Clear,13.6,2023-03-09 02:00:00,2
2,4,6,62,3.4,0,Clear,13.1,2023-03-09 03:00:00,3
2,7,9,63,2.8,0,Clear,12.8,2023-03-09 04:00:00,4
16,45,61,65,2.1,0,Clear,12.1,2023-03-09 05:00:00,5
40,142,182,67,1.5,0,Clear,8.5,2023-03-09 06:00:00,6
78,384,462,69,0.9,0,Clear,9.5,2023-03-09 07:00:00,7
165,642,807,71,0.6,0,Clear,10.1,2023-03-09 08:00:00,8
138,421,559,66,1.9,0,Clear,10.8,2023-03-09 09:00:00,9
133,206,339,60,3.6,0,Clear,11.8,2023-03-09 10:00:00,10
138,237,375,56,5.6,0,Clear,11.2,2023-03-09 11:00:00,11
143,318,461,52,7.5,0,Clear,10.9,2023-03-09 12:00:00,12
178,304,482,49,9.3,0,Clear,11.0,2023-03-09 13:00:00,13
182,284,466,46,10.7,0,Clear,12.5,2023-03-09 14:00:00,14
204,341,545,43,11.9,0,Clear,12.4,2023-03-09 15:00:00,15
292,498,790,42,12.3,0,Clear,12.4,2023-03-09 16:00:00,16
389,804,1193,42,12.3,0,Clear,11.8,2023-03-09 17:00:00,17
267,614,881,44,11.7,0,Clear,9.3,2023-03-09 18:00:00,18
150,430,580,50,10.1,0,Clear,5.8,2023-03-09 19:00:00,19
127,305,432,57,8.4,0,Clear,6.2,2023-03-09 20:00:00,20
120,254,374,65,6.9,0,Clear,7.0,2023-03-09 21:00:00,21
116,151,267,72,5.4,0,Clear,7.1,2023-03-09 22:00:00,22
46,95,141,76,4.4,0,Clear,7.1,2023-03-09 23:00:00,23
38,50,88,77,3.7,0,Clear,8.1,2023-03-10 00:00:00,0
18,20,38,79,3.2,1,Mostly Clear,8.4,2023-03-10 01:00:00,1
8,11,19,82,2.6,1,Mostly Clear,10.1,2023-03-10 02:00:00,2
4,10,14,81,2.9,2,Partly Cloudy,7.8,2023-03-10 03:00:00,3
2,12,14,83,2.8,3,Cloudy,5.4,2023-03-10 04:00:00,4
19,42,61,82,3.0,3,Cloudy,9.1,2023-03-10 05:00:00,5
29,122,151,82,3.1,3,Cloudy,3.5,2023-03-10 06:00:00,6
50,274,324,81,3.2,2,Partly Cloudy,6.5,2023-03-10 07:00:00,7
116,422,538,81,3.4,3,Cloudy,5.1,2023-03-10 08:00:00,8
88,241,329,78,4.3,3,Cloudy,6.5,2023-03-10 09:00:00,9
34,149,183,74,5.3,2,Partly Cloudy,7.8,2023-03-10 10:00:00,10
66,186,252,69,6.6,51,Light Drizzle,9.7,2023-03-10 11:00:00,11
85,283,368,70,7.2,51,Light Drizzle,12.3,2023-03-10 12:00:00,12
108,233,341,69,8.0,51,Light Drizzle,13.7,2023-03-10 13:00:00,13
48,111,159,75,8.0,51,Light Drizzle,13.8,2023-03-10 14:00:00,14
77,196,273,77,7.7,51,Light Drizzle,13.4,2023-03-10 15:00:00,15
97,250,347,83,7.8,51,Light Drizzle,12.4,2023-03-10 16:00:00,16
82,217,299,90,7.6,51,Light Drizzle,12.1,2023-03-10 17:00:00,17
63,230,293,93,7.4,55,Heavy Drizzle,8.4,2023-03-10 18:00:00,18
69,212,281,94,7.3,53,Heavy Drizzle,5.9,2023-03-10 19:00:00,19
50,132,182,95,7.1,51,Light Drizzle,6.6,2023-03-10 20:00:00,20
46,141,187,91,7.1,1,Mostly Clear,7.9,2023-03-10 21:00:00,21
46,105,151,88,6.0,0,Clear,11.2,2023-03-10 22:00:00,22
59,105,164,86,4.9,0,Clear,14.4,2023-03-10 23:00:00,23
41,65,106,85,4.2,0,Clear,15.1,2023-03-11 00:00:00,0
28,60,88,81,3.6,2,Partly Cloudy,16.9,2023-03-11 01:00:00,1
22,39,61,75,3.1,3,Cloudy,18.7,2023-03-11 02:00:00,2
7,16,23,78,2.6,1,Mostly Clear,20.4,2023-03-11 03:00:00,3
2,6,8,70,2.3,1,Mostly Clear,22.2,2023-03-11 04:00:00,4
4,10,14,64,2.0,0,Clear,22.1,2023-03-11 05:00:00,5
18,41,59,63,1.8,2,Partly Cloudy,16.3,2023-03-11 06:00:00,6
26,86,112,62,1.7,3,Cloudy,19.4,2023-03-11 07:00:00,7
58,172,230,62,1.8,3,Cloudy,21.4,2023-03-11 08:00:00,8
85,261,346,61,2.4,3,Cloudy,22.7,2023-03-11 09:00:00,9
170,256,426,58,3.4,2,Partly Cloudy,25.7,2023-03-11 10:00:00,10
231,349,580,54,5.6,2,Partly Cloudy,28.3,2023-03-11 11:00:00,11
288,381,669,50,7.1,3,Cloudy,27.1,2023-03-11 12:00:00,12
275,358,633,49,7.5,3,Cloudy,25.9,2023-03-11 13:00:00,13
310,386,696,47,8.2,3,Cloudy,23.7,2023-03-11 14:00:00,14
280,321,601,47,7.9,3,Cloudy,21.9,2023-03-11 15:00:00,15
230,341,571,45,8.3,3,Cloudy,19.7,2023-03-11 16:00:00,16
226,328,554,44,8.2,3,Cloudy,17.6,2023-03-11 17:00:00,17
171,264,435,45,7.7,3,Cloudy,15.6,2023-03-11 18:00:00,18
110,225,335,46,7.0,3,Cloudy,12.8,2023-03-11 19:00:00,19
77,160,237,50,5.6,3,Cloudy,11.2,2023-03-11 20:00:00,20
70,130,200,51,5.1,3,Cloudy,11.3,2023-03-11 21:00:00,21
82,124,206,52,4.7,3,Cloudy,11.5,2023-03-11 22:00:00,22
66,130,196,54,4.0,2,Partly Cloudy,10.6,2023-03-11 23:00:00,23
60,84,144,59,3.0,0,Clear,7.9,2023-03-12 00:00:00,0
40,55,95,65,2.0,0,Clear,6.8,2023-03-12 01:00:00,1
39,31,70,80,0.0,0,Clear,6.5,2023-03-12 03:00:00,3
11,16,27,81,-0.6,1,Mostly Clear,5.7,2023-03-12 04:00:00,4
6,16,22,82,-0.9,1,Mostly Clear,6.5,2023-03-12 05:00:00,5
9,24,33,82,-0.9,1,Mostly Clear,5.9,2023-03-12 06:00:00,6
14,49,63,81,-0.8,1,Mostly Clear,4.7,2023-03-12 07:00:00,7
54,96,150,79,-0.2,1,Mostly Clear,6.0,2023-03-12 08:00:00,8
106,157,263,70,1.5,1,Mostly Clear,7.1,2023-03-12 09:00:00,9
145,234,379,67,2.7,2,Partly Cloudy,3.8,2023-03-12 10:00:00,10
140,266,406,65,3.9,3,Cloudy,3.0,2023-03-12 11:00:00,11
197,344,541,63,5.0,3,Cloudy,7.4,2023-03-12 12:00:00,12
221,293,514,57,5.9,3,Cloudy,7.1,2023-03-12 13:00:00,13
196,285,481,63,5.4,3,Cloudy,6.8,2023-03-12 14:00:00,14
212,289,501,66,5.7,51,Light Drizzle,7.9,2023-03-12 15:00:00,15
110,198,308,73,5.0,51,Light Drizzle,7.6,2023-03-12 16:00:00,16
97,185,282,79,4.6,71,Light Snow,7.6,2023-03-12 17:00:00,17
66,156,222,84,4.2,71,Light Snow,6.8,2023-03-12 18:00:00,18
44,145,189,91,3.6,51,Light Drizzle,6.2,2023-03-12 19:00:00,19
37,82,119,92,3.1,51,Light Drizzle,7.4,2023-03-12 20:00:00,20
40,96,136,95,3.1,51,Light Drizzle,8.0,2023-03-12 21:00:00,21
36,68,104,95,3.2,51,Light Drizzle,7.4,2023-03-12 22:00:00,22
31,30,61,96,3.3,51,Light Drizzle,5.7,2023-03-12 23:00:00,23
5,19,24,96,3.5,51,Light Drizzle,4.0,2023-03-13 00:00:00,0
3,9,12,96,3.5,51,Light Drizzle,4.3,2023-03-13 01:00:00,1
2,3,5,96,3.6,51,Light Drizzle,4.8,2023-03-13 02:00:00,2
7,9,16,96,3.4,51,Light Drizzle,5.8,2023-03-13 03:00:00,3
8,12,20,96,3.4,51,Light Drizzle,6.0,2023-03-13 04:00:00,4
14,42,56,96,3.5,51,Light Drizzle,5.1,2023-03-13 05:00:00,5
18,133,151,97,3.6,51,Light Drizzle,2.5,2023-03-13 06:00:00,6
47,267,314,97,3.6,51,Light Drizzle,1.3,2023-03-13 07:00:00,7
119,432,551,96,3.7,51,Light Drizzle,3.1,2023-03-13 08:00:00,8
83,256,339,93,4.1,3,Cloudy,2.3,2023-03-13 09:00:00,9
52,127,179,90,4.6,3,Cloudy,1.1,2023-03-13 10:00:00,10
83,138,221,88,5.3,51,Light Drizzle,1.9,2023-03-13 11:00:00,11
90,187,277,84,5.7,51,Light Drizzle,4.9,2023-03-13 12:00:00,12
93,205,298,80,6.5,51,Light Drizzle,6.4,2023-03-13 13:00:00,13
140,194,334,75,7.5,51,Light Drizzle,7.8,2023-03-13 14:00:00,14
143,273,416,68,8.1,3,Cloudy,9.7,2023-03-13 15:00:00,15
177,428,605,65,8.3,3,Cloudy,11.4,2023-03-13 16:00:00,16
252,585,837,61,8.5,3,Cloudy,12.1,2023-03-13 17:00:00,17
194,607,801,61,8.4,3,Cloudy,11.1,2023-03-13 18:00:00,18
115,403,518,63,7.7,3,Cloudy,9.5,2023-03-13 19:00:00,19
70,237,307,67,6.3,2,Partly Cloudy,11.1,2023-03-13 20:00:00,20
57,161,218,70,5.2,1,Mostly Clear,12.0,2023-03-13 21:00:00,21
34,92,126,69,4.3,0,Clear,12.7,2023-03-13 22:00:00,22
21,51,72,65,4.0,0,Clear,16.1,2023-03-13 23:00:00,23
11,18,29,62,3.8,0,Clear,20.8,2023-03-14 00:00:00,0
6,1,7,58,3.0,0,Clear,21.7,2023-03-14 01:00:00,1
1,0,1,53,2.4,0,Clear,21.6,2023-03-14 02:00:00,2
1,3,4,51,1.7,0,Clear,21.1,2023-03-14 03:00:00,3
0,12,12,52,1.2,0,Clear,20.4,2023-03-14 04:00:00,4
13,49,62,54,0.8,0,Clear,20.5,2023-03-14 05:00:00,5
29,166,195,56,0.6,0,Clear,18.7,2023-03-14 06:00:00,6
61,321,382,58,0.5,0,Clear,18.8,2023-03-14 07:00:00,7
172,623,795,59,0.7,0,Clear,20.2,2023-03-14 08:00:00,8
94,336,430,55,1.5,0,Clear,23.1,2023-03-14 09:00:00,9
58,159,217,48,2.5,1,Mostly Clear,29.6,2023-03-14 10:00:00,10
74,170,244,43,3.7,2,Partly Cloudy,32.9,2023-03-14 11:00:00,11
74,192,266,39,4.7,3,Cloudy,33.5,2023-03-14 12:00:00,12
103,174,277,37,5.5,3,Cloudy,34.5,2023-03-14 13:00:00,13
71,177,248,35,6.3,2,Partly Cloudy,33.2,2023-03-14 14:00:00,14
97,252,349,35,6.1,1,Mostly Clear,34.2,2023-03-14 15:00:00,15
128,357,485,36,5.8,2,Partly Cloudy,33.2,2023-03-14 16:00:00,16
164,566,730,37,5.3,1,Mostly Clear,33.7,2023-03-14 17:00:00,17
146,528,674,37,4.4,0,Clear,29.8,2023-03-14 18:00:00,18
75,288,363,38,3.3,0,Clear,25.7,2023-03-14 19:00:00,19
61,198,259,40,2.4,0,Clear,25.5,2023-03-14 20:00:00,20
32,132,164,42,1.6,0,Clear,26.1,2023-03-14 21:00:00,21
22,77,99,45,0.9,0,Clear,26.6,2023-03-14 22:00:00,22
16,48,64,47,0.4,0,Clear,25.8,2023-03-14 23:00:00,23
11,22,33,49,0.1,0,Clear,25.1,2023-03-15 00:00:00,0
0,6,6,51,-0.1,0,Clear,24.3,2023-03-15 01:00:00,1
2,3,5,52,-0.2,0,Clear,24.2,2023-03-15 02:00:00,2
2,4,6,53,-0.2,0,Clear,24.2,2023-03-15 03:00:00,3
1,7,8,53,-0.2,0,Clear,24.2,2023-03-15 04:00:00,4
15,45,60,54,-0.2,0,Clear,24.4,2023-03-15 05:00:00,5
26,123,149,55,-0.2,0,Clear,19.5,2023-03-15 06:00:00,6
52,302,354,55,-0.2,0,Clear,21.1,2023-03-15 07:00:00,7
103,545,648,55,-0.0,0,Clear,23.0,2023-03-15 08:00:00,8
102,325,427,53,0.9,0,Clear,23.5,2023-03-15 09:00:00,9
57,162,219,47,2.3,0,Clear,27.4,2023-03-15 10:00:00,10
59,170,229,42,3.9,0,Clear,27.6,2023-03-15 11:00:00,11
61,196,257,36,5.6,0,Clear,27.5,2023-03-15 12:00:00,12
104,197,301,31,7.2,0,Clear,26.7,2023-03-15 13:00:00,13
109,225,334,28,8.5,0,Clear,26.5,2023-03-15 14:00:00,14
120,294,414,26,9.2,0,Clear,26.0,2023-03-15 15:00:00,15
205,408,613,25,9.7,0,Clear,25.7,2023-03-15 16:00:00,16
264,633,897,24,9.5,0,Clear,25.0,2023-03-15 17:00:00,17
179,573,752,26,8.9,0,Clear,18.2,2023-03-15 18:00:00,18
125,365,490,28,7.5,0,Clear,15.3,2023-03-15 19:00:00,19
75,265,340,28,6.4,0,Clear,15.5,2023-03-15 20:00:00,20
59,189,248,30,5.6,0,Clear,15.6,2023-03-15 21:00:00,21
69,137,206,32,4.9,0,Clear,15.8,2023-03-15 22:00:00,22
32,68,100,34,4.3,0,Clear,14.8,2023-03-15 23:00:00,23
11,25,36,37,3.7,0,Clear,14.4,2023-03-16 00:00:00,0
6,13,19,40,3.0,0,Clear,13.1,2023-03-16 01:00:00,1
1,4,5,43,2.1,0,Clear,11.5,2023-03-16 02:00:00,2
3,5,8,46,1.5,0,Clear,10.8,2023-03-16 03:00:00,3
1,11,12,51,0.7,0,Clear,10.3,2023-03-16 04:00:00,4
19,58,77,54,0.0,0,Clear,10.5,2023-03-16 05:00:00,5
36,137,173,56,-0.3,1,Mostly Clear,9.6,2023-03-16 06:00:00,6
66,328,394,62,-0.3,1,Mostly Clear,9.0,2023-03-16 07:00:00,7
145,556,701,69,-0.0,2,Partly Cloudy,9.1,2023-03-16 08:00:00,8
133,358,491,57,3.3,1,Mostly Clear,10.0,2023-03-16 09:00:00,9
155,191,346,45,6.7,0,Clear,9.7,2023-03-16 10:00:00,10
163,219,382,37,9.4,0,Clear,11.5,2023-03-16 11:00:00,11
199,257,456,32,11.4,0,Clear,11.7,2023-03-16 12:00:00,12
209,281,490,29,13.1,0,Clear,10.3,2023-03-16 13:00:00,13
264,256,520,27,14.4,0,Clear,10.7,2023-03-16 14:00:00,14
308,382,690,25,15.8,0,Clear,11.5,2023-03-16 15:00:00,15
357,503,860,24,16.1,1,Mostly Clear,11.8,2023-03-16 16:00:00,16
465,873,1338,25,16.0,1,Mostly Clear,12.0,2023-03-16 17:00:00,17
545,716,1261,31,15.0,0,Clear,7.5,2023-03-16 18:00:00,18
283,531,814,37,12.7,0,Clear,8.3,2023-03-16 19:00:00,19
140,340,480,40,10.7,0,Clear,9.9,2023-03-16 20:00:00,20
129,220,349,42,9.5,1,Mostly Clear,11.2,2023-03-16 21:00:00,21
108,197,305,44,8.9,2,Partly Cloudy,12.7,2023-03-16 22:00:00,22
65,112,177,46,8.8,3,Cloudy,14.0,2023-03-16 23:00:00,23
28,51,79,49,8.5,2,Partly Cloudy,14.5,2023-03-17 00:00:00,0
13,26,39,53,8.3,0,Clear,14.0,2023-03-17 01:00:00,1
4,8,12,56,8.1,2,Partly Cloudy,14.1,2023-03-17 02:00:00,2
2,2,4,50,8.5,1,Mostly Clear,13.8,2023-03-17 03:00:00,3
3,16,19,50,8.9,2,Partly Cloudy,13.7,2023-03-17 04:00:00,4
17,51,68,51,9.1,3,Cloudy,14.3,2023-03-17 05:00:00,5
36,119,155,51,9.4,2,Partly Cloudy,7.9,2023-03-17 06:00:00,6
63,287,350,54,9.1,1,Mostly Clear,8.5,2023-03-17 07:00:00,7
127,459,586,59,8.6,1,Mostly Clear,8.9,2023-03-17 08:00:00,8
143,320,463,58,10.1,1,Mostly Clear,10.3,2023-03-17 09:00:00,9
141,269,410,54,12.0,1,Mostly Clear,12.3,2023-03-17 10:00:00,10
176,229,405,48,13.6,1,Mostly Clear,16.0,2023-03-17 11:00:00,11
167,265,432,47,14.0,2,Partly Cloudy,18.9,2023-03-17 12:00:00,12
194,252,446,57,13.0,3,Cloudy,15.7,2023-03-17 13:00:00,13
166,225,391,68,12.2,51,Light Drizzle,14.9,2023-03-17 14:00:00,14
227,348,575,80,12.7,51,Light Drizzle,13.8,2023-03-17 15:00:00,15
322,444,766,81,12.8,51,Light Drizzle,12.6,2023-03-17 16:00:00,16
393,586,979,79,13.8,2,Partly Cloudy,13.0,2023-03-17 17:00:00,17
324,545,869,79,13.9,2,Partly Cloudy,14.0,2023-03-17 18:00:00,18
257,431,688,79,14.0,2,Partly Cloudy,13.6,2023-03-17 19:00:00,19
173,330,503,79,13.8,3,Cloudy,14.5,2023-03-17 20:00:00,20
164,179,343,79,14.1,3,Cloudy,16.1,2023-03-17 21:00:00,21
117,200,317,83,14.0,51,Light Drizzle,14.8,2023-03-17 22:00:00,22
81,122,203,88,13.2,51,Light Drizzle,13.2,2023-03-17 23:00:00,23
76,90,166,79,10.8,3,Cloudy,20.1,2023-03-18 00:00:00,0
68,71,139,71,8.8,3,Cloudy,19.4,2023-03-18 01:00:00,1
35,46,81,66,7.6,3,Cloudy,18.6,2023-03-18 02:00:00,2
19,15,34,72,7.7,3,Cloudy,19.6,2023-03-18 03:00:00,3
4,10,14,64,6.9,3,Cloudy,19.1,2023-03-18 04:00:00,4
6,22,28,61,6.0,2,Partly Cloudy,18.8,2023-03-18 05:00:00,5
51,84,135,59,5.2,3,Cloudy,13.8,2023-03-18 06:00:00,6
194,232,426,58,4.5,3,Cloudy,13.6,2023-03-18 07:00:00,7
149,196,345,58,4.2,3,Cloudy,13.1,2023-03-18 08:00:00,8
257,293,550,56,4.3,2,Partly Cloudy,17.6,2023-03-18 09:00:00,9
404,366,770,53,5.1,1,Mostly Clear,17.8,2023-03-18 10:00:00,10
440,436,876,48,6.3,1,Mostly Clear,18.4,2023-03-18 11:00:00,11
471,475,946,43,7.6,1,Mostly Clear,17.3,2023-03-18 12:00:00,12
511,440,951,39,8.7,1,Mostly Clear,16.5,2023-03-18 13:00:00,13
524,439,963,36,9.7,0,Clear,15.5,2023-03-18 14:00:00,14
611,464,1075,35,10.4,0,Clear,16.2,2023-03-18 15:00:00,15
596,457,1053,33,10.8,0,Clear,17.2,2023-03-18 16:00:00,16
546,454,1000,29,11.1,1,Mostly Clear,21.0,2023-03-18 17:00:00,17
420,420,840,28,10.9,1,Mostly Clear,13.1,2023-03-18 18:00:00,18
244,310,554,32,9.4,0,Clear,7.9,2023-03-18 19:00:00,19
137,196,333,35,7.7,0,Clear,10.9,2023-03-18 20:00:00,20
99,168,267,34,6.6,0,Clear,14.4,2023-03-18 21:00:00,21
105,148,253,34,5.8,0,Clear,14.8,2023-03-18 22:00:00,22
76,133,209,37,5.2,0,Clear,18.2,2023-03-18 23:00:00,23
48,95,143,39,4.7,0,Clear,21.0,2023-03-19 00:00:00,0
34,50,84,37,3.9,1,Mostly Clear,22.0,2023-03-19 01:00:00,1
23,27,50,33,2.8,0,Clear,21.4,2023-03-19 02:00:00,2
14,20,34,38,2.1,0,Clear,20.7,2023-03-19 03:00:00,3
1,8,9,38,0.9,0,Clear,20.3,2023-03-19 04:00:00,4
3,10,13,36,-0.1,0,Clear,19.7,2023-03-19 05:00:00,5
12,19,31,35,-1.0,0,Clear,15.8,2023-03-19 06:00:00,6
17,51,68,34,-1.8,0,Clear,16.7,2023-03-19 07:00:00,7
38,99,137,35,-2.0,0,Clear,17.4,2023-03-19 08:00:00,8
88,188,276,34,-1.4,0,Clear,17.5,2023-03-19 09:00:00,9
154,222,376,34,-0.2,0,Clear,17.4,2023-03-19 10:00:00,10
153,278,431,33,1.1,0,Clear,18.4,2023-03-19 11:00:00,11
196,290,486,33,2.6,0,Clear,19.0,2023-03-19 12:00:00,12
229,326,555,32,3.9,0,Clear,19.6,2023-03-19 13:00:00,13
219,344,563,30,5.2,0,Clear,20.1,2023-03-19 14:00:00,14
249,381,630,32,4.8,0,Clear,19.8,2023-03-19 15:00:00,15
197,289,486,31,5.2,0,Clear,20.0,2023-03-19 16:00:00,16
200,284,484,30,5.2,0,Clear,19.5,2023-03-19 17:00:00,17
132,241,373,29,4.9,0,Clear,15.6,2023-03-19 18:00:00,18
83,170,253,29,4.1,0,Clear,11.9,2023-03-19 19:00:00,19
41,102,143,33,2.9,0,Clear,8.8,2023-03-19 20:00:00,20
38,91,129,37,1.8,0,Clear,9.4,2023-03-19 21:00:00,21
17,63,80,41,0.9,0,Clear,9.8,2023-03-19 22:00:00,22
28,35,63,45,-0.1,0,Clear,10.0,2023-03-19 23:00:00,23
15,17,32,51,-1.0,0,Clear,9.9,2023-03-20 00:00:00,0
4,6,10,57,-1.8,0,Clear,8.4,2023-03-20 01:00:00,1
2,3,5,61,-2.4,0,Clear,6.8,2023-03-20 02:00:00,2
2,8,10,61,-2.6,0,Clear,6.4,2023-03-20 03:00:00,3
5,11,16,62,-2.8,0,Clear,6.0,2023-03-20 04:00:00,4
9,43,52,60,-2.7,0,Clear,5.8,2023-03-20 05:00:00,5
28,143,171,57,-2.0,0,Clear,5.2,2023-03-20 06:00:00,6
61,289,350,60,-2.2,0,Clear,4.9,2023-03-20 07:00:00,7
106,469,575,64,-1.9,0,Clear,7.0,2023-03-20 08:00:00,8
75,288,363,52,1.1,0,Clear,6.8,2023-03-20 09:00:00,9
89,189,278,45,3.0,0,Clear,7.1,2023-03-20 10:00:00,10
126,194,320,43,4.7,0,Clear,5.5,2023-03-20 11:00:00,11
141,280,421,41,6.3,0,Clear,5.2,2023-03-20 12:00:00,12
160,218,378,38,7.8,0,Clear,6.7,2023-03-20 13:00:00,13
183,242,425,36,8.9,0,Clear,8.1,2023-03-20 14:00:00,14
226,373,599,34,9.8,0,Clear,8.5,2023-03-20 15:00:00,15
279,470,749,33,10.2,0,Clear,8.7,2023-03-20 16:00:00,16
346,767,1113,33,10.2,0,Clear,8.9,2023-03-20 17:00:00,17
325,693,1018,33,9.7,0,Clear,5.8,2023-03-20 18:00:00,18
191,462,653,42,8.2,0,Clear,7.3,2023-03-20 19:00:00,19
145,290,435,48,6.3,0,Clear,6.9,2023-03-20 20:00:00,20
98,210,308,52,4.9,0,Clear,8.0,2023-03-20 21:00:00,21
58,143,201,56,3.7,0,Clear,8.9,2023-03-20 22:00:00,22
14,66,80,60,2.7,0,Clear,9.2,2023-03-20 23:00:00,23
14,32,46,65,1.8,0,Clear,9.0,2023-03-21 00:00:00,0
3,11,14,71,0.9,0,Clear,8.9,2023-03-21 01:00:00,1
3,3,6,76,0.2,0,Clear,9.2,2023-03-21 02:00:00,2
1,7,8,72,-0.2,0,Clear,9.2,2023-03-21 03:00:00,3
1,10,11,73,-0.8,0,Clear,8.4,2023-03-21 04:00:00,4
14,48,62,74,-1.3,0,Clear,7.6,2023-03-21 05:00:00,5
41,176,217,72,-1.2,0,Clear,7.4,2023-03-21 06:00:00,6
84,412,496,71,-1.1,0,Clear,7.2,2023-03-21 07:00:00,7
213,743,956,73,-0.4,0,Clear,5.7,2023-03-21 08:00:00,8
128,423,551,64,3.5,0,Clear,3.6,2023-03-21 09:00:00,9
140,216,356,52,7.1,0,Clear,2.6,2023-03-21 10:00:00,10
181,274,455,44,10.5,0,Clear,2.4,2023-03-21 11:00:00,11
186,311,497,34,13.0,0,Clear,3.6,2023-03-21 12:00:00,12
191,293,484,28,14.5,0,Clear,4.8,2023-03-21 13:00:00,13
194,318,512,27,15.4,1,Mostly Clear,6.2,2023-03-21 14:00:00,14
267,379,646,25,15.9,1,Mostly Clear,7.7,2023-03-21 15:00:00,15
362,583,945,26,15.8,1,Mostly Clear,8.4,2023-03-21 16:00:00,16
576,994,1570,27,15.5,1,Mostly Clear,9.1,2023-03-21 17:00:00,17
458,883,1341,32,14.5,2,Partly Cloudy,5.0,2023-03-21 18:00:00,18
273,557,830,39,12.3,2,Partly Cloudy,8.7,2023-03-21 19:00:00,19
168,326,494,44,10.3,2,Partly Cloudy,11.5,2023-03-21 20:00:00,20
149,238,387,51,8.7,0,Clear,12.5,2023-03-21 21:00:00,21
70,183,253,56,7.6,0,Clear,11.6,2023-03-21 22:00:00,22
47,73,120,61,6.6,1,Mostly Clear,11.4,2023-03-21 23:00:00,23
16,34,50,65,5.9,3,Cloudy,10.8,2023-03-22 00:00:00,0
6,4,10,68,5.3,3,Cloudy,11.3,2023-03-22 01:00:00,1
5,10,15,68,5.2,3,Cloudy,11.3,2023-03-22 02:00:00,2
5,4,9,59,6.2,3,Cloudy,11.3,2023-03-22 03:00:00,3
6,10,16,56,6.5,3,Cloudy,12.0,2023-03-22 04:00:00,4
16,64,80,55,6.6,3,Cloudy,11.2,2023-03-22 05:00:00,5
73,201,274,55,6.6,3,Cloudy,8.7,2023-03-22 06:00:00,6
145,450,595,58,6.4,2,Partly Cloudy,7.6,2023-03-22 07:00:00,7
218,784,1002,63,6.3,2,Partly Cloudy,8.2,2023-03-22 08:00:00,8
175,424,599,60,7.9,2,Partly Cloudy,9.4,2023-03-22 09:00:00,9
144,264,408,54,9.6,1,Mostly Clear,9.8,2023-03-22 10:00:00,10
168,254,422,47,12.1,0,Clear,10.5,2023-03-22 11:00:00,11
245,366,611,42,14.4,1,Mostly Clear,11.3,2023-03-22 12:00:00,12
232,355,587,37,16.1,1,Mostly Clear,13.9,2023-03-22 13:00:00,13
275,328,603,32,17.0,2,Partly Cloudy,15.3,2023-03-22 14:00:00,14
316,430,746,28,18.0,0,Clear,15.6,2023-03-22 15:00:00,15
402,640,1042,27,18.2,0,Clear,15.9,2023-03-22 16:00:00,16
600,1036,1636,29,17.9,1,Mostly Clear,15.0,2023-03-22 17:00:00,17
575,935,1510,34,16.8,2,Partly Cloudy,9.0,2023-03-22 18:00:00,18
367,633,1000,41,14.6,2,Partly Cloudy,8.0,2023-03-22 19:00:00,19
199,437,636,48,12.8,1,Mostly Clear,9.7,2023-03-22 20:00:00,20
146,323,469,53,11.8,0,Clear,11.1,2023-03-22 21:00:00,21
104,208,312,61,11.1,1,Mostly Clear,11.8,2023-03-22 22:00:00,22
47,116,163,70,10.4,1,Mostly Clear,12.6,2023-03-22 23:00:00,23
23,34,57,76,9.8,51,Light Drizzle,13.1,2023-03-23 00:00:00,0
7,14,21,80,9.6,51,Light Drizzle,11.6,2023-03-23 01:00:00,1
4,6,10,84,9.4,51,Light Drizzle,11.9,2023-03-23 02:00:00,2
2,5,7,78,9.6,1,Mostly Clear,12.7,2023-03-23 03:00:00,3
2,14,16,83,9.2,53,Heavy Drizzle,13.9,2023-03-23 04:00:00,4
11,51,62,89,8.8,53,Heavy Drizzle,13.0,2023-03-23 05:00:00,5
60,174,234,91,8.8,53,Heavy Drizzle,9.7,2023-03-23 06:00:00,6
124,434,558,91,9.1,2,Partly Cloudy,9.9,2023-03-23 07:00:00,7
200,698,898,91,9.5,51,Light Drizzle,9.5,2023-03-23 08:00:00,8
161,409,570,90,10.6,51,Light Drizzle,11.6,2023-03-23 09:00:00,9
127,214,341,88,12.1,51,Light Drizzle,12.1,2023-03-23 10:00:00,10
180,264,444,83,13.8,3,Cloudy,13.7,2023-03-23 11:00:00,11
219,354,573,74,16.2,1,Mostly Clear,16.4,2023-03-23 12:00:00,12
280,357,637,66,18.8,1,Mostly Clear,18.3,2023-03-23 13:00:00,13
320,366,686,60,20.6,0,Clear,19.7,2023-03-23 14:00:00,14
390,507,897,52,23.4,1,Mostly Clear,20.6,2023-03-23 15:00:00,15
499,739,1238,50,24.5,1,Mostly Clear,18.9,2023-03-23 16:00:00,16
825,1066,1891,52,24.6,0,Clear,12.2,2023-03-23 17:00:00,17
793,1007,1800,57,24.1,1,Mostly Clear,5.1,2023-03-23 18:00:00,18
533,757,1290,62,22.3,2,Partly Cloudy,7.1,2023-03-23 19:00:00,19
281,474,755,65,20.6,1,Mostly Clear,9.0,2023-03-23 20:00:00,20
237,409,646,67,19.6,1,Mostly Clear,11.3,2023-03-23 21:00:00,21
200,269,469,68,18.9,2,Partly Cloudy,14.2,2023-03-23 22:00:00,22
129,159,288,69,18.4,1,Mostly Clear,11.0,2023-03-23 23:00:00,23
60,91,151,70,18.0,1,Mostly Clear,9.4,2023-03-24 00:00:00,0
31,32,63,73,17.4,1,Mostly Clear,11.2,2023-03-24 01:00:00,1
12,28,40,78,16.8,1,Mostly Clear,10.1,2023-03-24 02:00:00,2
6,16,22,87,15.9,2,Partly Cloudy,7.6,2023-03-24 03:00:00,3
8,17,25,91,14.7,1,Mostly Clear,6.4,2023-03-24 04:00:00,4
25,50,75,92,14.0,51,Light Drizzle,7.9,2023-03-24 05:00:00,5
36,131,167,92,13.7,3,Cloudy,6.8,2023-03-24 06:00:00,6
77,259,336,92,13.4,3,Cloudy,7.3,2023-03-24 07:00:00,7
97,332,429,91,13.3,51,Light Drizzle,10.1,2023-03-24 08:00:00,8
33,126,159,91,13.0,55,Heavy Drizzle,8.9,2023-03-24 09:00:00,9
40,124,164,94,12.0,63,Rain,7.6,2023-03-24 10:00:00,10
72,148,220,92,10.8,61,Light Rain,10.8,2023-03-24 11:00:00,11
104,199,303,91,10.2,61,Light Rain,10.5,2023-03-24 12:00:00,12
135,198,333,89,9.8,51,Light Drizzle,10.0,2023-03-24 13:00:00,13
115,261,376,83,9.8,51,Light Drizzle,9.9,2023-03-24 14:00:00,14
162,367,529,87,9.6,51,Light Drizzle,9.9,2023-03-24 15:00:00,15
189,407,596,88,9.1,51,Light Drizzle,9.2,2023-03-24 16:00:00,16
106,271,377,92,8.6,53,Heavy Drizzle,8.2,2023-03-24 17:00:00,17
96,251,347,93,8.4,55,Heavy Drizzle,7.1,2023-03-24 18:00:00,18
56,136,192,95,8.2,53,Heavy Drizzle,8.7,2023-03-24 19:00:00,19
24,96,120,93,8.0,53,Heavy Drizzle,9.5,2023-03-24 20:00:00,20
25,69,94,94,7.9,61,Light Rain,6.1,2023-03-24 21:00:00,21
11,51,62,93,7.9,55,Heavy Drizzle,5.2,2023-03-24 22:00:00,22
36,78,114,93,7.8,61,Light Rain,6.9,2023-03-24 23:00:00,23
53,76,129,94,7.6,61,Light Rain,8.7,2023-03-25 00:00:00,0
35,66,101,94,7.6,61,Light Rain,10.2,2023-03-25 01:00:00,1
31,35,66,95,7.5,53,Heavy Drizzle,10.2,2023-03-25 02:00:00,2
9,15,24,95,7.0,51,Light Drizzle,10.5,2023-03-25 03:00:00,3
5,13,18,96,6.8,51,Light Drizzle,10.6,2023-03-25 04:00:00,4
6,15,21,95,6.6,51,Light Drizzle,13.6,2023-03-25 05:00:00,5
32,43,75,94,6.4,3,Cloudy,10.4,2023-03-25 06:00:00,6
35,89,124,93,6.4,3,Cloudy,13.0,2023-03-25 07:00:00,7
68,156,224,92,6.5,3,Cloudy,10.1,2023-03-25 08:00:00,8
33,97,130,96,6.6,61,Light Rain,9.0,2023-03-25 09:00:00,9
58,150,208,97,7.2,61,Light Rain,14.0,2023-03-25 10:00:00,10
123,212,335,96,8.1,55,Heavy Drizzle,13.8,2023-03-25 11:00:00,11
102,220,322,97,9.3,53,Heavy Drizzle,10.8,2023-03-25 12:00:00,12
206,238,444,97,10.1,53,Heavy Drizzle,9.0,2023-03-25 13:00:00,13
282,318,600,95,12.0,3,Cloudy,7.7,2023-03-25 14:00:00,14
240,348,588,90,11.0,3,Cloudy,7.9,2023-03-25 15:00:00,15
325,357,682,88,12.3,3,Cloudy,8.8,2023-03-25 16:00:00,16
350,390,740,82,14.8,3,Cloudy,13.0,2023-03-25 17:00:00,17
362,404,766,81,16.0,3,Cloudy,9.8,2023-03-25 18:00:00,18
292,346,638,85,15.7,3,Cloudy,6.3,2023-03-25 19:00:00,19
136,233,369,90,14.7,2,Partly Cloudy,3.5,2023-03-25 20:00:00,20
134,189,323,91,14.3,1,Mostly Clear,2.7,2023-03-25 21:00:00,21
144,190,334,87,14.7,1,Mostly Clear,1.8,2023-03-25 22:00:00,22
102,174,276,83,14.9,1,Mostly Clear,10.0,2023-03-25 23:00:00,23
81,128,209,85,13.8,0,Clear,10.2,2023-03-26 00:00:00,0
72,95,167,82,12.4,0,Clear,11.6,2023-03-26 01:00:00,1
54,69,123,64,11.9,0,Clear,14.7,2023-03-26 02:00:00,2
22,22,44,77,10.5,0,Clear,16.6,2023-03-26 03:00:00,3
9,14,23,72,10.0,0,Clear,16.1,2023-03-26 04:00:00,4
17,19,36,68,9.4,0,Clear,15.2,2023-03-26 05:00:00,5
92,59,151,64,8.7,0,Clear,13.6,2023-03-26 06:00:00,6
119,115,234,60,8.0,0,Clear,12.0,2023-03-26 07:00:00,7
252,236,488,59,7.8,0,Clear,13.2,2023-03-26 08:00:00,8
403,332,735,53,9.0,0,Clear,12.7,2023-03-26 09:00:00,9
639,476,1115,48,10.2,0,Clear,16.3,2023-03-26 10:00:00,10
741,510,1251,44,11.8,0,Clear,14.7,2023-03-26 11:00:00,11
930,591,1521,40,13.5,0,Clear,15.9,2023-03-26 12:00:00,12
1123,651,1774,37,15.0,0,Clear,16.5,2023-03-26 13:00:00,13
1141,639,1780,34,16.3,0,Clear,15.8,2023-03-26 14:00:00,14
1206,660,1866,32,18.0,0,Clear,13.8,2023-03-26 15:00:00,15
1038,624,1662,31,18.6,0,Clear,12.6,2023-03-26 16:00:00,16
1003,593,1596,32,18.7,0,Clear,11.2,2023-03-26 17:00:00,17
814,660,1474,37,18.0,0,Clear,6.1,2023-03-26 18:00:00,18
639,454,1093,53,16.5,0,Clear,2.1,2023-03-26 19:00:00,19
306,306,612,60,13.3,0,Clear,4.8,2023-03-26 20:00:00,20
171,174,345,68,11.0,0,Clear,5.9,2023-03-26 21:00:00,21
90,155,245,71,9.9,0,Clear,5.4,2023-03-26 22:00:00,22
58,68,126,74,9.0,0,Clear,6.1,2023-03-26 23:00:00,23
14,32,46,76,8.4,0,Clear,2.1,2023-03-27 00:00:00,0
6,15,21,83,6.9,0,Clear,5.2,2023-03-27 01:00:00,1
4,8,12,88,5.7,1,Mostly Clear,6.7,2023-03-27 02:00:00,2
3,9,12,85,5.8,1,Mostly Clear,6.4,2023-03-27 03:00:00,3
8,15,23,88,5.5,1,Mostly Clear,8.4,2023-03-27 04:00:00,4
18,40,58,92,5.6,1,Mostly Clear,8.4,2023-03-27 05:00:00,5
74,173,247,94,5.8,1,Mostly Clear,10.2,2023-03-27 06:00:00,6
105,372,477,96,5.8,0,Clear,8.9,2023-03-27 07:00:00,7
206,622,828,96,6.9,0,Clear,10.0,2023-03-27 08:00:00,8
175,376,551,88,10.5,1,Mostly Clear,7.2,2023-03-27 09:00:00,9
179,230,409,81,13.1,2,Partly Cloudy,8.3,2023-03-27 10:00:00,10
260,247,507,77,14.6,2,Partly Cloudy,10.8,2023-03-27 11:00:00,11
213,363,576,74,15.9,53,Heavy Drizzle,12.8,2023-03-27 12:00:00,12
205,290,495,75,16.7,51,Light Drizzle,12.8,2023-03-27 13:00:00,13
175,235,410,76,16.7,3,Cloudy,6.9,2023-03-27 14:00:00,14
200,358,558,86,14.4,3,Cloudy,9.2,2023-03-27 15:00:00,15
296,504,800,86,14.6,3,Cloudy,7.7,2023-03-27 16:00:00,16
433,798,1231,85,14.9,3,Cloudy,4.4,2023-03-27 17:00:00,17
423,724,1147,83,15.5,3,Cloudy,4.6,2023-03-27 18:00:00,18
289,537,826,84,15.3,0,Clear,4.1,2023-03-27 19:00:00,19
160,323,483,89,14.0,0,Clear,1.8,2023-03-27 20:00:00,20
135,268,403,86,13.3,0,Clear,3.3,2023-03-27 21:00:00,21
144,175,319,72,13.0,0,Clear,8.1,2023-03-27 22:00:00,22
55,85,140,70,12.0,0,Clear,11.8,2023-03-27 23:00:00,23
18,31,49,72,11.0,0,Clear,11.8,2023-03-28 00:00:00,0
8,14,22,73,10.1,0,Clear,11.1,2023-03-28 01:00:00,1
4,7,11,74,9.4,0,Clear,12.1,2023-03-28 02:00:00,2
4,5,9,79,8.6,0,Clear,12.4,2023-03-28 03:00:00,3
6,17,23,81,7.9,0,Clear,12.5,2023-03-28 04:00:00,4
17,57,74,84,7.3,0,Clear,12.3,2023-03-28 05:00:00,5
54,166,220,86,6.8,1,Mostly Clear,6.0,2023-03-28 06:00:00,6
129,459,588,87,6.6,3,Cloudy,10.2,2023-03-28 07:00:00,7
279,818,1097,83,7.2,3,Cloudy,11.2,2023-03-28 08:00:00,8
180,459,639,71,8.6,3,Cloudy,9.7,2023-03-28 09:00:00,9
158,230,388,65,9.3,1,Mostly Clear,13.9,2023-03-28 10:00:00,10
202,266,468,60,9.8,1,Mostly Clear,15.3,2023-03-28 11:00:00,11
213,319,532,57,10.6,2,Partly Cloudy,15.3,2023-03-28 12:00:00,12
228,304,532,53,11.5,3,Cloudy,13.8,2023-03-28 13:00:00,13
296,355,651,46,12.6,3,Cloudy,12.8,2023-03-28 14:00:00,14
299,471,770,44,13.5,3,Cloudy,12.8,2023-03-28 15:00:00,15
354,610,964,42,13.6,2,Partly Cloudy,10.4,2023-03-28 16:00:00,16
518,1028,1546,40,13.7,3,Cloudy,8.6,2023-03-28 17:00:00,17
488,889,1377,41,13.3,2,Partly Cloudy,9.0,2023-03-28 18:00:00,18
323,605,928,48,12.4,0,Clear,6.2,2023-03-28 19:00:00,19
172,386,558,53,10.7,1,Mostly Clear,7.8,2023-03-28 20:00:00,20
167,309,476,56,9.5,1,Mostly Clear,10.2,2023-03-28 21:00:00,21
95,148,243,59,8.4,2,Partly Cloudy,9.2,2023-03-28 22:00:00,22
50,87,137,62,7.6,2,Partly Cloudy,7.6,2023-03-28 23:00:00,23
15,31,46,73,6.5,2,Partly Cloudy,6.3,2023-03-29 00:00:00,0
6,18,24,75,6.4,2,Partly Cloudy,1.9,2023-03-29 01:00:00,1
2,11,13,73,6.5,2,Partly Cloudy,6.9,2023-03-29 02:00:00,2
7,11,18,70,6.5,2,Partly Cloudy,8.3,2023-03-29 03:00:00,3
4,11,15,72,6.0,2,Partly Cloudy,7.9,2023-03-29 04:00:00,4
22,53,75,78,4.9,0,Clear,7.6,2023-03-29 05:00:00,5
55,171,226,82,4.1,0,Clear,5.7,2023-03-29 06:00:00,6
128,490,618,86,3.2,0,Clear,5.6,2023-03-29 07:00:00,7
283,830,1113,85,4.3,0,Clear,5.6,2023-03-29 08:00:00,8
171,423,594,71,7.4,0,Clear,3.9,2023-03-29 09:00:00,9
175,255,430,60,9.5,0,Clear,2.7,2023-03-29 10:00:00,10
207,275,482,51,11.1,0,Clear,1.3,2023-03-29 11:00:00,11
231,377,608,44,12.6,2,Partly Cloudy,4.7,2023-03-29 12:00:00,12
252,340,592,39,13.6,1,Mostly Clear,6.4,2023-03-29 13:00:00,13
263,335,598,35,14.2,2,Partly Cloudy,8.4,2023-03-29 14:00:00,14
309,456,765,33,14.4,3,Cloudy,11.5,2023-03-29 15:00:00,15
384,598,982,31,14.3,3,Cloudy,13.6,2023-03-29 16:00:00,16
504,1013,1517,34,13.8,2,Partly Cloudy,11.3,2023-03-29 17:00:00,17
514,933,1447,38,13.5,0,Clear,10.2,2023-03-29 18:00:00,18
371,630,1001,44,12.1,0,Clear,6.5,2023-03-29 19:00:00,19
203,428,631,50,10.3,0,Clear,10.0,2023-03-29 20:00:00,20
157,313,470,56,9.0,0,Clear,11.3,2023-03-29 21:00:00,21
122,219,341,63,7.9,0,Clear,11.7,2023-03-29 22:00:00,22
46,103,149,69,6.7,1,Mostly Clear,10.7,2023-03-29 23:00:00,23
26,40,66,62,6.3,0,Clear,12.9,2023-03-30 00:00:00,0
10,11,21,53,6.5,0,Clear,18.2,2023-03-30 01:00:00,1
4,10,14,58,5.8,0,Clear,16.8,2023-03-30 02:00:00,2
3,7,10,61,5.6,0,Clear,15.1,2023-03-30 03:00:00,3
2,7,9,60,4.8,0,Clear,13.9,2023-03-30 04:00:00,4
24,45,69,58,4.0,0,Clear,12.9,2023-03-30 05:00:00,5
42,137,179,56,3.1,0,Clear,9.5,2023-03-30 06:00:00,6
90,394,484,57,2.3,0,Clear,7.5,2023-03-30 07:00:00,7
199,696,895,57,2.3,0,Clear,7.2,2023-03-30 08:00:00,8
181,467,648,47,3.3,0,Clear,9.4,2023-03-30 09:00:00,9
152,252,404,44,4.3,0,Clear,8.7,2023-03-30 10:00:00,10
176,324,500,41,5.7,0,Clear,8.2,2023-03-30 11:00:00,11
212,356,568,39,7.2,0,Clear,8.2,2023-03-30 12:00:00,12
185,309,494,37,8.7,0,Clear,8.3,2023-03-30 13:00:00,13
263,285,548,35,9.9,0,Clear,8.7,2023-03-30 14:00:00,14
299,475,774,35,10.8,0,Clear,8.9,2023-03-30 15:00:00,15
394,551,945,34,11.5,0,Clear,9.2,2023-03-30 16:00:00,16
496,843,1339,34,11.7,0,Clear,7.0,2023-03-30 17:00:00,17
442,813,1255,35,11.5,0,Clear,4.9,2023-03-30 18:00:00,18
357,566,923,41,10.5,0,Clear,2.2,2023-03-30 19:00:00,19
178,419,597,48,8.5,0,Clear,6.6,2023-03-30 20:00:00,20
148,317,465,53,7.0,0,Clear,9.2,2023-03-30 21:00:00,21
89,234,323,60,5.9,0,Clear,9.4,2023-03-30 22:00:00,22
50,104,154,66,5.2,0,Clear,9.7,2023-03-30 23:00:00,23
23,56,79,71,4.6,0,Clear,9.0,2023-03-31 00:00:00,0
18,31,49,75,4.1,0,Clear,10.0,2023-03-31 01:00:00,1
7,16,23,78,3.7,0,Clear,9.9,2023-03-31 02:00:00,2
1,9,10,82,3.5,0,Clear,10.2,2023-03-31 03:00:00,3
1,13,14,86,3.6,0,Clear,10.8,2023-03-31 04:00:00,4
18,47,65,88,3.8,1,Mostly Clear,11.1,2023-03-31 05:00:00,5
43,145,188,90,4.0,1,Mostly Clear,11.1,2023-03-31 06:00:00,6
88,327,415,90,4.4,1,Mostly Clear,10.8,2023-03-31 07:00:00,7
172,487,659,87,5.6,1,Mostly Clear,12.1,2023-03-31 08:00:00,8
185,374,559,79,7.7,2,Partly Cloudy,11.3,2023-03-31 09:00:00,9
209,272,481,74,9.8,2,Partly Cloudy,13.0,2023-03-31 10:00:00,10
269,301,570,70,11.8,3,Cloudy,13.8,2023-03-31 11:00:00,11
308,365,673,66,14.0,2,Partly Cloudy,15.0,2023-03-31 12:00:00,12
385,355,740,60,16.3,3,Cloudy,15.9,2023-03-31 13:00:00,13
413,377,790,56,17.7,3,Cloudy,17.1,2023-03-31 14:00:00,14
403,506,909,53,18.6,3,Cloudy,19.2,2023-03-31 15:00:00,15
442,559,1001,51,19.1,3,Cloudy,20.3,2023-03-31 16:00:00,16
502,787,1289,54,18.0,3,Cloudy,18.8,2023-03-31 17:00:00,17
409,729,1138,59,16.9,3,Cloudy,18.5,2023-03-31 18:00:00,18
271,536,807,72,14.8,53,Heavy Drizzle,19.9,2023-03-31 19:00:00,19
177,314,491,83,13.4,53,Heavy Drizzle,22.0,2023-03-31 20:00:00,20
143,248,391,89,13.4,53,Heavy Drizzle,19.7,2023-03-31 21:00:00,21
153,162,315,90,13.9,3,Cloudy,21.0,2023-03-31 22:00:00,22
119,161,280,90,14.5,3,Cloudy,22.2,2023-03-31 23:00:00,23
113,139,252,91,14.9,2,Partly Cloudy,22.1,2023-04-01 00:00:00,0
71,67,138,91,15.1,2,Partly Cloudy,23.1,2023-04-01 01:00:00,1
34,42,76,90,15.2,2,Partly Cloudy,23.4,2023-04-01 02:00:00,2
14,22,36,91,15.3,53,Heavy Drizzle,25.6,2023-04-01 03:00:00,3
7,18,25,93,15.7,51,Light Drizzle,27.1,2023-04-01 04:00:00,4
13,36,49,93,15.9,2,Partly Cloudy,27.1,2023-04-01 05:00:00,5
27,41,68,92,16.1,3,Cloudy,27.3,2023-04-01 06:00:00,6
26,89,115,88,16.3,51,Light Drizzle,25.5,2023-04-01 07:00:00,7
57,134,191,85,16.7,51,Light Drizzle,25.5,2023-04-01 08:00:00,8
73,189,262,81,17.4,51,Light Drizzle,24.2,2023-04-01 09:00:00,9
66,150,216,73,19.0,3,Cloudy,20.1,2023-04-01 10:00:00,10
62,143,205,68,20.3,51,Light Drizzle,19.9,2023-04-01 11:00:00,11
289,294,583,61,22.0,2,Partly Cloudy,15.1,2023-04-01 12:00:00,12
546,502,1048,64,21.7,61,Light Rain,19.9,2023-04-01 13:00:00,13
784,596,1380,61,22.8,51,Light Drizzle,22.2,2023-04-01 14:00:00,14
860,584,1444,61,22.7,51,Light Drizzle,24.1,2023-04-01 15:00:00,15
822,568,1390,46,23.5,51,Light Drizzle,24.4,2023-04-01 16:00:00,16
721,478,1199,42,23.3,1,Mostly Clear,21.4,2023-04-01 17:00:00,17
486,484,970,44,21.9,1,Mostly Clear,16.6,2023-04-01 18:00:00,18
318,333,651,44,20.1,51,Light Drizzle,18.7,2023-04-01 19:00:00,19
189,227,416,43,16.6,1,Mostly Clear,32.4,2023-04-01 20:00:00,20
103,134,237,46,13.7,2,Partly Cloudy,31.8,2023-04-01 21:00:00,21
64,141,205,47,11.4,0,Clear,30.2,2023-04-01 22:00:00,22
85,139,224,49,10.0,0,Clear,28.8,2023-04-01 23:00:00,23
72,99,171,49,9.2,0,Clear,25.0,2023-04-02 00:00:00,0
42,77,119,49,8.7,0,Clear,23.1,2023-04-02 01:00:00,1
29,39,68,50,8.4,1,Mostly Clear,21.7,2023-04-02 02:00:00,2
19,23,42,54,7.8,1,Mostly Clear,22.6,2023-04-02 03:00:00,3
10,21,31,56,7.6,1,Mostly Clear,23.0,2023-04-02 04:00:00,4
11,25,36,58,7.2,0,Clear,21.7,2023-04-02 05:00:00,5
265,243,508,58,6.7,0,Clear,18.8,2023-04-02 06:00:00,6
147,183,330,58,6.0,0,Clear,17.6,2023-04-02 07:00:00,7
160,189,349,57,5.7,0,Clear,19.2,2023-04-02 08:00:00,8
274,288,562,53,6.0,1,Mostly Clear,20.8,2023-04-02 09:00:00,9
410,367,777,49,6.9,0,Clear,20.0,2023-04-02 10:00:00,10
442,433,875,45,8.2,0,Clear,18.1,2023-04-02 11:00:00,11
570,499,1069,41,9.5,0,Clear,16.8,2023-04-02 12:00:00,12
554,495,1049,37,10.8,0,Clear,15.0,2023-04-02 13:00:00,13
568,454,1022,35,11.8,0,Clear,13.8,2023-04-02 14:00:00,14
594,503,1097,36,12.7,0,Clear,12.7,2023-04-02 15:00:00,15
643,532,1175,34,13.1,0,Clear,12.0,2023-04-02 16:00:00,16
551,532,1083,33,13.1,0,Clear,11.5,2023-04-02 17:00:00,17
491,448,939,33,12.7,0,Clear,9.7,2023-04-02 18:00:00,18
283,346,629,38,11.8,0,Clear,5.9,2023-04-02 19:00:00,19
160,249,409,51,10.2,0,Clear,5.6,2023-04-02 20:00:00,20
115,165,280,60,8.1,0,Clear,5.9,2023-04-02 21:00:00,21
60,116,176,66,6.7,0,Clear,5.8,2023-04-02 22:00:00,22
49,71,120,70,5.7,0,Clear,7.2,2023-04-02 23:00:00,23
11,30,41,72,5.1,0,Clear,8.3,2023-04-03 00:00:00,0
8,9,17,76,4.7,0,Clear,7.4,2023-04-03 01:00:00,1
6,7,13,79,4.4,0,Clear,9.4,2023-04-03 02:00:00,2
5,5,10,82,4.4,0,Clear,10.0,2023-04-03 03:00:00,3
5,9,14,87,4.2,0,Clear,9.4,2023-04-03 04:00:00,4
22,47,69,90,3.9,0,Clear,9.1,2023-04-03 05:00:00,5
39,156,195,92,3.8,0,Clear,6.9,2023-04-03 06:00:00,6
102,359,461,93,3.7,1,Mostly Clear,8.2,2023-04-03 07:00:00,7
208,604,812,90,5.6,1,Mostly Clear,9.3,2023-04-03 08:00:00,8
217,413,630,76,9.4,1,Mostly Clear,11.7,2023-04-03 09:00:00,9
263,270,533,70,11.6,0,Clear,14.5,2023-04-03 10:00:00,10
289,279,568,65,13.8,1,Mostly Clear,14.2,2023-04-03 11:00:00,11
343,354,697,59,15.8,0,Clear,15.4,2023-04-03 12:00:00,12
323,326,649,54,17.6,0,Clear,16.7,2023-04-03 13:00:00,13
370,301,671,50,18.9,1,Mostly Clear,18.1,2023-04-03 14:00:00,14
392,439,831,47,19.8,1,Mostly Clear,19.0,2023-04-03 15:00:00,15
483,586,1069,45,20.4,1,Mostly Clear,19.0,2023-04-03 16:00:00,16
537,991,1528,46,20.4,1,Mostly Clear,17.9,2023-04-03 17:00:00,17
541,860,1401,50,19.7,1,Mostly Clear,8.8,2023-04-03 18:00:00,18
374,601,975,56,18.0,1,Mostly Clear,10.0,2023-04-03 19:00:00,19
229,371,600,63,16.0,1,Mostly Clear,11.6,2023-04-03 20:00:00,20
161,317,478,66,15.0,2,Partly Cloudy,12.0,2023-04-03 21:00:00,21
122,173,295,65,15.0,1,Mostly Clear,13.4,2023-04-03 22:00:00,22
53,124,177,64,14.9,0,Clear,13.0,2023-04-03 23:00:00,23
40,47,87,65,14.6,0,Clear,12.2,2023-04-04 00:00:00,0
12,11,23,68,13.9,0,Clear,13.4,2023-04-04 01:00:00,1
6,12,18,72,13.2,0,Clear,14.0,2023-04-04 02:00:00,2
2,17,19,71,13.3,0,Clear,13.6,2023-04-04 03:00:00,3
2,20,22,76,12.8,0,Clear,12.2,2023-04-04 04:00:00,4
22,72,94,81,12.1,0,Clear,10.8,2023-04-04 05:00:00,5
65,193,258,85,11.5,0,Clear,10.6,2023-04-04 06:00:00,6
111,451,562,88,10.9,0,Clear,10.8,2023-04-04 07:00:00,7
270,848,1118,87,11.8,0,Clear,10.6,2023-04-04 08:00:00,8
255,476,731,76,14.8,0,Clear,9.5,2023-04-04 09:00:00,9
282,274,556,69,17.0,0,Clear,10.9,2023-04-04 10:00:00,10
330,273,603,64,19.1,0,Clear,10.5,2023-04-04 11:00:00,11
312,345,657,60,20.9,0,Clear,9.3,2023-04-04 12:00:00,12
371,363,734,57,22.5,0,Clear,9.2,2023-04-04 13:00:00,13
452,346,798,54,23.7,0,Clear,10.7,2023-04-04 14:00:00,14
494,465,959,49,25.0,0,Clear,12.1,2023-04-04 15:00:00,15
497,635,1132,48,25.3,1,Mostly Clear,13.0,2023-04-04 16:00:00,16
791,1174,1965,48,25.3,0,Clear,10.1,2023-04-04 17:00:00,17
781,1022,1803,53,24.5,0,Clear,6.3,2023-04-04 18:00:00,18
505,659,1164,60,22.7,0,Clear,6.0,2023-04-04 19:00:00,19
255,489,744,71,20.1,0,Clear,9.8,2023-04-04 20:00:00,20
237,394,631,80,18.4,0,Clear,10.4,2023-04-04 21:00:00,21
171,266,437,86,17.3,1,Mostly Clear,9.9,2023-04-04 22:00:00,22
72,117,189,90,16.5,1,Mostly Clear,9.3,2023-04-04 23:00:00,23
45,48,93,92,16.1,1,Mostly Clear,9.8,2023-04-05 00:00:00,0
13,22,35,92,15.8,0,Clear,9.0,2023-04-05 01:00:00,1
6,12,18,92,15.5,0,Clear,9.4,2023-04-05 02:00:00,2
4,9,13,92,15.8,0,Clear,9.4,2023-04-05 03:00:00,3
5,15,20,93,15.4,0,Clear,8.7,2023-04-05 04:00:00,4
24,61,85,95,15.0,0,Clear,9.5,2023-04-05 05:00:00,5
62,184,246,96,14.7,0,Clear,6.6,2023-04-05 06:00:00,6
146,464,610,96,14.6,0,Clear,7.5,2023-04-05 07:00:00,7
312,821,1133,93,15.8,1,Mostly Clear,8.9,2023-04-05 08:00:00,8
246,497,743,84,18.6,1,Mostly Clear,8.2,2023-04-05 09:00:00,9
297,288,585,77,21.2,1,Mostly Clear,10.1,2023-04-05 10:00:00,10
309,295,604,70,23.5,1,Mostly Clear,11.6,2023-04-05 11:00:00,11
345,422,767,64,25.4,1,Mostly Clear,13.7,2023-04-05 12:00:00,12
370,380,750,59,26.8,1,Mostly Clear,15.9,2023-04-05 13:00:00,13
393,386,779,55,27.7,1,Mostly Clear,18.4,2023-04-05 14:00:00,14
451,464,915,49,28.8,1,Mostly Clear,19.5,2023-04-05 15:00:00,15
511,639,1150,46,28.9,1,Mostly Clear,20.1,2023-04-05 16:00:00,16
758,1081,1839,48,28.5,1,Mostly Clear,16.6,2023-04-05 17:00:00,17
645,883,1528,52,27.4,2,Partly Cloudy,14.4,2023-04-05 18:00:00,18
469,675,1144,57,25.6,1,Mostly Clear,12.1,2023-04-05 19:00:00,19
303,507,810,61,24.0,1,Mostly Clear,13.8,2023-04-05 20:00:00,20
257,325,582,64,23.1,1,Mostly Clear,14.9,2023-04-05 21:00:00,21
198,278,476,65,22.7,1,Mostly Clear,16.2,2023-04-05 22:00:00,22
78,110,188,67,22.5,1,Mostly Clear,16.8,2023-04-05 23:00:00,23
33,69,102,68,22.3,1,Mostly Clear,16.9,2023-04-06 00:00:00,0
16,30,46,68,22.2,1,Mostly Clear,14.5,2023-04-06 01:00:00,1
5,19,24,69,21.9,1,Mostly Clear,10.9,2023-04-06 02:00:00,2
5,10,15,74,20.8,1,Mostly Clear,8.9,2023-04-06 03:00:00,3
10,16,26,78,19.8,2,Partly Cloudy,7.4,2023-04-06 04:00:00,4
24,62,86,84,18.8,2,Partly Cloudy,7.4,2023-04-06 05:00:00,5
65,186,251,88,17.9,2,Partly Cloudy,6.9,2023-04-06 06:00:00,6
133,427,560,91,17.1,2,Partly Cloudy,5.5,2023-04-06 07:00:00,7
246,840,1086,90,18.2,1,Mostly Clear,4.8,2023-04-06 08:00:00,8
250,511,761,78,21.2,2,Partly Cloudy,5.0,2023-04-06 09:00:00,9
272,278,550,74,22.6,1,Mostly Clear,5.7,2023-04-06 10:00:00,10
311,341,652,68,24.3,1,Mostly Clear,6.4,2023-04-06 11:00:00,11
324,385,709,59,26.4,0,Clear,7.2,2023-04-06 12:00:00,12
360,383,743,55,27.8,1,Mostly Clear,8.1,2023-04-06 13:00:00,13
323,362,685,54,28.5,1,Mostly Clear,7.9,2023-04-06 14:00:00,14
360,484,844,49,29.0,1,Mostly Clear,8.0,2023-04-06 15:00:00,15
461,589,1050,49,29.1,1,Mostly Clear,5.8,2023-04-06 16:00:00,16
573,970,1543,52,28.0,53,Heavy Drizzle,6.6,2023-04-06 17:00:00,17
297,583,880,83,22.9,63,Rain,8.2,2023-04-06 18:00:00,18
171,333,504,87,19.9,63,Rain,16.8,2023-04-06 19:00:00,19
119,277,396,83,17.7,53,Heavy Drizzle,17.1,2023-04-06 20:00:00,20
130,262,392,77,16.7,51,Light Drizzle,13.7,2023-04-06 21:00:00,21
113,195,308,68,16.1,2,Partly Cloudy,13.0,2023-04-06 22:00:00,22
87,143,230,56,15.4,1,Mostly Clear,13.8,2023-04-06 23:00:00,23
47,85,132,47,14.6,1,Mostly Clear,14.0,2023-04-07 00:00:00,0
22,46,68,43,14.0,1,Mostly Clear,14.5,2023-04-07 01:00:00,1
13,21,34,41,13.6,0,Clear,13.8,2023-04-07 02:00:00,2
11,22,33,44,12.9,1,Mostly Clear,13.4,2023-04-07 03:00:00,3
5,29,34,41,12.5,1,Mostly Clear,13.2,2023-04-07 04:00:00,4
19,55,74,39,12.3,2,Partly Cloudy,13.0,2023-04-07 05:00:00,5
58,166,224,36,12.2,2,Partly Cloudy,9.0,2023-04-07 06:00:00,6
99,312,411,35,11.9,3,Cloudy,8.9,2023-04-07 07:00:00,7
178,436,614,35,11.8,3,Cloudy,11.2,2023-04-07 08:00:00,8
209,394,603,35,11.5,2,Partly Cloudy,11.4,2023-04-07 09:00:00,9
206,238,444,38,11.1,3,Cloudy,10.6,2023-04-07 10:00:00,10
190,237,427,39,10.8,51,Light Drizzle,10.2,2023-04-07 11:00:00,11
229,255,484,44,10.6,2,Partly Cloudy,7.9,2023-04-07 12:00:00,12
363,343,706,44,11.1,3,Cloudy,8.7,2023-04-07 13:00:00,13
385,376,761,40,12.4,3,Cloudy,7.5,2023-04-07 14:00:00,14
428,461,889,41,12.5,3,Cloudy,7.4,2023-04-07 15:00:00,15
416,527,943,40,12.6,3,Cloudy,6.5,2023-04-07 16:00:00,16
501,668,1169,42,12.4,3,Cloudy,6.9,2023-04-07 17:00:00,17
361,567,928,48,12.1,3,Cloudy,6.1,2023-04-07 18:00:00,18
385,495,880,52,11.7,3,Cloudy,5.5,2023-04-07 19:00:00,19
202,284,486,57,11.1,3,Cloudy,6.5,2023-04-07 20:00:00,20
143,250,393,61,10.6,3,Cloudy,6.6,2023-04-07 21:00:00,21
132,195,327,65,10.1,2,Partly Cloudy,7.0,2023-04-07 22:00:00,22
101,215,316,67,9.7,1,Mostly Clear,6.9,2023-04-07 23:00:00,23
82,125,207,65,9.3,1,Mostly Clear,6.2,2023-04-08 00:00:00,0
86,112,198,56,9.1,1,Mostly Clear,8.9,2023-04-08 01:00:00,1
59,65,124,46,8.9,1,Mostly Clear,13.2,2023-04-08 02:00:00,2
19,31,50,39,8.4,1,Mostly Clear,14.0,2023-04-08 03:00:00,3
10,16,26,38,8.2,1,Mostly Clear,14.1,2023-04-08 04:00:00,4
8,20,28,41,7.7,1,Mostly Clear,13.7,2023-04-08 05:00:00,5
25,60,85,44,7.2,1,Mostly Clear,12.1,2023-04-08 06:00:00,6
56,119,175,48,6.7,1,Mostly Clear,13.7,2023-04-08 07:00:00,7
145,208,353,50,6.6,1,Mostly Clear,14.5,2023-04-08 08:00:00,8
261,304,565,49,6.9,1,Mostly Clear,13.8,2023-04-08 09:00:00,9
394,373,767,48,7.7,1,Mostly Clear,12.5,2023-04-08 10:00:00,10
557,443,1000,45,9.0,1,Mostly Clear,11.5,2023-04-08 11:00:00,11
602,457,1059,43,10.0,1,Mostly Clear,11.0,2023-04-08 12:00:00,12
640,492,1132,41,10.8,1,Mostly Clear,9.2,2023-04-08 13:00:00,13
664,514,1178,40,11.1,1,Mostly Clear,9.5,2023-04-08 14:00:00,14
616,515,1131,38,10.9,1,Mostly Clear,8.4,2023-04-08 15:00:00,15
564,559,1123,37,10.9,1,Mostly Clear,7.4,2023-04-08 16:00:00,16
514,469,983,38,10.5,1,Mostly Clear,7.2,2023-04-08 17:00:00,17
375,419,794,38,10.1,1,Mostly Clear,5.8,2023-04-08 18:00:00,18
243,328,571,41,9.6,1,Mostly Clear,5.1,2023-04-08 19:00:00,19
177,271,448,48,8.9,1,Mostly Clear,5.5,2023-04-08 20:00:00,20
124,232,356,58,8.0,1,Mostly Clear,5.6,2023-04-08 21:00:00,21
132,228,360,67,7.2,1,Mostly Clear,5.0,2023-04-08 22:00:00,22
104,145,249,70,6.8,1,Mostly Clear,4.0,2023-04-08 23:00:00,23
67,118,185,73,6.3,1,Mostly Clear,4.7,2023-04-09 00:00:00,0
48,79,127,77,5.7,1,Mostly Clear,5.9,2023-04-09 01:00:00,1
32,47,79,80,5.3,1,Mostly Clear,6.4,2023-04-09 02:00:00,2
16,17,33,78,5.1,1,Mostly Clear,6.9,2023-04-09 03:00:00,3
12,19,31,75,5.6,0,Clear,5.4,2023-04-09 04:00:00,4
27,14,41,80,4.6,0,Clear,4.7,2023-04-09 05:00:00,5
39,60,99,87,3.4,0,Clear,5.5,2023-04-09 06:00:00,6
46,99,145,91,2.8,0,Clear,5.4,2023-04-09 07:00:00,7
85,143,228,86,5.0,0,Clear,6.2,2023-04-09 08:00:00,8
177,268,445,64,8.6,0,Clear,4.7,2023-04-09 09:00:00,9
297,349,646,53,10.4,0,Clear,5.1,2023-04-09 10:00:00,10
440,422,862,44,11.8,0,Clear,6.4,2023-04-09 11:00:00,11
549,467,1016,40,12.9,0,Clear,6.9,2023-04-09 12:00:00,12
587,436,1023,38,13.8,0,Clear,6.9,2023-04-09 13:00:00,13
690,486,1176,36,14.4,0,Clear,6.5,2023-04-09 14:00:00,14
696,509,1205,33,14.8,0,Clear,6.1,2023-04-09 15:00:00,15
619,498,1117,32,15.1,1,Mostly Clear,6.3,2023-04-09 16:00:00,16
545,464,1009,32,14.9,1,Mostly Clear,6.8,2023-04-09 17:00:00,17
489,396,885,34,14.2,0,Clear,7.2,2023-04-09 18:00:00,18
246,359,605,41,12.8,0,Clear,7.5,2023-04-09 19:00:00,19
123,207,330,46,10.9,0,Clear,6.4,2023-04-09 20:00:00,20
131,183,314,51,9.6,0,Clear,6.7,2023-04-09 21:00:00,21
64,144,208,58,8.4,0,Clear,7.8,2023-04-09 22:00:00,22
37,64,101,65,7.4,0,Clear,10.4,2023-04-09 23:00:00,23
13,31,44,72,6.6,0,Clear,10.3,2023-04-10 00:00:00,0
10,12,22,79,5.8,0,Clear,8.4,2023-04-10 01:00:00,1
12,12,24,86,4.9,0,Clear,6.6,2023-04-10 02:00:00,2
3,10,13,87,4.5,0,Clear,6.9,2023-04-10 03:00:00,3
8,16,24,88,3.9,0,Clear,7.2,2023-04-10 04:00:00,4
22,66,88,89,3.5,0,Clear,6.9,2023-04-10 05:00:00,5
38,151,189,89,3.3,0,Clear,8.2,2023-04-10 06:00:00,6
92,351,443,88,3.1,0,Clear,7.9,2023-04-10 07:00:00,7
152,595,747,86,5.2,0,Clear,6.5,2023-04-10 08:00:00,8
165,403,568,62,9.1,0,Clear,5.8,2023-04-10 09:00:00,9
231,261,492,50,11.3,0,Clear,6.4,2023-04-10 10:00:00,10
257,279,536,44,13.2,0,Clear,5.4,2023-04-10 11:00:00,11
272,353,625,39,14.8,0,Clear,4.1,2023-04-10 12:00:00,12
302,391,693,36,15.9,0,Clear,3.2,2023-04-10 13:00:00,13
337,369,706,34,16.6,0,Clear,3.6,2023-04-10 14:00:00,14
409,454,863,31,17.3,0,Clear,4.7,2023-04-10 15:00:00,15
406,517,923,31,17.4,0,Clear,5.8,2023-04-10 16:00:00,16
541,930,1471,31,17.2,0,Clear,6.9,2023-04-10 17:00:00,17
494,830,1324,33,16.6,0,Clear,5.2,2023-04-10 18:00:00,18
318,609,927,41,14.9,0,Clear,7.1,2023-04-10 19:00:00,19
202,427,629,48,12.7,0,Clear,9.7,2023-04-10 20:00:00,20
133,305,438,54,11.2,0,Clear,10.7,2023-04-10 21:00:00,21
82,175,257,60,10.1,0,Clear,11.5,2023-04-10 22:00:00,22
42,75,117,66,9.2,0,Clear,12.1,2023-04-10 23:00:00,23
23,35,58,69,8.5,0,Clear,11.6,2023-04-11 00:00:00,0
9,19,28,70,7.9,0,Clear,10.9,2023-04-11 01:00:00,1
10,9,19,72,7.3,0,Clear,10.2,2023-04-11 02:00:00,2
3,12,15,71,6.9,0,Clear,9.7,2023-04-11 03:00:00,3
7,23,30,74,6.2,0,Clear,8.9,2023-04-11 04:00:00,4
17,76,93,78,5.5,0,Clear,8.4,2023-04-11 05:00:00,5
53,208,261,81,4.8,0,Clear,7.9,2023-04-11 06:00:00,6
120,506,626,85,4.3,0,Clear,7.2,2023-04-11 07:00:00,7
264,849,1113,82,6.7,0,Clear,7.6,2023-04-11 08:00:00,8
183,522,705,63,10.7,0,Clear,6.0,2023-04-11 09:00:00,9
185,293,478,56,13.6,0,Clear,5.5,2023-04-11 10:00:00,10
219,301,520,49,16.6,1,Mostly Clear,6.0,2023-04-11 11:00:00,11
248,385,633,41,19.3,0,Clear,7.4,2023-04-11 12:00:00,12
290,372,662,33,21.2,0,Clear,9.4,2023-04-11 13:00:00,13
298,371,669,28,22.3,0,Clear,10.8,2023-04-11 14:00:00,14
357,443,800,26,23.1,1,Mostly Clear,12.6,2023-04-11 15:00:00,15
447,692,1139,25,23.4,1,Mostly Clear,13.3,2023-04-11 16:00:00,16
676,1171,1847,24,23.4,1,Mostly Clear,13.0,2023-04-11 17:00:00,17
604,981,1585,31,22.5,1,Mostly Clear,8.0,2023-04-11 18:00:00,18
409,733,1142,40,20.3,1,Mostly Clear,7.4,2023-04-11 19:00:00,19
288,473,761,47,17.9,1,Mostly Clear,8.7,2023-04-11 20:00:00,20
208,373,581,49,16.3,0,Clear,8.7,2023-04-11 21:00:00,21
117,248,365,48,15.3,0,Clear,8.8,2023-04-11 22:00:00,22
76,121,197,44,14.8,1,Mostly Clear,9.8,2023-04-11 23:00:00,23
28,42,70,43,14.5,1,Mostly Clear,10.0,2023-04-12 00:00:00,0
13,24,37,43,14.1,3,Cloudy,10.4,2023-04-12 01:00:00,1
11,15,26,45,13.4,3,Cloudy,11.2,2023-04-12 02:00:00,2
7,9,16,45,13.0,1,Mostly Clear,11.9,2023-04-12 03:00:00,3
4,17,21,46,12.5,1,Mostly Clear,12.0,2023-04-12 04:00:00,4
22,80,102,47,12.1,1,Mostly Clear,12.4,2023-04-12 05:00:00,5
54,257,311,48,11.7,1,Mostly Clear,11.9,2023-04-12 06:00:00,6
134,506,640,53,11.7,1,Mostly Clear,12.4,2023-04-12 07:00:00,7
286,893,1179,56,13.1,1,Mostly Clear,13.1,2023-04-12 08:00:00,8
247,540,787,50,16.5,1,Mostly Clear,12.4,2023-04-12 09:00:00,9
232,296,528,43,19.5,0,Clear,12.4,2023-04-12 10:00:00,10
297,325,622,40,21.9,0,Clear,14.8,2023-04-12 11:00:00,11
264,409,673,38,23.8,0,Clear,16.2,2023-04-12 12:00:00,12
292,410,702,37,25.3,0,Clear,16.9,2023-04-12 13:00:00,13
338,397,735,35,26.4,0,Clear,17.3,2023-04-12 14:00:00,14
334,520,854,31,27.3,0,Clear,17.3,2023-04-12 15:00:00,15
422,696,1118,31,27.5,0,Clear,17.2,2023-04-12 16:00:00,16
681,1114,1795,31,27.4,0,Clear,15.6,2023-04-12 17:00:00,17
639,1015,1654,36,26.4,0,Clear,10.1,2023-04-12 18:00:00,18
477,732,1209,43,24.3,0,Clear,8.2,2023-04-12 19:00:00,19
298,484,782,50,21.8,0,Clear,11.2,2023-04-12 20:00:00,20
254,419,673,54,19.8,0,Clear,11.9,2023-04-12 21:00:00,21
188,284,472,58,18.4,0,Clear,11.7,2023-04-12 22:00:00,22
101,151,252,59,17.3,0,Clear,9.9,2023-04-12 23:00:00,23
39,82,121,60,16.5,0,Clear,9.0,2023-04-13 00:00:00,0
15,26,41,60,15.9,0,Clear,9.0,2023-04-13 01:00:00,1
3,11,14,60,15.3,0,Clear,9.6,2023-04-13 02:00:00,2
10,11,21,66,14.4,0,Clear,9.5,2023-04-13 03:00:00,3
5,20,25,67,13.7,0,Clear,9.5,2023-04-13 04:00:00,4
28,64,92,67,13.1,0,Clear,10.0,2023-04-13 05:00:00,5
66,173,239,68,12.7,0,Clear,9.5,2023-04-13 06:00:00,6
169,492,661,72,12.3,0,Clear,9.6,2023-04-13 07:00:00,7
290,861,1151,74,14.4,0,Clear,9.7,2023-04-13 08:00:00,8
267,508,775,54,19.7,0,Clear,7.8,2023-04-13 09:00:00,9
242,269,511,47,22.4,0,Clear,6.9,2023-04-13 10:00:00,10
234,313,547,42,24.6,0,Clear,7.6,2023-04-13 11:00:00,11
318,411,729,37,26.4,0,Clear,5.8,2023-04-13 12:00:00,12
279,367,646,33,27.5,0,Clear,7.1,2023-04-13 13:00:00,13
342,375,717,31,28.3,0,Clear,10.0,2023-04-13 14:00:00,14
372,485,857,27,29.0,0,Clear,11.9,2023-04-13 15:00:00,15
445,657,1102,27,29.1,0,Clear,12.2,2023-04-13 16:00:00,16
713,1182,1895,27,28.9,0,Clear,12.0,2023-04-13 17:00:00,17
625,1023,1648,32,27.7,0,Clear,8.7,2023-04-13 18:00:00,18
514,749,1263,37,25.4,0,Clear,7.3,2023-04-13 19:00:00,19
365,551,916,41,22.9,0,Clear,8.5,2023-04-13 20:00:00,20
308,480,788,43,21.0,0,Clear,9.3,2023-04-13 21:00:00,21
225,327,552,47,19.4,0,Clear,9.8,2023-04-13 22:00:00,22
108,192,300,50,18.2,0,Clear,11.0,2023-04-13 23:00:00,23
67,98,165,53,17.4,0,Clear,10.8,2023-04-14 00:00:00,0
33,48,81,57,16.8,0,Clear,10.5,2023-04-14 01:00:00,1
18,16,34,61,16.3,0,Clear,11.0,2023-04-14 02:00:00,2
7,15,22,60,15.9,1,Mostly Clear,10.7,2023-04-14 03:00:00,3
4,20,24,63,15.2,1,Mostly Clear,10.2,2023-04-14 04:00:00,4
22,75,97,65,14.6,1,Mostly Clear,10.3,2023-04-14 05:00:00,5
63,182,245,68,14.1,1,Mostly Clear,7.5,2023-04-14 06:00:00,6
138,431,569,71,13.7,1,Mostly Clear,8.0,2023-04-14 07:00:00,7
260,660,920,69,15.3,0,Clear,9.6,2023-04-14 08:00:00,8
238,472,710,60,18.2,0,Clear,8.7,2023-04-14 09:00:00,9
316,351,667,53,20.7,1,Mostly Clear,9.4,2023-04-14 10:00:00,10
365,389,754,48,22.6,1,Mostly Clear,9.0,2023-04-14 11:00:00,11
383,397,780,44,23.9,1,Mostly Clear,10.2,2023-04-14 12:00:00,12
414,450,864,42,24.9,1,Mostly Clear,12.0,2023-04-14 13:00:00,13
481,469,950,43,25.4,2,Partly Cloudy,13.2,2023-04-14 14:00:00,14
463,561,1024,41,26.7,2,Partly Cloudy,13.5,2023-04-14 15:00:00,15
592,677,1269,47,26.1,2,Partly Cloudy,13.3,2023-04-14 16:00:00,16
649,873,1522,54,25.2,1,Mostly Clear,14.4,2023-04-14 17:00:00,17
514,692,1206,62,23.8,3,Cloudy,12.3,2023-04-14 18:00:00,18
344,491,835,69,22.3,2,Partly Cloudy,9.4,2023-04-14 19:00:00,19
216,366,582,76,21.0,2,Partly Cloudy,7.9,2023-04-14 20:00:00,20
228,304,532,83,19.9,2,Partly Cloudy,9.2,2023-04-14 21:00:00,21
251,286,537,89,19.0,2,Partly Cloudy,10.9,2023-04-14 22:00:00,22
206,242,448,93,18.5,2,Partly Cloudy,10.5,2023-04-14 23:00:00,23
140,181,321,95,18.0,51,Light Drizzle,10.2,2023-04-15 00:00:00,0
83,102,185,97,17.6,51,Light Drizzle,8.4,2023-04-15 01:00:00,1
59,64,123,97,17.5,3,Cloudy,8.0,2023-04-15 02:00:00,2
15,22,37,99,17.6,51,Light Drizzle,7.6,2023-04-15 03:00:00,3
16,20,36,99,17.8,51,Light Drizzle,7.2,2023-04-15 04:00:00,4
13,28,41,99,17.8,51,Light Drizzle,6.5,2023-04-15 05:00:00,5
36,66,102,100,17.8,3,Cloudy,3.9,2023-04-15 06:00:00,6
78,137,215,99,17.9,51,Light Drizzle,4.7,2023-04-15 07:00:00,7
124,263,387,99,18.2,51,Light Drizzle,4.9,2023-04-15 08:00:00,8
346,333,679,96,18.7,51,Light Drizzle,5.8,2023-04-15 09:00:00,9
502,436,938,90,19.3,53,Heavy Drizzle,6.5,2023-04-15 10:00:00,10
605,541,1146,87,20.3,53,Heavy Drizzle,5.9,2023-04-15 11:00:00,11
769,588,1357,77,21.6,53,Heavy Drizzle,4.3,2023-04-15 12:00:00,12
794,530,1324,77,21.7,53,Heavy Drizzle,4.1,2023-04-15 13:00:00,13
840,615,1455,75,22.3,61,Light Rain,5.9,2023-04-15 14:00:00,14
560,407,967,64,23.6,55,Heavy Drizzle,5.9,2023-04-15 15:00:00,15
418,378,796,69,22.6,53,Heavy Drizzle,2.2,2023-04-15 16:00:00,16
577,459,1036,76,21.6,61,Light Rain,2.8,2023-04-15 17:00:00,17
510,443,953,85,20.4,51,Light Drizzle,2.5,2023-04-15 18:00:00,18
486,461,947,88,20.0,2,Partly Cloudy,2.4,2023-04-15 19:00:00,19
354,356,710,93,19.1,3,Cloudy,2.2,2023-04-15 20:00:00,20
320,300,620,97,18.1,1,Mostly Clear,3.7,2023-04-15 21:00:00,21
236,252,488,98,17.5,0,Clear,7.7,2023-04-15 22:00:00,22
201,221,422,99,16.9,2,Partly Cloudy,10.0,2023-04-15 23:00:00,23
181,193,374,99,16.5,3,Cloudy,9.2,2023-04-16 00:00:00,0
111,124,235,97,16.3,2,Partly Cloudy,7.6,2023-04-16 01:00:00,1
83,76,159,97,15.9,2,Partly Cloudy,9.7,2023-04-16 02:00:00,2
36,35,71,96,15.8,2,Partly Cloudy,10.8,2023-04-16 03:00:00,3
26,23,49,96,15.2,2,Partly Cloudy,8.3,2023-04-16 04:00:00,4
9,18,27,96,14.7,3,Cloudy,7.5,2023-04-16 05:00:00,5
36,60,96,97,14.0,1,Mostly Clear,6.6,2023-04-16 06:00:00,6
58,99,157,97,14.1,1,Mostly Clear,5.6,2023-04-16 07:00:00,7
163,198,361,97,16.1,0,Clear,4.2,2023-04-16 08:00:00,8
335,342,677,87,19.4,0,Clear,1.6,2023-04-16 09:00:00,9
531,474,1005,74,22.0,1,Mostly Clear,0.8,2023-04-16 10:00:00,10
673,511,1184,62,24.3,1,Mostly Clear,4.1,2023-04-16 11:00:00,11
713,510,1223,52,25.9,1,Mostly Clear,6.6,2023-04-16 12:00:00,12
756,534,1290,47,26.9,1,Mostly Clear,9.3,2023-04-16 13:00:00,13
628,575,1203,43,27.5,1,Mostly Clear,11.2,2023-04-16 14:00:00,14
753,586,1339,44,27.1,2,Partly Cloudy,13.5,2023-04-16 15:00:00,15
646,592,1238,45,26.8,3,Cloudy,14.3,2023-04-16 16:00:00,16
604,519,1123,47,26.2,2,Partly Cloudy,14.9,2023-04-16 17:00:00,17
416,494,910,49,25.4,3,Cloudy,13.3,2023-04-16 18:00:00,18
309,373,682,53,24.1,2,Partly Cloudy,13.0,2023-04-16 19:00:00,19
213,285,498,58,22.5,2,Partly Cloudy,13.0,2023-04-16 20:00:00,20
163,229,392,63,21.3,2,Partly Cloudy,11.9,2023-04-16 21:00:00,21
152,173,325,67,20.7,2,Partly Cloudy,12.3,2023-04-16 22:00:00,22
74,114,188,72,19.9,2,Partly Cloudy,13.0,2023-04-16 23:00:00,23
44,43,87,75,19.5,2,Partly Cloudy,10.6,2023-04-17 00:00:00,0
16,33,49,80,18.8,51,Light Drizzle,9.9,2023-04-17 01:00:00,1
11,13,24,79,17.8,3,Cloudy,18.4,2023-04-17 02:00:00,2
6,17,23,79,15.8,3,Cloudy,20.6,2023-04-17 03:00:00,3
9,22,31,71,15.2,3,Cloudy,17.1,2023-04-17 04:00:00,4
23,55,78,65,14.9,3,Cloudy,16.9,2023-04-17 05:00:00,5
48,167,215,58,14.6,3,Cloudy,14.3,2023-04-17 06:00:00,6
99,384,483,56,14.1,2,Partly Cloudy,15.3,2023-04-17 07:00:00,7
207,604,811,54,13.7,2,Partly Cloudy,14.5,2023-04-17 08:00:00,8
167,360,527,53,13.7,1,Mostly Clear,13.2,2023-04-17 09:00:00,9
210,251,461,49,14.5,1,Mostly Clear,10.4,2023-04-17 10:00:00,10
206,303,509,45,15.6,2,Partly Cloudy,12.5,2023-04-17 11:00:00,11
235,370,605,40,17.2,2,Partly Cloudy,15.1,2023-04-17 12:00:00,12
236,337,573,33,18.7,2,Partly Cloudy,16.6,2023-04-17 13:00:00,13
297,322,619,30,19.5,2,Partly Cloudy,18.7,2023-04-17 14:00:00,14
296,422,718,32,18.6,1,Mostly Clear,19.0,2023-04-17 15:00:00,15
305,527,832,30,19.3,2,Partly Cloudy,20.5,2023-04-17 16:00:00,16
497,901,1398,30,19.1,2,Partly Cloudy,22.2,2023-04-17 17:00:00,17
384,822,1206,31,18.9,2,Partly Cloudy,17.3,2023-04-17 18:00:00,18
302,571,873,32,18.1,2,Partly Cloudy,12.3,2023-04-17 19:00:00,19
198,386,584,36,16.8,2,Partly Cloudy,8.4,2023-04-17 20:00:00,20
180,282,462,37,15.5,1,Mostly Clear,11.4,2023-04-17 21:00:00,21
97,181,278,39,14.5,1,Mostly Clear,12.9,2023-04-17 22:00:00,22
44,93,137,42,13.4,1,Mostly Clear,8.2,2023-04-17 23:00:00,23
24,34,58,45,12.6,1,Mostly Clear,8.6,2023-04-18 00:00:00,0
7,17,24,49,11.7,1,Mostly Clear,12.1,2023-04-18 01:00:00,1
8,5,13,60,10.4,0,Clear,10.6,2023-04-18 02:00:00,2
2,9,11,61,9.5,0,Clear,8.3,2023-04-18 03:00:00,3
6,21,27,66,8.7,0,Clear,7.0,2023-04-18 04:00:00,4
23,67,90,68,8.0,0,Clear,5.9,2023-04-18 05:00:00,5
60,191,251,68,8.3,0,Clear,11.7,2023-04-18 06:00:00,6
156,486,642,62,9.7,0,Clear,13.4,2023-04-18 07:00:00,7
275,873,1148,53,11.8,0,Clear,12.2,2023-04-18 08:00:00,8
229,470,699,42,14.0,0,Clear,13.7,2023-04-18 09:00:00,9
181,238,419,34,14.8,0,Clear,14.2,2023-04-18 10:00:00,10
193,285,478,33,15.8,1,Mostly Clear,19.7,2023-04-18 11:00:00,11
228,367,595,32,16.8,0,Clear,21.5,2023-04-18 12:00:00,12
230,362,592,30,17.9,0,Clear,22.7,2023-04-18 13:00:00,13
296,355,651,28,19.0,0,Clear,22.0,2023-04-18 14:00:00,14
298,482,780,22,21.0,0,Clear,22.9,2023-04-18 15:00:00,15
341,660,1001,20,21.5,0,Clear,23.8,2023-04-18 16:00:00,16
590,1087,1677,20,21.1,0,Clear,23.6,2023-04-18 17:00:00,17
600,1035,1635,23,20.2,0,Clear,15.8,2023-04-18 18:00:00,18
400,652,1052,27,18.4,0,Clear,11.2,2023-04-18 19:00:00,19
266,484,750,33,16.2,0,Clear,10.4,2023-04-18 20:00:00,20
215,398,613,36,14.5,0,Clear,12.7,2023-04-18 21:00:00,21
122,242,364,41,12.9,0,Clear,13.9,2023-04-18 22:00:00,22
60,107,167,47,11.5,0,Clear,10.6,2023-04-18 23:00:00,23
26,43,69,58,9.9,0,Clear,8.0,2023-04-19 00:00:00,0
14,16,30,66,8.5,0,Clear,6.4,2023-04-19 01:00:00,1
4,5,9,69,7.9,0,Clear,4.8,2023-04-19 02:00:00,2
9,6,15,66,7.7,0,Clear,6.0,2023-04-19 03:00:00,3
9,19,28,61,8.9,0,Clear,4.1,2023-04-19 04:00:00,4
25,78,103,63,9.0,0,Clear,2.2,2023-04-19 05:00:00,5
57,184,241,65,8.8,0,Clear,5.4,2023-04-19 06:00:00,6
140,481,621,70,8.5,0,Clear,5.0,2023-04-19 07:00:00,7
242,831,1073,79,8.7,0,Clear,5.1,2023-04-19 08:00:00,8
229,427,656,53,11.8,0,Clear,6.9,2023-04-19 09:00:00,9
183,264,447,47,13.8,0,Clear,9.0,2023-04-19 10:00:00,10
198,313,511,41,15.6,0,Clear,11.5,2023-04-19 11:00:00,11
267,366,633,36,17.4,0,Clear,11.9,2023-04-19 12:00:00,12
232,329,561,32,19.0,0,Clear,12.1,2023-04-19 13:00:00,13
289,387,676,29,20.5,0,Clear,12.3,2023-04-19 14:00:00,14
296,492,788,26,21.9,0,Clear,12.3,2023-04-19 15:00:00,15
409,633,1042,25,22.7,0,Clear,12.1,2023-04-19 16:00:00,16
659,1119,1778,24,23.2,0,Clear,10.7,2023-04-19 17:00:00,17
656,1052,1708,28,22.9,0,Clear,5.5,2023-04-19 18:00:00,18
447,729,1176,48,20.9,0,Clear,3.9,2023-04-19 19:00:00,19
273,482,755,49,18.5,0,Clear,7.3,2023-04-19 20:00:00,20
273,378,651,57,15.9,0,Clear,6.5,2023-04-19 21:00:00,21
166,270,436,67,14.1,0,Clear,8.7,2023-04-19 22:00:00,22
97,134,231,76,12.7,0,Clear,7.6,2023-04-19 23:00:00,23
45,59,104,82,11.8,1,Mostly Clear,7.3,2023-04-20 00:00:00,0
19,20,39,87,11.2,1,Mostly Clear,8.1,2023-04-20 01:00:00,1
6,10,16,90,10.9,0,Clear,6.1,2023-04-20 02:00:00,2
9,4,13,91,10.7,0,Clear,6.0,2023-04-20 03:00:00,3
7,20,27,92,11.0,0,Clear,7.4,2023-04-20 04:00:00,4
29,61,90,92,11.3,0,Clear,6.3,2023-04-20 05:00:00,5
70,175,245,92,11.6,0,Clear,4.6,2023-04-20 06:00:00,6
111,491,602,96,10.4,0,Clear,7.1,2023-04-20 07:00:00,7
278,773,1051,91,13.5,0,Clear,6.2,2023-04-20 08:00:00,8
240,503,743,76,16.9,0,Clear,3.9,2023-04-20 09:00:00,9
192,278,470,68,19.1,0,Clear,3.8,2023-04-20 10:00:00,10
227,290,517,62,21.2,0,Clear,3.6,2023-04-20 11:00:00,11
231,372,603,56,23.2,0,Clear,3.1,2023-04-20 12:00:00,12
297,382,679,50,25.1,0,Clear,2.9,2023-04-20 13:00:00,13
294,385,679,46,26.6,0,Clear,4.3,2023-04-20 14:00:00,14
318,502,820,42,27.5,0,Clear,6.1,2023-04-20 15:00:00,15
458,617,1075,39,28.0,0,Clear,7.5,2023-04-20 16:00:00,16
681,1124,1805,39,27.8,0,Clear,10.2,2023-04-20 17:00:00,17
633,1042,1675,43,26.9,0,Clear,9.9,2023-04-20 18:00:00,18
502,755,1257,53,24.4,0,Clear,11.3,2023-04-20 19:00:00,19
371,526,897,63,21.7,0,Clear,11.1,2023-04-20 20:00:00,20
279,443,722,66,20.2,0,Clear,10.7,2023-04-20 21:00:00,21
231,284,515,67,19.1,0,Clear,11.0,2023-04-20 22:00:00,22
143,160,303,68,18.5,0,Clear,11.2,2023-04-20 23:00:00,23
48,105,153,70,17.8,0,Clear,10.2,2023-04-21 00:00:00,0
43,30,73,71,17.2,0,Clear,8.4,2023-04-21 01:00:00,1
18,8,26,68,16.7,0,Clear,7.6,2023-04-21 02:00:00,2
9,15,24,66,16.4,0,Clear,8.1,2023-04-21 03:00:00,3
7,29,36,67,15.7,0,Clear,7.6,2023-04-21 04:00:00,4
27,45,72,70,14.8,0,Clear,6.8,2023-04-21 05:00:00,5
55,168,223,75,14.0,0,Clear,2.6,2023-04-21 06:00:00,6
115,370,485,80,13.6,0,Clear,3.4,2023-04-21 07:00:00,7
226,558,784,76,16.6,0,Clear,3.5,2023-04-21 08:00:00,8
267,407,674,58,20.4,0,Clear,1.3,2023-04-21 09:00:00,9
290,323,613,52,22.9,1,Mostly Clear,1.3,2023-04-21 10:00:00,10
370,373,743,47,25.3,0,Clear,1.1,2023-04-21 11:00:00,11
340,424,764,42,27.4,0,Clear,4.6,2023-04-21 12:00:00,12
437,402,839,36,29.1,0,Clear,5.7,2023-04-21 13:00:00,13
452,462,914,32,29.8,0,Clear,7.2,2023-04-21 14:00:00,14
495,507,1002,32,29.5,1,Mostly Clear,8.9,2023-04-21 15:00:00,15
554,653,1207,28,29.7,0,Clear,10.0,2023-04-21 16:00:00,16
698,845,1543,26,29.8,0,Clear,10.7,2023-04-21 17:00:00,17
672,778,1450,28,28.9,1,Mostly Clear,11.0,2023-04-21 18:00:00,18
543,630,1173,34,26.5,1,Mostly Clear,10.2,2023-04-21 19:00:00,19
354,478,832,38,24.0,1,Mostly Clear,12.5,2023-04-21 20:00:00,20
317,368,685,37,23.1,0,Clear,14.8,2023-04-21 21:00:00,21
285,322,607,38,22.7,0,Clear,15.8,2023-04-21 22:00:00,22
212,289,501,41,22.2,0,Clear,15.5,2023-04-21 23:00:00,23
194,218,412,44,21.6,0,Clear,16.6,2023-04-22 00:00:00,0
123,115,238,47,20.9,0,Clear,17.3,2023-04-22 01:00:00,1
90,96,186,48,20.1,0,Clear,17.2,2023-04-22 02:00:00,2
36,37,73,51,19.5,1,Mostly Clear,16.3,2023-04-22 03:00:00,3
10,14,24,54,18.8,1,Mostly Clear,16.2,2023-04-22 04:00:00,4
21,24,45,58,18.0,1,Mostly Clear,16.6,2023-04-22 05:00:00,5
46,58,104,63,17.3,1,Mostly Clear,17.1,2023-04-22 06:00:00,6
81,158,239,68,16.9,1,Mostly Clear,15.5,2023-04-22 07:00:00,7
201,276,477,70,17.6,1,Mostly Clear,14.0,2023-04-22 08:00:00,8
322,419,741,67,18.8,1,Mostly Clear,17.7,2023-04-22 09:00:00,9
565,478,1043,62,20.3,2,Partly Cloudy,20.7,2023-04-22 10:00:00,10
589,569,1158,54,21.7,2,Partly Cloudy,22.6,2023-04-22 11:00:00,11
646,587,1233,51,22.2,2,Partly Cloudy,21.4,2023-04-22 12:00:00,12
509,538,1047,49,23.0,51,Light Drizzle,20.6,2023-04-22 13:00:00,13
84,101,185,54,22.5,51,Light Drizzle,21.1,2023-04-22 14:00:00,14
60,104,164,80,19.2,61,Light Rain,13.0,2023-04-22 15:00:00,15
80,151,231,93,17.2,63,Rain,14.9,2023-04-22 16:00:00,16
111,183,294,94,16.6,63,Rain,13.0,2023-04-22 17:00:00,17
207,308,515,95,16.5,61,Light Rain,2.1,2023-04-22 18:00:00,18
215,300,515,94,16.0,51,Light Drizzle,4.0,2023-04-22 19:00:00,19
154,175,329,89,14.9,3,Cloudy,5.5,2023-04-22 20:00:00,20
119,181,300,86,14.3,3,Cloudy,8.7,2023-04-22 21:00:00,21
111,184,295,85,13.9,3,Cloudy,9.3,2023-04-22 22:00:00,22
130,185,315,85,13.4,3,Cloudy,8.9,2023-04-22 23:00:00,23
101,133,234,85,12.9,3,Cloudy,10.0,2023-04-23 00:00:00,0
69,117,186,86,12.2,3,Cloudy,9.4,2023-04-23 01:00:00,1
58,66,124,86,11.6,1,Mostly Clear,8.6,2023-04-23 02:00:00,2
17,22,39,89,11.9,0,Clear,8.4,2023-04-23 03:00:00,3
15,12,27,88,11.6,0,Clear,8.7,2023-04-23 04:00:00,4
20,26,46,87,11.0,0,Clear,10.5,2023-04-23 05:00:00,5
38,52,90,87,10.2,0,Clear,7.9,2023-04-23 06:00:00,6
64,87,151,87,9.9,0,Clear,9.2,2023-04-23 07:00:00,7
155,201,356,82,11.3,0,Clear,9.1,2023-04-23 08:00:00,8
325,327,652,70,13.3,0,Clear,10.2,2023-04-23 09:00:00,9
451,452,903,56,15.0,0,Clear,10.5,2023-04-23 10:00:00,10
696,539,1235,46,15.9,0,Clear,9.8,2023-04-23 11:00:00,11
698,641,1339,41,16.9,1,Mostly Clear,10.7,2023-04-23 12:00:00,12
812,661,1473,38,17.2,2,Partly Cloudy,13.3,2023-04-23 13:00:00,13
624,631,1255,39,16.9,2,Partly Cloudy,14.8,2023-04-23 14:00:00,14
539,543,1082,42,17.0,51,Light Drizzle,15.5,2023-04-23 15:00:00,15
445,518,963,44,16.8,1,Mostly Clear,16.7,2023-04-23 16:00:00,16
446,562,1008,47,16.2,0,Clear,16.2,2023-04-23 17:00:00,17
389,442,831,48,15.5,1,Mostly Clear,15.7,2023-04-23 18:00:00,18
264,413,677,45,14.8,0,Clear,15.4,2023-04-23 19:00:00,19
146,235,381,45,13.6,0,Clear,16.6,2023-04-23 20:00:00,20
81,197,278,42,12.7,0,Clear,18.0,2023-04-23 21:00:00,21
83,142,225,42,11.7,0,Clear,15.6,2023-04-23 22:00:00,22
45,91,136,43,10.8,1,Mostly Clear,14.0,2023-04-23 23:00:00,23
26,41,67,45,10.0,1,Mostly Clear,13.7,2023-04-24 00:00:00,0
8,3,11,47,9.4,1,Mostly Clear,12.9,2023-04-24 01:00:00,1
6,8,14,54,8.2,1,Mostly Clear,10.8,2023-04-24 02:00:00,2
4,4,8,50,7.7,1,Mostly Clear,8.7,2023-04-24 03:00:00,3
6,13,19,53,7.4,0,Clear,7.1,2023-04-24 04:00:00,4
24,58,82,61,6.7,0,Clear,6.4,2023-04-24 05:00:00,5
51,197,248,68,6.0,0,Clear,3.4,2023-04-24 06:00:00,6
120,433,553,71,6.0,1,Mostly Clear,5.6,2023-04-24 07:00:00,7
211,673,884,56,7.8,1,Mostly Clear,6.5,2023-04-24 08:00:00,8
188,444,632,50,9.4,0,Clear,7.2,2023-04-24 09:00:00,9
172,277,449,45,10.8,1,Mostly Clear,7.9,2023-04-24 10:00:00,10
244,278,522,41,12.3,2,Partly Cloudy,10.2,2023-04-24 11:00:00,11
285,373,658,35,14.0,2,Partly Cloudy,11.7,2023-04-24 12:00:00,12
228,345,573,33,14.6,2,Partly Cloudy,13.4,2023-04-24 13:00:00,13
236,325,561,31,15.1,2,Partly Cloudy,14.1,2023-04-24 14:00:00,14
285,453,738,34,14.2,2,Partly Cloudy,14.6,2023-04-24 15:00:00,15
342,589,931,32,14.7,2,Partly Cloudy,14.2,2023-04-24 16:00:00,16
481,937,1418,30,14.6,2,Partly Cloudy,13.0,2023-04-24 17:00:00,17
386,894,1280,32,14.2,0,Clear,8.8,2023-04-24 18:00:00,18
315,625,940,35,13.6,0,Clear,7.2,2023-04-24 19:00:00,19
202,408,610,44,11.9,0,Clear,6.6,2023-04-24 20:00:00,20
155,298,453,50,10.4,1,Mostly Clear,8.1,2023-04-24 21:00:00,21
93,166,259,54,9.1,0,Clear,12.3,2023-04-24 22:00:00,22
39,73,112,54,8.2,0,Clear,11.3,2023-04-24 23:00:00,23
17,58,75,56,7.4,0,Clear,9.7,2023-04-25 00:00:00,0
4,20,24,61,6.5,0,Clear,8.9,2023-04-25 01:00:00,1
6,8,14,68,5.6,1,Mostly Clear,8.7,2023-04-25 02:00:00,2
3,10,13,68,5.8,1,Mostly Clear,8.7,2023-04-25 03:00:00,3
13,18,31,74,5.1,0,Clear,7.4,2023-04-25 04:00:00,4
20,87,107,77,4.6,0,Clear,6.6,2023-04-25 05:00:00,5
51,201,252,81,4.0,0,Clear,5.9,2023-04-25 06:00:00,6
143,533,676,83,4.0,0,Clear,7.1,2023-04-25 07:00:00,7
278,965,1243,68,7.1,0,Clear,6.4,2023-04-25 08:00:00,8
194,504,698,60,8.9,0,Clear,5.8,2023-04-25 09:00:00,9
149,269,418,49,10.7,0,Clear,5.7,2023-04-25 10:00:00,10
162,318,480,42,12.0,1,Mostly Clear,8.7,2023-04-25 11:00:00,11
207,374,581,38,13.2,1,Mostly Clear,10.0,2023-04-25 12:00:00,12
231,377,608,33,14.7,2,Partly Cloudy,10.7,2023-04-25 13:00:00,13
234,378,612,30,15.0,3,Cloudy,10.7,2023-04-25 14:00:00,14
302,473,775,31,15.6,3,Cloudy,9.3,2023-04-25 15:00:00,15
337,687,1024,30,15.6,3,Cloudy,7.4,2023-04-25 16:00:00,16
558,1153,1711,29,15.9,3,Cloudy,4.7,2023-04-25 17:00:00,17
523,983,1506,28,15.6,1,Mostly Clear,5.0,2023-04-25 18:00:00,18
352,649,1001,36,14.6,1,Mostly Clear,3.1,2023-04-25 19:00:00,19
242,456,698,46,12.8,0,Clear,4.9,2023-04-25 20:00:00,20
140,326,466,56,11.3,0,Clear,6.5,2023-04-25 21:00:00,21
95,224,319,64,10.4,0,Clear,7.3,2023-04-25 22:00:00,22
55,87,142,70,9.7,0,Clear,7.4,2023-04-25 23:00:00,23
18,42,60,74,9.1,0,Clear,7.4,2023-04-26 00:00:00,0
5,19,24,79,8.6,0,Clear,7.0,2023-04-26 01:00:00,1
2,3,5,84,8.1,0,Clear,7.0,2023-04-26 02:00:00,2
3,7,10,90,7.6,0,Clear,7.1,2023-04-26 03:00:00,3
3,13,16,91,7.2,0,Clear,6.8,2023-04-26 04:00:00,4
20,63,83,92,6.8,0,Clear,7.4,2023-04-26 05:00:00,5
72,227,299,92,7.0,1,Mostly Clear,8.3,2023-04-26 06:00:00,6
143,507,650,92,7.2,2,Partly Cloudy,5.9,2023-04-26 07:00:00,7
259,911,1170,82,10.5,2,Partly Cloudy,4.4,2023-04-26 08:00:00,8
178,474,652,66,13.0,0,Clear,4.4,2023-04-26 09:00:00,9
156,287,443,58,14.6,1,Mostly Clear,6.8,2023-04-26 10:00:00,10
186,351,537,52,16.3,1,Mostly Clear,8.7,2023-04-26 11:00:00,11
246,440,686,49,17.7,0,Clear,8.4,2023-04-26 12:00:00,12
193,438,631,48,18.8,1,Mostly Clear,7.6,2023-04-26 13:00:00,13
273,394,667,46,19.6,2,Partly Cloudy,8.0,2023-04-26 14:00:00,14
207,403,610,48,19.4,51,Light Drizzle,9.2,2023-04-26 15:00:00,15
282,537,819,45,19.0,51,Light Drizzle,6.8,2023-04-26 16:00:00,16
470,1041,1511,56,17.2,53,Heavy Drizzle,7.2,2023-04-26 17:00:00,17
549,955,1504,75,15.6,53,Heavy Drizzle,9.7,2023-04-26 18:00:00,18
376,655,1031,84,14.3,51,Light Drizzle,13.8,2023-04-26 19:00:00,19
228,480,708,89,13.0,1,Mostly Clear,11.5,2023-04-26 20:00:00,20
170,343,513,89,12.1,1,Mostly Clear,12.9,2023-04-26 21:00:00,21
136,239,375,89,11.6,1,Mostly Clear,12.5,2023-04-26 22:00:00,22
73,158,231,87,11.4,1,Mostly Clear,10.5,2023-04-26 23:00:00,23
21,45,66,87,11.2,0,Clear,7.4,2023-04-27 00:00:00,0
14,14,28,89,10.9,1,Mostly Clear,6.0,2023-04-27 01:00:00,1
10,14,24,93,10.1,1,Mostly Clear,6.2,2023-04-27 02:00:00,2
6,10,16,93,9.5,1,Mostly Clear,6.4,2023-04-27 03:00:00,3
5,7,12,94,9.0,1,Mostly Clear,7.0,2023-04-27 04:00:00,4
27,65,92,96,8.6,1,Mostly Clear,7.1,2023-04-27 05:00:00,5
57,211,268,97,8.4,1,Mostly Clear,6.4,2023-04-27 06:00:00,6
143,469,612,97,8.9,3,Cloudy,6.0,2023-04-27 07:00:00,7
268,821,1089,91,11.9,1,Mostly Clear,4.6,2023-04-27 08:00:00,8
209,532,741,79,14.1,2,Partly Cloudy,1.6,2023-04-27 09:00:00,9
189,306,495,69,16.0,3,Cloudy,1.8,2023-04-27 10:00:00,10
255,312,567,62,17.6,3,Cloudy,1.1,2023-04-27 11:00:00,11
250,362,612,57,19.1,51,Light Drizzle,1.1,2023-04-27 12:00:00,12
276,373,649,52,19.8,51,Light Drizzle,3.8,2023-04-27 13:00:00,13
287,407,694,51,20.0,51,Light Drizzle,5.1,2023-04-27 14:00:00,14
325,499,824,46,20.6,51,Light Drizzle,7.1,2023-04-27 15:00:00,15
417,693,1110,49,20.0,2,Partly Cloudy,8.7,2023-04-27 16:00:00,16
600,1069,1669,52,19.6,2,Partly Cloudy,11.4,2023-04-27 17:00:00,17
554,945,1499,61,18.5,2,Partly Cloudy,11.9,2023-04-27 18:00:00,18
415,650,1065,69,17.5,2,Partly Cloudy,13.7,2023-04-27 19:00:00,19
258,419,677,77,16.2,3,Cloudy,14.8,2023-04-27 20:00:00,20
203,315,518,81,15.4,3,Cloudy,13.8,2023-04-27 21:00:00,21
163,258,421,84,14.9,3,Cloudy,13.7,2023-04-27 22:00:00,22
80,151,231,86,14.5,2,Partly Cloudy,13.3,2023-04-27 23:00:00,23
47,85,132,88,14.0,2,Partly Cloudy,13.7,2023-04-28 00:00:00,0
39,51,90,89,13.7,2,Partly Cloudy,14.1,2023-04-28 01:00:00,1
12,19,31,89,13.5,3,Cloudy,13.4,2023-04-28 02:00:00,2
8,14,22,92,12.9,3,Cloudy,13.0,2023-04-28 03:00:00,3
6,19,25,92,12.7,51,Light Drizzle,12.6,2023-04-28 04:00:00,4
9,28,37,93,12.5,51,Light Drizzle,13.6,2023-04-28 05:00:00,5
17,74,91,96,12.2,53,Heavy Drizzle,11.4,2023-04-28 06:00:00,6
26,116,142,96,12.1,55,Heavy Drizzle,17.1,2023-04-28 07:00:00,7
47,179,226,96,12.3,61,Light Rain,18.6,2023-04-28 08:00:00,8
46,116,162,96,12.6,61,Light Rain,18.5,2023-04-28 09:00:00,9
16,76,92,96,12.8,63,Rain,17.8,2023-04-28 10:00:00,10
24,59,83,96,13.1,63,Rain,18.4,2023-04-28 11:00:00,11
16,67,83,96,13.4,63,Rain,21.1,2023-04-28 12:00:00,12
23,72,95,97,13.6,63,Rain,22.3,2023-04-28 13:00:00,13
19,68,87,97,13.6,61,Light Rain,22.5,2023-04-28 14:00:00,14
37,115,152,96,11.9,61,Light Rain,22.2,2023-04-28 15:00:00,15
47,159,206,97,11.5,63,Rain,25.8,2023-04-28 16:00:00,16
65,206,271,96,11.3,53,Heavy Drizzle,24.4,2023-04-28 17:00:00,17
57,154,211,97,11.5,53,Heavy Drizzle,21.1,2023-04-28 18:00:00,18
34,127,161,97,11.7,53,Heavy Drizzle,20.4,2023-04-28 19:00:00,19
14,91,105,97,12.0,51,Light Drizzle,19.4,2023-04-28 20:00:00,20
34,87,121,98,12.2,51,Light Drizzle,21.9,2023-04-28 21:00:00,21
33,75,108,98,12.4,51,Light Drizzle,19.6,2023-04-28 22:00:00,22
29,65,94,99,12.4,51,Light Drizzle,18.2,2023-04-28 23:00:00,23
25,57,82,99,12.3,3,Cloudy,14.5,2023-04-29 00:00:00,0
37,40,77,98,12.2,3,Cloudy,9.2,2023-04-29 01:00:00,1
32,33,65,98,11.9,3,Cloudy,7.1,2023-04-29 02:00:00,2
11,15,26,99,12.6,51,Light Drizzle,7.1,2023-04-29 03:00:00,3
9,10,19,99,12.4,51,Light Drizzle,10.2,2023-04-29 04:00:00,4
11,25,36,99,12.0,51,Light Drizzle,12.3,2023-04-29 05:00:00,5
23,66,89,99,11.7,3,Cloudy,11.0,2023-04-29 06:00:00,6
52,124,176,98,11.6,3,Cloudy,9.7,2023-04-29 07:00:00,7
106,200,306,96,11.8,3,Cloudy,8.3,2023-04-29 08:00:00,8
246,333,579,92,12.3,3,Cloudy,6.2,2023-04-29 09:00:00,9
389,433,822,90,13.3,3,Cloudy,4.9,2023-04-29 10:00:00,10
477,525,1002,81,15.0,3,Cloudy,4.7,2023-04-29 11:00:00,11
647,610,1257,75,16.6,3,Cloudy,4.8,2023-04-29 12:00:00,12
687,598,1285,68,18.4,3,Cloudy,2.5,2023-04-29 13:00:00,13
632,563,1195,61,19.5,3,Cloudy,0.4,2023-04-29 14:00:00,14
708,611,1319,67,18.8,3,Cloudy,4.6,2023-04-29 15:00:00,15
775,634,1409,65,19.2,51,Light Drizzle,8.3,2023-04-29 16:00:00,16
767,631,1398,69,18.6,3,Cloudy,6.5,2023-04-29 17:00:00,17
614,617,1231,69,18.8,2,Partly Cloudy,3.3,2023-04-29 18:00:00,18
505,503,1008,74,17.9,2,Partly Cloudy,5.8,2023-04-29 19:00:00,19
316,357,673,81,16.5,1,Mostly Clear,8.5,2023-04-29 20:00:00,20
292,332,624,85,15.5,2,Partly Cloudy,10.2,2023-04-29 21:00:00,21
264,255,519,87,14.9,2,Partly Cloudy,10.5,2023-04-29 22:00:00,22
228,240,468,89,14.4,2,Partly Cloudy,11.4,2023-04-29 23:00:00,23
164,197,361,90,14.3,3,Cloudy,13.2,2023-04-30 00:00:00,0
112,116,228,89,14.6,3,Cloudy,14.3,2023-04-30 01:00:00,1
74,75,149,89,14.9,3,Cloudy,14.0,2023-04-30 02:00:00,2
45,38,83,92,14.9,1,Mostly Clear,12.5,2023-04-30 03:00:00,3
13,21,34,95,14.7,2,Partly Cloudy,10.2,2023-04-30 04:00:00,4
11,14,25,97,14.6,3,Cloudy,9.0,2023-04-30 05:00:00,5
19,37,56,98,14.4,3,Cloudy,7.0,2023-04-30 06:00:00,6
14,21,35,99,14.9,51,Light Drizzle,9.4,2023-04-30 07:00:00,7
21,46,67,99,15.1,61,Light Rain,5.3,2023-04-30 08:00:00,8
33,74,107,99,15.4,61,Light Rain,7.1,2023-04-30 09:00:00,9
44,90,134,100,15.8,61,Light Rain,10.9,2023-04-30 10:00:00,10
76,154,230,100,16.1,63,Rain,13.6,2023-04-30 11:00:00,11
95,198,293,100,16.1,61,Light Rain,15.0,2023-04-30 12:00:00,12
89,173,262,99,16.6,61,Light Rain,15.3,2023-04-30 13:00:00,13
89,179,268,99,16.9,55,Heavy Drizzle,7.8,2023-04-30 14:00:00,14
153,285,438,99,17.1,53,Heavy Drizzle,4.2,2023-04-30 15:00:00,15
190,336,526,99,16.9,51,Light Drizzle,11.6,2023-04-30 16:00:00,16
234,352,586,96,16.6,51,Light Drizzle,14.0,2023-04-30 17:00:00,17
223,382,605,97,15.5,53,Heavy Drizzle,13.3,2023-04-30 18:00:00,18
168,278,446,96,14.6,53,Heavy Drizzle,16.1,2023-04-30 19:00:00,19
95,156,251,94,14.1,53,Heavy Drizzle,18.5,2023-04-30 20:00:00,20
90,146,236,92,13.9,51,Light Drizzle,25.6,2023-04-30 21:00:00,21
102,137,239,83,13.0,3,Cloudy,26.3,2023-04-30 22:00:00,22
74,97,171,75,12.6,2,Partly Cloudy,22.6,2023-04-30 23:00:00,23
29,54,83,69,12.4,2,Partly Cloudy,20.3,2023-05-01 00:00:00,0
13,21,34,64,12.3,1,Mostly Clear,17.8,2023-05-01 01:00:00,1
9,11,20,59,11.8,2,Partly Cloudy,16.4,2023-05-01 02:00:00,2
5,11,16,62,11.7,1,Mostly Clear,16.6,2023-05-01 03:00:00,3
8,13,21,59,11.2,0,Clear,15.2,2023-05-01 04:00:00,4
24,61,85,61,10.4,0,Clear,12.0,2023-05-01 05:00:00,5
43,209,252,66,9.5,0,Clear,9.7,2023-05-01 06:00:00,6
101,428,529,70,9.3,0,Clear,9.5,2023-05-01 07:00:00,7
198,717,915,67,10.5,0,Clear,11.0,2023-05-01 08:00:00,8
178,450,628,56,11.6,0,Clear,15.9,2023-05-01 09:00:00,9
183,287,470,50,12.6,1,Mostly Clear,22.4,2023-05-01 10:00:00,10
211,343,554,46,13.5,1,Mostly Clear,24.7,2023-05-01 11:00:00,11
207,385,592,46,13.6,51,Light Drizzle,23.1,2023-05-01 12:00:00,12
220,371,591,48,14.2,1,Mostly Clear,22.8,2023-05-01 13:00:00,13
212,351,563,48,14.9,2,Partly Cloudy,24.5,2023-05-01 14:00:00,14
223,428,651,37,15.4,2,Partly Cloudy,23.7,2023-05-01 15:00:00,15
253,574,827,35,15.7,2,Partly Cloudy,22.3,2023-05-01 16:00:00,16
381,885,1266,36,15.8,2,Partly Cloudy,20.2,2023-05-01 17:00:00,17
340,917,1257,39,15.6,2,Partly Cloudy,15.1,2023-05-01 18:00:00,18
290,595,885,44,14.9,2,Partly Cloudy,14.5,2023-05-01 19:00:00,19
181,376,557,61,12.7,55,Heavy Drizzle,15.1,2023-05-01 20:00:00,20
148,294,442,70,11.6,53,Heavy Drizzle,16.9,2023-05-01 21:00:00,21
113,186,299,76,10.9,51,Light Drizzle,14.8,2023-05-01 22:00:00,22
54,97,151,79,10.4,2,Partly Cloudy,12.4,2023-05-01 23:00:00,23
20,63,83,86,9.1,2,Partly Cloudy,14.3,2023-05-02 00:00:00,0
11,17,28,84,9.1,1,Mostly Clear,15.5,2023-05-02 01:00:00,1
5,9,14,77,9.2,51,Light Drizzle,16.4,2023-05-02 02:00:00,2
0,12,12,58,10.5,3,Cloudy,16.6,2023-05-02 03:00:00,3
13,13,26,63,10.0,3,Cloudy,18.3,2023-05-02 04:00:00,4
17,72,89,67,9.4,51,Light Drizzle,17.6,2023-05-02 05:00:00,5
44,198,242,68,8.9,2,Partly Cloudy,12.6,2023-05-02 06:00:00,6
132,518,650,69,8.8,2,Partly Cloudy,12.5,2023-05-02 07:00:00,7
267,881,1148,71,9.2,3,Cloudy,10.2,2023-05-02 08:00:00,8
174,463,637,68,10.3,3,Cloudy,10.6,2023-05-02 09:00:00,9
115,240,355,64,11.7,3,Cloudy,11.3,2023-05-02 10:00:00,10
146,273,419,60,12.4,51,Light Drizzle,13.0,2023-05-02 11:00:00,11
157,337,494,61,12.3,51,Light Drizzle,16.9,2023-05-02 12:00:00,12
165,309,474,63,12.5,51,Light Drizzle,17.6,2023-05-02 13:00:00,13
137,321,458,64,12.8,51,Light Drizzle,17.5,2023-05-02 14:00:00,14
197,436,633,63,13.3,51,Light Drizzle,14.9,2023-05-02 15:00:00,15
258,567,825,60,14.0,51,Light Drizzle,16.9,2023-05-02 16:00:00,16
320,734,1054,69,12.3,53,Heavy Drizzle,17.4,2023-05-02 17:00:00,17
315,765,1080,72,12.0,51,Light Drizzle,8.3,2023-05-02 18:00:00,18
229,537,766,75,11.4,51,Light Drizzle,8.6,2023-05-02 19:00:00,19
166,375,541,76,10.5,51,Light Drizzle,11.8,2023-05-02 20:00:00,20
117,251,368,75,10.0,2,Partly Cloudy,11.0,2023-05-02 21:00:00,21
81,190,271,75,9.5,2,Partly Cloudy,10.9,2023-05-02 22:00:00,22
47,109,156,75,8.8,1,Mostly Clear,12.1,2023-05-02 23:00:00,23
15,42,57,75,8.4,1,Mostly Clear,13.5,2023-05-03 00:00:00,0
6,14,20,74,8.0,1,Mostly Clear,13.1,2023-05-03 01:00:00,1
6,4,10,76,7.6,1,Mostly Clear,10.1,2023-05-03 02:00:00,2
5,9,14,84,7.4,0,Clear,6.8,2023-05-03 03:00:00,3
5,15,20,89,6.6,1,Mostly Clear,7.4,2023-05-03 04:00:00,4
22,58,80,82,8.0,2,Partly Cloudy,4.6,2023-05-03 05:00:00,5
46,221,267,83,8.2,3,Cloudy,3.7,2023-05-03 06:00:00,6
101,410,511,92,7.1,51,Light Drizzle,2.5,2023-05-03 07:00:00,7
240,799,1039,83,8.9,51,Light Drizzle,4.2,2023-05-03 08:00:00,8
188,484,672,80,8.9,51,Light Drizzle,5.6,2023-05-03 09:00:00,9
137,276,413,70,9.3,2,Partly Cloudy,12.7,2023-05-03 10:00:00,10
168,296,464,62,10.5,2,Partly Cloudy,16.8,2023-05-03 11:00:00,11
173,341,514,57,11.9,2,Partly Cloudy,16.8,2023-05-03 12:00:00,12
181,336,517,55,12.7,1,Mostly Clear,16.2,2023-05-03 13:00:00,13
181,361,542,54,13.3,1,Mostly Clear,16.2,2023-05-03 14:00:00,14
205,455,660,52,13.6,51,Light Drizzle,16.9,2023-05-03 15:00:00,15
294,625,919,51,13.6,51,Light Drizzle,18.9,2023-05-03 16:00:00,16
413,1004,1417,56,12.2,55,Heavy Drizzle,21.0,2023-05-03 17:00:00,17
386,836,1222,61,11.0,51,Light Drizzle,12.2,2023-05-03 18:00:00,18
239,495,734,63,10.7,2,Partly Cloudy,11.8,2023-05-03 19:00:00,19
150,388,538,67,9.9,1,Mostly Clear,10.7,2023-05-03 20:00:00,20
126,279,405,69,9.3,2,Partly Cloudy,12.1,2023-05-03 21:00:00,21
98,211,309,70,8.9,1,Mostly Clear,13.4,2023-05-03 22:00:00,22
55,121,176,73,8.4,0,Clear,14.2,2023-05-03 23:00:00,23
20,44,64,75,8.0,0,Clear,14.7,2023-05-04 00:00:00,0
8,19,27,77,7.6,0,Clear,14.5,2023-05-04 01:00:00,1
8,6,14,79,7.2,0,Clear,14.1,2023-05-04 02:00:00,2
4,15,19,84,7.0,0,Clear,13.4,2023-05-04 03:00:00,3
5,10,15,85,6.8,0,Clear,13.7,2023-05-04 04:00:00,4
19,65,84,87,6.6,0,Clear,13.0,2023-05-04 05:00:00,5
62,204,266,88,6.7,0,Clear,7.7,2023-05-04 06:00:00,6
122,467,589,87,7.1,0,Clear,7.2,2023-05-04 07:00:00,7
217,833,1050,80,8.5,1,Mostly Clear,6.3,2023-05-04 08:00:00,8
167,494,661,71,9.7,1,Mostly Clear,10.6,2023-05-04 09:00:00,9
189,291,480,65,10.9,3,Cloudy,12.2,2023-05-04 10:00:00,10
178,300,478,59,12.1,2,Partly Cloudy,13.2,2023-05-04 11:00:00,11
235,387,622,55,12.8,2,Partly Cloudy,12.3,2023-05-04 12:00:00,12
221,345,566,52,14.0,1,Mostly Clear,11.4,2023-05-04 13:00:00,13
187,347,534,49,14.9,1,Mostly Clear,9.5,2023-05-04 14:00:00,14
271,509,780,50,15.5,51,Light Drizzle,7.6,2023-05-04 15:00:00,15
289,623,912,51,15.8,51,Light Drizzle,6.5,2023-05-04 16:00:00,16
538,1049,1587,51,15.7,51,Light Drizzle,6.1,2023-05-04 17:00:00,17
462,903,1365,57,15.2,51,Light Drizzle,4.6,2023-05-04 18:00:00,18
341,649,990,63,14.4,2,Partly Cloudy,4.3,2023-05-04 19:00:00,19
266,475,741,73,13.4,2,Partly Cloudy,6.8,2023-05-04 20:00:00,20
197,331,528,82,11.9,1,Mostly Clear,7.8,2023-05-04 21:00:00,21
170,278,448,90,10.6,0,Clear,9.0,2023-05-04 22:00:00,22
70,143,213,94,9.5,0,Clear,7.6,2023-05-04 23:00:00,23
42,85,127,95,9.0,0,Clear,7.9,2023-05-05 00:00:00,0
28,32,60,95,8.3,0,Clear,8.7,2023-05-05 01:00:00,1
16,11,27,95,8.0,0,Clear,8.5,2023-05-05 02:00:00,2
11,11,22,91,7.4,0,Clear,8.4,2023-05-05 03:00:00,3
7,20,27,92,7.1,0,Clear,8.5,2023-05-05 04:00:00,4
20,53,73,92,6.8,0,Clear,8.0,2023-05-05 05:00:00,5
52,171,223,93,6.4,0,Clear,7.2,2023-05-05 06:00:00,6
104,385,489,94,6.8,0,Clear,8.7,2023-05-05 07:00:00,7
210,623,833,87,9.9,0,Clear,6.9,2023-05-05 08:00:00,8
213,420,633,80,12.4,0,Clear,6.4,2023-05-05 09:00:00,9
201,336,537,68,14.7,0,Clear,6.0,2023-05-05 10:00:00,10
249,409,658,57,16.1,1,Mostly Clear,7.6,2023-05-05 11:00:00,11
317,489,806,52,16.7,1,Mostly Clear,7.9,2023-05-05 12:00:00,12
324,450,774,48,17.7,51,Light Drizzle,8.0,2023-05-05 13:00:00,13
397,483,880,45,18.0,1,Mostly Clear,8.7,2023-05-05 14:00:00,14
458,612,1070,42,18.2,2,Partly Cloudy,8.7,2023-05-05 15:00:00,15
489,700,1189,42,18.4,2,Partly Cloudy,8.1,2023-05-05 16:00:00,16
559,898,1457,41,18.6,1,Mostly Clear,7.4,2023-05-05 17:00:00,17
520,749,1269,45,17.9,1,Mostly Clear,5.8,2023-05-05 18:00:00,18
446,648,1094,55,16.6,1,Mostly Clear,4.9,2023-05-05 19:00:00,19
310,399,709,61,15.2,0,Clear,4.8,2023-05-05 20:00:00,20
254,296,550,66,13.9,0,Clear,6.3,2023-05-05 21:00:00,21
206,265,471,61,14.2,0,Clear,5.4,2023-05-05 22:00:00,22
158,251,409,79,10.9,0,Clear,5.6,2023-05-05 23:00:00,23
126,194,320,87,9.5,0,Clear,6.4,2023-05-06 00:00:00,0
109,119,228,89,8.7,0,Clear,6.5,2023-05-06 01:00:00,1
86,65,151,91,8.1,0,Clear,5.4,2023-05-06 02:00:00,2
37,34,71,91,9.2,0,Clear,4.7,2023-05-06 03:00:00,3
13,21,34,94,8.1,0,Clear,5.4,2023-05-06 04:00:00,4
19,40,59,95,7.3,0,Clear,6.1,2023-05-06 05:00:00,5
32,71,103,96,6.7,0,Clear,6.5,2023-05-06 06:00:00,6
50,133,183,95,7.3,0,Clear,7.9,2023-05-06 07:00:00,7
147,258,405,84,11.3,0,Clear,4.7,2023-05-06 08:00:00,8
290,386,676,72,14.6,0,Clear,2.6,2023-05-06 09:00:00,9
479,533,1012,60,17.1,0,Clear,2.2,2023-05-06 10:00:00,10
578,561,1139,51,18.6,0,Clear,1.1,2023-05-06 11:00:00,11
705,630,1335,47,19.7,0,Clear,1.0,2023-05-06 12:00:00,12
784,613,1397,43,20.6,1,Mostly Clear,3.6,2023-05-06 13:00:00,13
748,610,1358,40,21.3,1,Mostly Clear,4.1,2023-05-06 14:00:00,14
814,633,1447,38,21.5,1,Mostly Clear,3.7,2023-05-06 15:00:00,15
772,594,1366,38,21.9,1,Mostly Clear,5.2,2023-05-06 16:00:00,16
705,616,1321,38,21.7,1,Mostly Clear,5.6,2023-05-06 17:00:00,17
608,551,1159,40,21.4,1,Mostly Clear,2.9,2023-05-06 18:00:00,18
464,490,954,58,19.6,1,Mostly Clear,1.5,2023-05-06 19:00:00,19
352,362,714,64,18.3,1,Mostly Clear,4.8,2023-05-06 20:00:00,20
195,268,463,65,16.5,1,Mostly Clear,7.9,2023-05-06 21:00:00,21
185,196,381,69,15.1,1,Mostly Clear,10.0,2023-05-06 22:00:00,22
204,252,456,73,14.1,0,Clear,10.4,2023-05-06 23:00:00,23
134,142,276,76,13.4,0,Clear,9.4,2023-05-07 00:00:00,0
93,102,195,81,12.7,0,Clear,9.3,2023-05-07 01:00:00,1
61,72,133,85,12.1,0,Clear,9.5,2023-05-07 02:00:00,2
49,25,74,91,11.5,0,Clear,7.9,2023-05-07 03:00:00,3
11,12,23,93,10.9,0,Clear,7.2,2023-05-07 04:00:00,4
18,38,56,94,10.4,0,Clear,7.4,2023-05-07 05:00:00,5
53,75,128,94,10.0,0,Clear,5.8,2023-05-07 06:00:00,6
87,113,200,94,10.6,2,Partly Cloudy,7.1,2023-05-07 07:00:00,7
139,222,361,83,13.9,3,Cloudy,4.8,2023-05-07 08:00:00,8
288,369,657,77,15.6,2,Partly Cloudy,4.3,2023-05-07 09:00:00,9
427,462,889,71,18.2,0,Clear,3.4,2023-05-07 10:00:00,10
506,508,1014,65,20.5,1,Mostly Clear,4.3,2023-05-07 11:00:00,11
597,583,1180,59,22.4,1,Mostly Clear,4.4,2023-05-07 12:00:00,12
605,591,1196,55,23.7,1,Mostly Clear,6.0,2023-05-07 13:00:00,13
673,597,1270,52,24.5,1,Mostly Clear,6.9,2023-05-07 14:00:00,14
506,545,1051,54,24.0,1,Mostly Clear,7.9,2023-05-07 15:00:00,15
422,510,932,55,23.6,3,Cloudy,9.2,2023-05-07 16:00:00,16
287,353,640,62,22.4,51,Light Drizzle,8.7,2023-05-07 17:00:00,17
136,234,370,77,20.3,53,Heavy Drizzle,6.1,2023-05-07 18:00:00,18
113,234,347,89,19.0,55,Heavy Drizzle,4.9,2023-05-07 19:00:00,19
139,219,358,92,18.0,53,Heavy Drizzle,2.0,2023-05-07 20:00:00,20
111,168,279,95,17.6,51,Light Drizzle,6.0,2023-05-07 21:00:00,21
75,136,211,96,17.4,2,Partly Cloudy,6.3,2023-05-07 22:00:00,22
39,72,111,97,17.1,2,Partly Cloudy,5.8,2023-05-07 23:00:00,23
21,37,58,97,16.7,0,Clear,7.2,2023-05-08 00:00:00,0
18,21,39,96,16.3,1,Mostly Clear,9.1,2023-05-08 01:00:00,1
14,9,23,95,15.9,1,Mostly Clear,9.3,2023-05-08 02:00:00,2
7,3,10,96,15.2,1,Mostly Clear,9.6,2023-05-08 03:00:00,3
7,19,26,96,15.0,0,Clear,9.4,2023-05-08 04:00:00,4
18,61,79,97,14.9,0,Clear,9.5,2023-05-08 05:00:00,5
41,159,200,96,15.0,1,Mostly Clear,7.1,2023-05-08 06:00:00,6
99,411,510,96,15.8,1,Mostly Clear,8.7,2023-05-08 07:00:00,7
219,644,863,94,17.7,1,Mostly Clear,7.9,2023-05-08 08:00:00,8
199,405,604,88,19.7,1,Mostly Clear,5.8,2023-05-08 09:00:00,9
204,293,497,76,21.4,51,Light Drizzle,5.8,2023-05-08 10:00:00,10
229,305,534,67,22.5,1,Mostly Clear,6.9,2023-05-08 11:00:00,11
275,359,634,64,23.1,1,Mostly Clear,11.5,2023-05-08 12:00:00,12
261,341,602,60,23.8,2,Partly Cloudy,14.8,2023-05-08 13:00:00,13
270,369,639,59,23.8,2,Partly Cloudy,15.3,2023-05-08 14:00:00,14
311,499,810,46,26.4,1,Mostly Clear,14.4,2023-05-08 15:00:00,15
377,620,997,44,26.8,2,Partly Cloudy,13.3,2023-05-08 16:00:00,16
502,975,1477,45,26.5,2,Partly Cloudy,12.0,2023-05-08 17:00:00,17
509,880,1389,51,25.6,2,Partly Cloudy,9.0,2023-05-08 18:00:00,18
433,679,1112,58,24.1,1,Mostly Clear,5.2,2023-05-08 19:00:00,19
302,483,785,66,22.1,1,Mostly Clear,7.1,2023-05-08 20:00:00,20
208,296,504,71,20.3,1,Mostly Clear,8.2,2023-05-08 21:00:00,21
123,180,303,77,19.2,1,Mostly Clear,7.3,2023-05-08 22:00:00,22
67,102,169,85,18.0,3,Cloudy,5.7,2023-05-08 23:00:00,23
35,47,82,84,18.0,3,Cloudy,5.5,2023-05-09 00:00:00,0
15,24,39,83,17.9,3,Cloudy,4.4,2023-05-09 01:00:00,1
1,9,10,80,18.2,2,Partly Cloudy,4.3,2023-05-09 02:00:00,2
3,6,9,84,16.8,51,Light Drizzle,6.4,2023-05-09 03:00:00,3
5,20,25,85,16.3,2,Partly Cloudy,6.5,2023-05-09 04:00:00,4
22,64,86,86,15.9,2,Partly Cloudy,6.8,2023-05-09 05:00:00,5
72,212,284,87,15.3,1,Mostly Clear,8.1,2023-05-09 06:00:00,6
132,541,673,85,15.5,1,Mostly Clear,9.8,2023-05-09 07:00:00,7
261,857,1118,75,16.3,51,Light Drizzle,8.9,2023-05-09 08:00:00,8
103,333,436,66,16.7,51,Light Drizzle,9.4,2023-05-09 09:00:00,9
69,172,241,61,17.1,51,Light Drizzle,9.8,2023-05-09 10:00:00,10
100,228,328,59,17.1,51,Light Drizzle,10.0,2023-05-09 11:00:00,11
102,298,400,54,17.7,51,Light Drizzle,9.8,2023-05-09 12:00:00,12
139,322,461,52,18.1,51,Light Drizzle,8.9,2023-05-09 13:00:00,13
202,349,551,57,17.0,51,Light Drizzle,7.0,2023-05-09 14:00:00,14
241,437,678,69,16.0,51,Light Drizzle,6.0,2023-05-09 15:00:00,15
272,624,896,66,16.7,51,Light Drizzle,4.2,2023-05-09 16:00:00,16
533,1124,1657,65,17.0,0,Clear,2.5,2023-05-09 17:00:00,17
511,1024,1535,64,17.3,0,Clear,5.4,2023-05-09 18:00:00,18
412,710,1122,65,17.4,0,Clear,1.1,2023-05-09 19:00:00,19
296,501,797,73,16.3,0,Clear,5.0,2023-05-09 20:00:00,20
212,314,526,80,14.8,0,Clear,6.3,2023-05-09 21:00:00,21
129,211,340,87,13.6,0,Clear,5.9,2023-05-09 22:00:00,22
87,148,235,92,12.3,0,Clear,5.9,2023-05-09 23:00:00,23
32,71,103,93,11.8,0,Clear,5.7,2023-05-10 00:00:00,0
13,27,40,96,10.9,0,Clear,6.3,2023-05-10 01:00:00,1
2,10,12,97,10.3,0,Clear,8.4,2023-05-10 02:00:00,2
9,9,18,93,9.6,0,Clear,10.5,2023-05-10 03:00:00,3
8,12,20,88,9.4,0,Clear,10.4,2023-05-10 04:00:00,4
30,82,112,83,8.9,0,Clear,9.4,2023-05-10 05:00:00,5
60,211,271,79,8.5,0,Clear,9.3,2023-05-10 06:00:00,6
123,559,682,76,9.2,0,Clear,9.3,2023-05-10 07:00:00,7
316,962,1278,63,12.1,0,Clear,8.0,2023-05-10 08:00:00,8
233,588,821,59,14.1,0,Clear,7.5,2023-05-10 09:00:00,9
196,296,492,57,16.1,0,Clear,5.5,2023-05-10 10:00:00,10
237,350,587,53,17.9,0,Clear,3.6,2023-05-10 11:00:00,11
257,392,649,47,19.5,0,Clear,4.8,2023-05-10 12:00:00,12
287,417,704,42,20.7,0,Clear,5.3,2023-05-10 13:00:00,13
338,401,739,40,21.6,0,Clear,4.9,2023-05-10 14:00:00,14
334,502,836,38,21.8,0,Clear,3.9,2023-05-10 15:00:00,15
384,700,1084,38,22.0,0,Clear,4.3,2023-05-10 16:00:00,16
640,1158,1798,38,22.0,0,Clear,5.4,2023-05-10 17:00:00,17
629,1034,1663,38,21.7,0,Clear,6.2,2023-05-10 18:00:00,18
601,770,1371,48,20.5,0,Clear,4.3,2023-05-10 19:00:00,19
320,544,864,53,19.4,0,Clear,6.2,2023-05-10 20:00:00,20
254,411,665,57,18.4,0,Clear,6.0,2023-05-10 21:00:00,21
164,292,456,64,16.8,0,Clear,6.6,2023-05-10 22:00:00,22
111,133,244,80,13.7,0,Clear,8.2,2023-05-10 23:00:00,23
34,76,110,87,12.3,0,Clear,8.5,2023-05-11 00:00:00,0
16,29,45,91,11.6,0,Clear,8.8,2023-05-11 01:00:00,1
11,8,19,93,11.1,0,Clear,8.6,2023-05-11 02:00:00,2
6,13,19,87,11.1,0,Clear,8.3,2023-05-11 03:00:00,3
8,16,24,90,10.2,0,Clear,8.6,2023-05-11 04:00:00,4
28,81,109,91,9.8,0,Clear,8.4,2023-05-11 05:00:00,5
67,222,289,90,10.1,1,Mostly Clear,6.6,2023-05-11 06:00:00,6
150,513,663,88,11.3,1,Mostly Clear,3.3,2023-05-11 07:00:00,7
277,893,1170,82,14.2,1,Mostly Clear,2.3,2023-05-11 08:00:00,8
216,484,700,71,17.5,1,Mostly Clear,2.8,2023-05-11 09:00:00,9
210,288,498,61,20.1,1,Mostly Clear,3.3,2023-05-11 10:00:00,10
238,336,574,53,22.2,1,Mostly Clear,2.8,2023-05-11 11:00:00,11
253,387,640,47,23.6,1,Mostly Clear,2.6,2023-05-11 12:00:00,12
286,389,675,45,24.7,1,Mostly Clear,4.1,2023-05-11 13:00:00,13
316,349,665,43,25.5,1,Mostly Clear,4.7,2023-05-11 14:00:00,14
378,537,915,43,26.1,1,Mostly Clear,4.7,2023-05-11 15:00:00,15
384,702,1086,42,26.2,1,Mostly Clear,5.4,2023-05-11 16:00:00,16
651,1142,1793,42,26.1,0,Clear,6.6,2023-05-11 17:00:00,17
635,1033,1668,45,25.6,0,Clear,7.8,2023-05-11 18:00:00,18
528,795,1323,54,24.4,0,Clear,4.6,2023-05-11 19:00:00,19
408,586,994,62,22.6,0,Clear,7.6,2023-05-11 20:00:00,20
231,421,652,69,20.3,0,Clear,8.0,2023-05-11 21:00:00,21
179,326,505,77,18.7,1,Mostly Clear,8.0,2023-05-11 22:00:00,22
114,185,299,84,17.5,1,Mostly Clear,7.9,2023-05-11 23:00:00,23
83,101,184,89,16.7,1,Mostly Clear,8.1,2023-05-12 00:00:00,0
45,37,82,91,16.2,1,Mostly Clear,7.6,2023-05-12 01:00:00,1
31,28,59,91,15.8,1,Mostly Clear,7.6,2023-05-12 02:00:00,2
20,12,32,89,15.3,1,Mostly Clear,7.3,2023-05-12 03:00:00,3
9,22,31,91,14.6,1,Mostly Clear,8.2,2023-05-12 04:00:00,4
22,72,94,93,13.9,1,Mostly Clear,6.6,2023-05-12 05:00:00,5
67,171,238,95,13.4,1,Mostly Clear,3.9,2023-05-12 06:00:00,6
115,414,529,95,14.1,1,Mostly Clear,2.1,2023-05-12 07:00:00,7
226,620,846,85,17.5,1,Mostly Clear,1.8,2023-05-12 08:00:00,8
232,421,653,76,20.0,1,Mostly Clear,1.5,2023-05-12 09:00:00,9
234,339,573,69,22.4,1,Mostly Clear,0.0,2023-05-12 10:00:00,10
281,361,642,62,24.6,1,Mostly Clear,1.1,2023-05-12 11:00:00,11
363,420,783,56,26.4,1,Mostly Clear,1.9,2023-05-12 12:00:00,12
392,426,818,49,27.7,1,Mostly Clear,2.3,2023-05-12 13:00:00,13
369,531,900,44,28.4,1,Mostly Clear,3.8,2023-05-12 14:00:00,14
423,597,1020,47,28.4,1,Mostly Clear,4.5,2023-05-12 15:00:00,15
497,705,1202,46,28.5,1,Mostly Clear,4.9,2023-05-12 16:00:00,16
674,927,1601,46,28.2,1,Mostly Clear,5.4,2023-05-12 17:00:00,17
625,832,1457,53,27.2,1,Mostly Clear,5.4,2023-05-12 18:00:00,18
460,672,1132,62,25.7,1,Mostly Clear,5.6,2023-05-12 19:00:00,19
407,415,822,72,23.7,1,Mostly Clear,6.9,2023-05-12 20:00:00,20
269,349,618,78,22.2,1,Mostly Clear,6.8,2023-05-12 21:00:00,21
327,362,689,82,21.2,1,Mostly Clear,6.8,2023-05-12 22:00:00,22
256,302,558,86,20.5,1,Mostly Clear,7.8,2023-05-12 23:00:00,23
149,183,332,87,19.9,1,Mostly Clear,8.4,2023-05-13 00:00:00,0
119,138,257,87,19.5,1,Mostly Clear,8.1,2023-05-13 01:00:00,1
94,76,170,88,19.0,1,Mostly Clear,8.7,2023-05-13 02:00:00,2
24,37,61,85,18.8,1,Mostly Clear,9.2,2023-05-13 03:00:00,3
18,13,31,88,18.4,1,Mostly Clear,8.7,2023-05-13 04:00:00,4
20,31,51,89,18.2,3,Cloudy,7.4,2023-05-13 05:00:00,5
46,57,103,90,18.1,3,Cloudy,4.7,2023-05-13 06:00:00,6
76,122,198,88,18.7,51,Light Drizzle,3.2,2023-05-13 07:00:00,7
154,276,430,82,20.5,3,Cloudy,3.8,2023-05-13 08:00:00,8
243,388,631,77,21.9,3,Cloudy,3.1,2023-05-13 09:00:00,9
355,416,771,72,23.5,51,Light Drizzle,3.1,2023-05-13 10:00:00,10
430,478,908,75,23.4,53,Heavy Drizzle,5.4,2023-05-13 11:00:00,11
482,543,1025,78,23.1,53,Heavy Drizzle,7.4,2023-05-13 12:00:00,12
414,456,870,81,22.7,53,Heavy Drizzle,8.5,2023-05-13 13:00:00,13
328,412,740,86,22.0,53,Heavy Drizzle,9.8,2023-05-13 14:00:00,14
390,389,779,90,19.6,63,Rain,10.9,2023-05-13 15:00:00,15
130,194,324,91,18.9,63,Rain,9.8,2023-05-13 16:00:00,16
104,176,280,92,18.6,63,Rain,8.6,2023-05-13 17:00:00,17
137,219,356,93,18.2,55,Heavy Drizzle,3.1,2023-05-13 18:00:00,18
185,249,434,94,18.0,51,Light Drizzle,4.8,2023-05-13 19:00:00,19
197,251,448,93,17.8,1,Mostly Clear,7.0,2023-05-13 20:00:00,20
181,232,413,93,17.6,1,Mostly Clear,7.5,2023-05-13 21:00:00,21
165,244,409,94,17.3,1,Mostly Clear,8.4,2023-05-13 22:00:00,22
153,227,380,94,16.6,1,Mostly Clear,8.9,2023-05-13 23:00:00,23
110,169,279,93,16.1,0,Clear,9.4,2023-05-14 00:00:00,0
82,95,177,93,15.7,0,Clear,10.9,2023-05-14 01:00:00,1
60,61,121,93,15.4,0,Clear,12.1,2023-05-14 02:00:00,2
31,34,65,91,14.9,0,Clear,12.6,2023-05-14 03:00:00,3
8,16,24,85,14.1,0,Clear,12.3,2023-05-14 04:00:00,4
16,26,42,79,13.3,0,Clear,11.9,2023-05-14 05:00:00,5
28,61,89,75,12.8,0,Clear,10.1,2023-05-14 06:00:00,6
54,104,158,73,13.1,0,Clear,11.2,2023-05-14 07:00:00,7
132,206,338,70,15.0,1,Mostly Clear,11.5,2023-05-14 08:00:00,8
289,331,620,60,17.2,0,Clear,10.6,2023-05-14 09:00:00,9
456,486,942,52,19.0,0,Clear,11.2,2023-05-14 10:00:00,10
571,521,1092,46,20.5,0,Clear,9.7,2023-05-14 11:00:00,11
634,528,1162,41,21.7,0,Clear,8.7,2023-05-14 12:00:00,12
635,554,1189,38,22.6,0,Clear,7.1,2023-05-14 13:00:00,13
794,624,1418,36,23.4,0,Clear,6.5,2023-05-14 14:00:00,14
711,610,1321,33,24.2,0,Clear,7.3,2023-05-14 15:00:00,15
679,582,1261,33,24.5,1,Mostly Clear,8.3,2023-05-14 16:00:00,16
596,534,1130,33,24.5,0,Clear,9.1,2023-05-14 17:00:00,17
582,526,1108,36,24.1,0,Clear,7.3,2023-05-14 18:00:00,18
454,456,910,47,22.8,0,Clear,5.8,2023-05-14 19:00:00,19
311,349,660,54,20.9,1,Mostly Clear,6.4,2023-05-14 20:00:00,20
229,274,503,52,19.0,0,Clear,7.1,2023-05-14 21:00:00,21
148,162,310,48,17.9,1,Mostly Clear,8.7,2023-05-14 22:00:00,22
71,121,192,44,16.9,0,Clear,9.2,2023-05-14 23:00:00,23
25,65,90,44,16.0,0,Clear,11.9,2023-05-15 00:00:00,0
25,18,43,45,15.3,2,Partly Cloudy,13.4,2023-05-15 01:00:00,1
6,12,18,48,14.4,2,Partly Cloudy,12.4,2023-05-15 02:00:00,2
13,12,25,46,14.1,2,Partly Cloudy,11.4,2023-05-15 03:00:00,3
11,12,23,47,13.6,2,Partly Cloudy,10.2,2023-05-15 04:00:00,4
23,67,90,49,12.9,2,Partly Cloudy,9.7,2023-05-15 05:00:00,5
58,195,253,53,12.4,1,Mostly Clear,9.0,2023-05-15 06:00:00,6
117,407,524,59,12.3,1,Mostly Clear,8.7,2023-05-15 07:00:00,7
246,745,991,55,13.1,1,Mostly Clear,7.2,2023-05-15 08:00:00,8
221,391,612,53,14.1,1,Mostly Clear,4.9,2023-05-15 09:00:00,9
172,238,410,50,15.9,0,Clear,1.8,2023-05-15 10:00:00,10
260,333,593,46,17.6,0,Clear,1.4,2023-05-15 11:00:00,11
233,355,588,41,19.5,0,Clear,3.6,2023-05-15 12:00:00,12
284,368,652,38,21.1,0,Clear,4.7,2023-05-15 13:00:00,13
315,360,675,37,22.3,0,Clear,6.3,2023-05-15 14:00:00,14
397,470,867,37,23.0,0,Clear,8.0,2023-05-15 15:00:00,15
440,647,1087,38,23.4,0,Clear,9.8,2023-05-15 16:00:00,16
566,980,1546,39,23.4,0,Clear,11.3,2023-05-15 17:00:00,17
579,976,1555,42,22.9,0,Clear,10.2,2023-05-15 18:00:00,18
446,681,1127,49,21.7,0,Clear,9.7,2023-05-15 19:00:00,19
295,419,714,57,19.9,0,Clear,9.3,2023-05-15 20:00:00,20
186,326,512,59,18.5,0,Clear,11.1,2023-05-15 21:00:00,21
135,239,374,64,17.6,0,Clear,11.8,2023-05-15 22:00:00,22
66,111,177,69,16.8,0,Clear,12.0,2023-05-15 23:00:00,23
36,49,85,74,16.2,0,Clear,11.2,2023-05-16 00:00:00,0
20,28,48,80,15.6,0,Clear,10.4,2023-05-16 01:00:00,1
9,11,20,84,15.2,1,Mostly Clear,11.2,2023-05-16 02:00:00,2
9,9,18,86,14.7,1,Mostly Clear,11.2,2023-05-16 03:00:00,3
6,21,27,89,14.5,1,Mostly Clear,10.5,2023-05-16 04:00:00,4
22,75,97,91,14.3,0,Clear,10.5,2023-05-16 05:00:00,5
74,241,315,91,14.4,1,Mostly Clear,7.8,2023-05-16 06:00:00,6
186,578,764,88,15.2,1,Mostly Clear,8.4,2023-05-16 07:00:00,7
314,944,1258,80,17.2,2,Partly Cloudy,7.4,2023-05-16 08:00:00,8
221,496,717,73,19.1,2,Partly Cloudy,6.4,2023-05-16 09:00:00,9
188,299,487,68,20.8,1,Mostly Clear,5.2,2023-05-16 10:00:00,10
214,347,561,62,22.6,1,Mostly Clear,4.9,2023-05-16 11:00:00,11
241,378,619,54,24.3,1,Mostly Clear,5.4,2023-05-16 12:00:00,12
229,336,565,50,25.3,2,Partly Cloudy,10.0,2023-05-16 13:00:00,13
270,368,638,49,25.3,3,Cloudy,14.0,2023-05-16 14:00:00,14
275,523,798,47,24.9,3,Cloudy,14.2,2023-05-16 15:00:00,15
353,673,1026,50,24.6,3,Cloudy,13.0,2023-05-16 16:00:00,16
487,1071,1558,58,23.2,3,Cloudy,15.0,2023-05-16 17:00:00,17
445,858,1303,68,21.9,51,Light Drizzle,11.9,2023-05-16 18:00:00,18
280,537,817,75,20.9,51,Light Drizzle,9.5,2023-05-16 19:00:00,19
215,416,631,80,19.8,51,Light Drizzle,9.8,2023-05-16 20:00:00,20
210,379,589,82,19.0,51,Light Drizzle,10.9,2023-05-16 21:00:00,21
141,245,386,83,18.3,51,Light Drizzle,10.1,2023-05-16 22:00:00,22
85,136,221,88,17.5,51,Light Drizzle,10.7,2023-05-16 23:00:00,23
47,58,105,89,17.0,51,Light Drizzle,12.4,2023-05-17 00:00:00,0
13,27,40,90,16.6,51,Light Drizzle,12.5,2023-05-17 01:00:00,1
7,14,21,89,16.2,2,Partly Cloudy,13.4,2023-05-17 02:00:00,2
11,6,17,82,16.4,1,Mostly Clear,13.8,2023-05-17 03:00:00,3
8,23,31,81,15.9,0,Clear,14.1,2023-05-17 04:00:00,4
32,80,112,80,15.5,0,Clear,14.3,2023-05-17 05:00:00,5
91,253,344,80,15.1,0,Clear,13.4,2023-05-17 06:00:00,6
172,512,684,80,15.5,0,Clear,14.8,2023-05-17 07:00:00,7
315,971,1286,76,17.0,0,Clear,13.5,2023-05-17 08:00:00,8
238,552,790,64,18.4,0,Clear,16.4,2023-05-17 09:00:00,9
201,291,492,57,19.2,0,Clear,15.7,2023-05-17 10:00:00,10
226,339,565,51,20.0,0,Clear,14.8,2023-05-17 11:00:00,11
247,371,618,46,20.6,0,Clear,15.0,2023-05-17 12:00:00,12
237,349,586,40,21.2,0,Clear,15.2,2023-05-17 13:00:00,13
329,420,749,36,21.5,0,Clear,14.1,2023-05-17 14:00:00,14
307,537,844,36,22.0,0,Clear,13.0,2023-05-17 15:00:00,15
438,698,1136,34,22.0,0,Clear,11.9,2023-05-17 16:00:00,16
631,1190,1821,33,21.8,0,Clear,12.2,2023-05-17 17:00:00,17
632,1037,1669,33,21.2,0,Clear,9.3,2023-05-17 18:00:00,18
490,723,1213,36,20.0,0,Clear,10.2,2023-05-17 19:00:00,19
366,509,875,40,18.2,0,Clear,10.2,2023-05-17 20:00:00,20
178,372,550,39,16.7,0,Clear,10.8,2023-05-17 21:00:00,21
170,227,397,41,15.5,0,Clear,11.6,2023-05-17 22:00:00,22
113,120,233,43,14.6,0,Clear,11.3,2023-05-17 23:00:00,23
40,66,106,45,13.8,0,Clear,11.8,2023-05-18 00:00:00,0
26,25,51,47,13.0,0,Clear,12.3,2023-05-18 01:00:00,1
13,13,26,49,12.3,0,Clear,12.0,2023-05-18 02:00:00,2
3,9,12,51,11.5,0,Clear,12.7,2023-05-18 03:00:00,3
10,18,28,50,11.0,0,Clear,12.5,2023-05-18 04:00:00,4
27,78,105,51,10.4,0,Clear,11.5,2023-05-18 05:00:00,5
61,196,257,55,9.9,0,Clear,10.2,2023-05-18 06:00:00,6
160,493,653,61,10.0,0,Clear,9.9,2023-05-18 07:00:00,7
305,884,1189,54,11.7,0,Clear,9.9,2023-05-18 08:00:00,8
231,528,759,54,13.4,0,Clear,8.1,2023-05-18 09:00:00,9
217,287,504,54,15.1,0,Clear,6.9,2023-05-18 10:00:00,10
241,321,562,53,16.5,0,Clear,7.3,2023-05-18 11:00:00,11
293,390,683,50,17.9,0,Clear,7.7,2023-05-18 12:00:00,12
288,389,677,47,19.1,0,Clear,8.9,2023-05-18 13:00:00,13
328,422,750,45,20.0,0,Clear,9.9,2023-05-18 14:00:00,14
335,517,852,45,20.3,0,Clear,10.4,2023-05-18 15:00:00,15
468,701,1169,45,20.5,0,Clear,12.5,2023-05-18 16:00:00,16
648,1179,1827,45,20.2,2,Partly Cloudy,13.0,2023-05-18 17:00:00,17
603,980,1583,47,19.4,3,Cloudy,11.4,2023-05-18 18:00:00,18
432,671,1103,50,18.5,3,Cloudy,11.8,2023-05-18 19:00:00,19
340,534,874,55,17.4,3,Cloudy,10.7,2023-05-18 20:00:00,20
202,323,525,58,16.3,3,Cloudy,11.4,2023-05-18 21:00:00,21
169,256,425,61,15.4,3,Cloudy,11.9,2023-05-18 22:00:00,22
108,157,265,63,14.5,2,Partly Cloudy,11.9,2023-05-18 23:00:00,23
65,91,156,66,14.0,2,Partly Cloudy,12.4,2023-05-19 00:00:00,0
32,38,70,72,13.4,1,Mostly Clear,11.3,2023-05-19 01:00:00,1
17,24,41,78,12.9,1,Mostly Clear,10.0,2023-05-19 02:00:00,2
8,15,23,83,12.6,1,Mostly Clear,8.9,2023-05-19 03:00:00,3
8,12,20,89,12.2,1,Mostly Clear,8.2,2023-05-19 04:00:00,4
35,46,81,92,12.3,1,Mostly Clear,7.4,2023-05-19 05:00:00,5
66,204,270,94,12.4,1,Mostly Clear,4.0,2023-05-19 06:00:00,6
159,487,646,93,13.5,1,Mostly Clear,6.1,2023-05-19 07:00:00,7
294,720,1014,83,16.4,2,Partly Cloudy,5.2,2023-05-19 08:00:00,8
277,439,716,73,17.9,3,Cloudy,8.3,2023-05-19 09:00:00,9
255,341,596,67,19.1,51,Light Drizzle,14.2,2023-05-19 10:00:00,10
328,366,694,63,19.6,51,Light Drizzle,14.1,2023-05-19 11:00:00,11
404,428,832,59,20.5,51,Light Drizzle,14.5,2023-05-19 12:00:00,12
438,437,875,54,21.3,51,Light Drizzle,14.4,2023-05-19 13:00:00,13
469,479,948,53,21.5,3,Cloudy,15.6,2023-05-19 14:00:00,14
469,627,1096,50,22.4,3,Cloudy,17.3,2023-05-19 15:00:00,15
581,747,1328,49,22.1,3,Cloudy,16.2,2023-05-19 16:00:00,16
732,1011,1743,49,21.7,3,Cloudy,15.5,2023-05-19 17:00:00,17
674,746,1420,51,20.9,3,Cloudy,12.4,2023-05-19 18:00:00,18
488,631,1119,54,20.0,3,Cloudy,11.3,2023-05-19 19:00:00,19
388,487,875,59,18.9,3,Cloudy,11.0,2023-05-19 20:00:00,20
287,297,584,64,17.8,1,Mostly Clear,9.9,2023-05-19 21:00:00,21
221,284,505,72,16.8,0,Clear,10.7,2023-05-19 22:00:00,22
227,284,511,80,15.8,0,Clear,10.4,2023-05-19 23:00:00,23
126,157,283,87,15.1,0,Clear,9.3,2023-05-20 00:00:00,0
95,116,211,92,14.5,0,Clear,8.2,2023-05-20 01:00:00,1
60,69,129,95,13.7,1,Mostly Clear,6.3,2023-05-20 02:00:00,2
31,33,64,94,14.1,1,Mostly Clear,5.6,2023-05-20 03:00:00,3
12,17,29,97,13.0,1,Mostly Clear,4.9,2023-05-20 04:00:00,4
23,29,52,98,12.7,1,Mostly Clear,5.9,2023-05-20 05:00:00,5
81,100,181,98,12.4,1,Mostly Clear,3.9,2023-05-20 06:00:00,6
92,140,232,97,13.6,1,Mostly Clear,4.8,2023-05-20 07:00:00,7
170,237,407,87,16.3,2,Partly Cloudy,4.1,2023-05-20 08:00:00,8
305,410,715,82,17.8,3,Cloudy,3.4,2023-05-20 09:00:00,9
427,467,894,76,19.1,3,Cloudy,2.5,2023-05-20 10:00:00,10
652,476,1128,67,20.8,1,Mostly Clear,3.8,2023-05-20 11:00:00,11
693,615,1308,62,22.1,1,Mostly Clear,4.1,2023-05-20 12:00:00,12
814,576,1390,60,23.2,1,Mostly Clear,5.1,2023-05-20 13:00:00,13
813,630,1443,57,24.3,1,Mostly Clear,5.4,2023-05-20 14:00:00,14
778,579,1357,54,25.6,2,Partly Cloudy,7.7,2023-05-20 15:00:00,15
693,584,1277,50,26.5,3,Cloudy,10.8,2023-05-20 16:00:00,16
672,624,1296,50,26.5,3,Cloudy,11.9,2023-05-20 17:00:00,17
606,587,1193,54,26.0,1,Mostly Clear,3.7,2023-05-20 18:00:00,18
203,245,448,60,24.5,51,Light Drizzle,4.3,2023-05-20 19:00:00,19
71,111,182,71,22.6,53,Heavy Drizzle,7.4,2023-05-20 20:00:00,20
134,194,328,80,21.1,51,Light Drizzle,11.2,2023-05-20 21:00:00,21
134,202,336,86,20.3,51,Light Drizzle,13.3,2023-05-20 22:00:00,22
137,196,333,90,19.4,51,Light Drizzle,14.3,2023-05-20 23:00:00,23
108,125,233,92,18.4,51,Light Drizzle,15.0,2023-05-21 00:00:00,0
60,93,153,91,17.5,51,Light Drizzle,14.8,2023-05-21 01:00:00,1
59,55,114,90,16.6,1,Mostly Clear,13.3,2023-05-21 02:00:00,2
39,21,60,87,15.6,1,Mostly Clear,13.3,2023-05-21 03:00:00,3
13,6,19,85,14.7,0,Clear,12.5,2023-05-21 04:00:00,4
14,25,39,82,13.8,0,Clear,12.2,2023-05-21 05:00:00,5
42,56,98,81,12.8,0,Clear,10.9,2023-05-21 06:00:00,6
66,141,207,79,12.9,0,Clear,12.3,2023-05-21 07:00:00,7
169,198,367,72,14.1,0,Clear,14.0,2023-05-21 08:00:00,8
346,339,685,65,15.8,0,Clear,15.8,2023-05-21 09:00:00,9
498,441,939,57,17.7,0,Clear,15.0,2023-05-21 10:00:00,10
546,504,1050,51,19.7,0,Clear,15.2,2023-05-21 11:00:00,11
675,531,1206,46,21.3,1,Mostly Clear,16.3,2023-05-21 12:00:00,12
707,600,1307,41,23.0,0,Clear,15.1,2023-05-21 13:00:00,13
698,562,1260,37,24.2,0,Clear,15.0,2023-05-21 14:00:00,14
682,517,1199,38,24.8,0,Clear,14.0,2023-05-21 15:00:00,15
649,597,1246,36,25.4,0,Clear,13.7,2023-05-21 16:00:00,16
633,557,1190,35,25.7,0,Clear,13.2,2023-05-21 17:00:00,17
575,516,1091,34,25.6,0,Clear,11.6,2023-05-21 18:00:00,18
452,433,885,42,24.6,0,Clear,7.9,2023-05-21 19:00:00,19
304,310,614,61,22.5,0,Clear,5.7,2023-05-21 20:00:00,20
226,254,480,59,20.4,0,Clear,5.9,2023-05-21 21:00:00,21
164,170,334,64,18.3,0,Clear,6.3,2023-05-21 22:00:00,22
89,106,195,66,16.9,0,Clear,6.4,2023-05-21 23:00:00,23
34,53,87,65,16.2,0,Clear,6.9,2023-05-22 00:00:00,0
23,18,41,65,15.8,0,Clear,7.7,2023-05-22 01:00:00,1
5,11,16,67,15.3,0,Clear,8.4,2023-05-22 02:00:00,2
12,10,22,73,14.5,0,Clear,7.9,2023-05-22 03:00:00,3
7,11,18,77,13.9,0,Clear,7.7,2023-05-22 04:00:00,4
22,68,90,81,13.3,0,Clear,8.1,2023-05-22 05:00:00,5
56,190,246,84,12.9,0,Clear,6.2,2023-05-22 06:00:00,6
155,445,600,85,13.7,0,Clear,7.6,2023-05-22 07:00:00,7
234,672,906,67,17.9,0,Clear,5.1,2023-05-22 08:00:00,8
226,422,648,56,20.3,0,Clear,5.7,2023-05-22 09:00:00,9
258,235,493,48,22.3,0,Clear,6.1,2023-05-22 10:00:00,10
296,288,584,42,23.7,0,Clear,6.2,2023-05-22 11:00:00,11
318,387,705,38,24.9,0,Clear,7.6,2023-05-22 12:00:00,12
324,386,710,36,25.7,1,Mostly Clear,9.3,2023-05-22 13:00:00,13
333,379,712,34,25.9,1,Mostly Clear,10.5,2023-05-22 14:00:00,14
376,437,813,35,25.9,1,Mostly Clear,10.4,2023-05-22 15:00:00,15
425,609,1034,35,25.8,1,Mostly Clear,10.8,2023-05-22 16:00:00,16
574,999,1573,37,25.3,1,Mostly Clear,11.2,2023-05-22 17:00:00,17
597,884,1481,39,24.7,2,Partly Cloudy,8.5,2023-05-22 18:00:00,18
446,681,1127,46,23.5,2,Partly Cloudy,6.8,2023-05-22 19:00:00,19
358,504,862,55,22.2,2,Partly Cloudy,6.3,2023-05-22 20:00:00,20
189,318,507,60,20.4,1,Mostly Clear,6.6,2023-05-22 21:00:00,21
138,179,317,67,19.0,1,Mostly Clear,7.4,2023-05-22 22:00:00,22
61,123,184,72,18.0,1,Mostly Clear,12.8,2023-05-22 23:00:00,23
40,36,76,77,17.3,1,Mostly Clear,12.6,2023-05-23 00:00:00,0
18,21,39,82,16.5,1,Mostly Clear,9.7,2023-05-23 01:00:00,1
14,10,24,89,15.4,1,Mostly Clear,6.4,2023-05-23 02:00:00,2
4,10,14,90,14.9,1,Mostly Clear,5.2,2023-05-23 03:00:00,3
6,24,30,91,14.4,1,Mostly Clear,5.4,2023-05-23 04:00:00,4
28,82,110,92,14.1,1,Mostly Clear,5.5,2023-05-23 05:00:00,5
75,213,288,92,13.9,1,Mostly Clear,5.9,2023-05-23 06:00:00,6
200,585,785,91,14.7,1,Mostly Clear,7.9,2023-05-23 07:00:00,7
289,932,1221,77,17.2,2,Partly Cloudy,8.1,2023-05-23 08:00:00,8
245,466,711,68,18.6,2,Partly Cloudy,7.6,2023-05-23 09:00:00,9
185,275,460,58,20.2,2,Partly Cloudy,8.6,2023-05-23 10:00:00,10
198,317,515,52,21.6,1,Mostly Clear,9.8,2023-05-23 11:00:00,11
258,365,623,47,22.7,1,Mostly Clear,11.0,2023-05-23 12:00:00,12
246,376,622,44,23.4,1,Mostly Clear,12.3,2023-05-23 13:00:00,13
320,361,681,42,23.7,1,Mostly Clear,13.7,2023-05-23 14:00:00,14
386,495,881,44,23.2,1,Mostly Clear,13.3,2023-05-23 15:00:00,15
460,726,1186,44,23.0,1,Mostly Clear,13.3,2023-05-23 16:00:00,16
695,1167,1862,44,22.5,1,Mostly Clear,13.1,2023-05-23 17:00:00,17
636,954,1590,45,21.8,1,Mostly Clear,9.7,2023-05-23 18:00:00,18
443,672,1115,46,20.8,1,Mostly Clear,9.0,2023-05-23 19:00:00,19
305,511,816,51,19.5,1,Mostly Clear,7.1,2023-05-23 20:00:00,20
208,365,573,54,18.1,1,Mostly Clear,7.6,2023-05-23 21:00:00,21
161,284,445,60,16.7,0,Clear,7.8,2023-05-23 22:00:00,22
167,258,425,68,15.4,0,Clear,6.5,2023-05-23 23:00:00,23
29,64,93,75,14.3,0,Clear,5.4,2023-05-24 00:00:00,0
13,22,35,80,13.2,0,Clear,4.7,2023-05-24 01:00:00,1
9,10,19,83,12.7,0,Clear,4.7,2023-05-24 02:00:00,2
6,17,23,84,12.7,0,Clear,6.2,2023-05-24 03:00:00,3
6,17,23,84,12.6,0,Clear,7.0,2023-05-24 04:00:00,4
22,83,105,87,12.1,0,Clear,5.9,2023-05-24 05:00:00,5
74,234,308,89,11.6,0,Clear,5.9,2023-05-24 06:00:00,6
168,528,696,88,12.8,0,Clear,7.1,2023-05-24 07:00:00,7
300,924,1224,68,15.9,0,Clear,6.6,2023-05-24 08:00:00,8
253,462,715,58,17.9,0,Clear,4.9,2023-05-24 09:00:00,9
191,339,530,52,20.0,0,Clear,4.0,2023-05-24 10:00:00,10
243,308,551,49,22.0,0,Clear,4.2,2023-05-24 11:00:00,11
260,420,680,45,23.8,1,Mostly Clear,5.4,2023-05-24 12:00:00,12
273,385,658,40,25.2,0,Clear,5.6,2023-05-24 13:00:00,13
286,415,701,37,26.2,0,Clear,4.2,2023-05-24 14:00:00,14
293,503,796,34,26.7,0,Clear,3.4,2023-05-24 15:00:00,15
390,692,1082,33,27.0,1,Mostly Clear,2.2,2023-05-24 16:00:00,16
622,1231,1853,32,27.1,1,Mostly Clear,1.5,2023-05-24 17:00:00,17
615,1006,1621,35,26.3,1,Mostly Clear,2.3,2023-05-24 18:00:00,18
462,692,1154,42,24.5,0,Clear,5.4,2023-05-24 19:00:00,19
337,513,850,48,22.7,0,Clear,8.7,2023-05-24 20:00:00,20
286,416,702,51,21.0,0,Clear,9.9,2023-05-24 21:00:00,21
164,294,458,55,20.0,0,Clear,7.9,2023-05-24 22:00:00,22
127,183,310,64,18.8,1,Mostly Clear,3.2,2023-05-24 23:00:00,23
41,70,111,63,18.2,1,Mostly Clear,11.9,2023-05-25 00:00:00,0
23,26,49,65,18.0,1,Mostly Clear,18.2,2023-05-25 01:00:00,1
9,16,25,69,17.6,0,Clear,19.4,2023-05-25 02:00:00,2
3,6,9,71,15.9,0,Clear,18.1,2023-05-25 03:00:00,3
4,12,16,69,15.3,0,Clear,18.2,2023-05-25 04:00:00,4
24,58,82,65,14.6,0,Clear,17.3,2023-05-25 05:00:00,5
82,192,274,62,13.8,1,Mostly Clear,15.6,2023-05-25 06:00:00,6
151,494,645,60,13.5,1,Mostly Clear,16.2,2023-05-25 07:00:00,7
301,853,1154,57,13.9,1,Mostly Clear,15.7,2023-05-25 08:00:00,8
181,508,689,53,14.6,1,Mostly Clear,14.7,2023-05-25 09:00:00,9
197,279,476,49,15.9,0,Clear,12.6,2023-05-25 10:00:00,10
213,328,541,45,17.4,0,Clear,11.0,2023-05-25 11:00:00,11
275,379,654,41,18.6,0,Clear,9.7,2023-05-25 12:00:00,12
287,388,675,38,19.8,0,Clear,8.9,2023-05-25 13:00:00,13
309,385,694,35,20.9,0,Clear,9.3,2023-05-25 14:00:00,14
385,519,904,31,21.3,0,Clear,9.3,2023-05-25 15:00:00,15
416,687,1103,29,21.8,0,Clear,9.2,2023-05-25 16:00:00,16
653,1051,1704,28,21.8,0,Clear,9.4,2023-05-25 17:00:00,17
645,954,1599,28,21.4,0,Clear,8.2,2023-05-25 18:00:00,18
510,665,1175,30,20.7,0,Clear,7.7,2023-05-25 19:00:00,19
404,513,917,41,19.2,0,Clear,4.1,2023-05-25 20:00:00,20
238,331,569,53,17.1,0,Clear,5.9,2023-05-25 21:00:00,21
175,264,439,57,16.2,0,Clear,6.4,2023-05-25 22:00:00,22
116,166,282,55,16.0,0,Clear,5.0,2023-05-25 23:00:00,23
65,87,152,56,16.0,0,Clear,5.8,2023-05-26 00:00:00,0
34,37,71,62,14.8,0,Clear,5.9,2023-05-26 01:00:00,1
3,9,12,79,12.2,0,Clear,4.0,2023-05-26 02:00:00,2
6,11,17,77,14.0,0,Clear,1.6,2023-05-26 03:00:00,3
11,23,34,85,12.7,0,Clear,4.9,2023-05-26 04:00:00,4
30,47,77,91,11.5,0,Clear,6.9,2023-05-26 05:00:00,5
62,147,209,93,10.8,0,Clear,5.0,2023-05-26 06:00:00,6
134,359,493,91,11.7,0,Clear,4.7,2023-05-26 07:00:00,7
202,503,705,76,15.0,0,Clear,2.9,2023-05-26 08:00:00,8
255,399,654,61,16.9,0,Clear,3.0,2023-05-26 09:00:00,9
289,319,608,53,18.6,0,Clear,4.3,2023-05-26 10:00:00,10
337,389,726,46,20.0,0,Clear,6.6,2023-05-26 11:00:00,11
398,432,830,40,21.3,1,Mostly Clear,8.7,2023-05-26 12:00:00,12
445,462,907,37,22.1,1,Mostly Clear,10.1,2023-05-26 13:00:00,13
513,553,1066,36,22.7,0,Clear,9.8,2023-05-26 14:00:00,14
548,648,1196,33,23.2,0,Clear,9.1,2023-05-26 15:00:00,15
572,719,1291,33,23.3,0,Clear,9.0,2023-05-26 16:00:00,16
672,842,1514,33,23.2,0,Clear,9.4,2023-05-26 17:00:00,17
558,629,1187,34,22.6,0,Clear,8.4,2023-05-26 18:00:00,18
491,538,1029,38,21.5,1,Mostly Clear,7.9,2023-05-26 19:00:00,19
370,408,778,46,19.9,0,Clear,6.5,2023-05-26 20:00:00,20
283,297,580,51,18.2,0,Clear,5.2,2023-05-26 21:00:00,21
268,248,516,58,16.8,0,Clear,6.6,2023-05-26 22:00:00,22
201,213,414,66,15.6,0,Clear,8.7,2023-05-26 23:00:00,23
81,123,204,73,14.4,0,Clear,7.9,2023-05-27 00:00:00,0
117,83,200,79,13.5,0,Clear,5.9,2023-05-27 01:00:00,1
57,53,110,76,13.6,0,Clear,6.0,2023-05-27 02:00:00,2
28,13,41,71,14.2,1,Mostly Clear,3.9,2023-05-27 03:00:00,3
7,13,20,79,12.7,1,Mostly Clear,5.0,2023-05-27 04:00:00,4
19,20,39,85,11.3,1,Mostly Clear,4.8,2023-05-27 05:00:00,5
32,61,93,86,10.7,1,Mostly Clear,5.1,2023-05-27 06:00:00,6
77,134,211,83,12.1,1,Mostly Clear,7.6,2023-05-27 07:00:00,7
177,231,408,57,16.3,1,Mostly Clear,5.8,2023-05-27 08:00:00,8
377,395,772,42,18.4,1,Mostly Clear,6.7,2023-05-27 09:00:00,9
475,410,885,37,20.1,1,Mostly Clear,8.7,2023-05-27 10:00:00,10
592,491,1083,34,21.4,1,Mostly Clear,11.2,2023-05-27 11:00:00,11
769,523,1292,32,22.5,1,Mostly Clear,13.1,2023-05-27 12:00:00,12
824,499,1323,30,23.2,1,Mostly Clear,13.3,2023-05-27 13:00:00,13
893,534,1427,29,23.8,1,Mostly Clear,12.6,2023-05-27 14:00:00,14
761,601,1362,29,23.9,1,Mostly Clear,13.0,2023-05-27 15:00:00,15
703,504,1207,29,23.9,1,Mostly Clear,13.5,2023-05-27 16:00:00,16
642,587,1229,30,23.4,1,Mostly Clear,13.1,2023-05-27 17:00:00,17
624,469,1093,32,22.6,1,Mostly Clear,9.4,2023-05-27 18:00:00,18
469,456,925,36,21.6,1,Mostly Clear,8.6,2023-05-27 19:00:00,19
419,308,727,44,20.3,1,Mostly Clear,6.0,2023-05-27 20:00:00,20
247,274,521,47,18.8,1,Mostly Clear,7.7,2023-05-27 21:00:00,21
217,196,413,53,17.7,1,Mostly Clear,9.5,2023-05-27 22:00:00,22
157,187,344,58,16.8,1,Mostly Clear,8.8,2023-05-27 23:00:00,23
86,123,209,63,15.9,1,Mostly Clear,6.8,2023-05-28 00:00:00,0
76,74,150,70,14.8,1,Mostly Clear,6.2,2023-05-28 01:00:00,1
55,39,94,74,13.9,1,Mostly Clear,6.5,2023-05-28 02:00:00,2
24,19,43,69,13.5,2,Partly Cloudy,7.1,2023-05-28 03:00:00,3
12,8,20,69,13.4,2,Partly Cloudy,7.4,2023-05-28 04:00:00,4
19,22,41,70,13.2,2,Partly Cloudy,7.9,2023-05-28 05:00:00,5
27,50,77,73,13.1,2,Partly Cloudy,8.4,2023-05-28 06:00:00,6
51,116,167,75,13.8,1,Mostly Clear,10.2,2023-05-28 07:00:00,7
100,145,245,64,16.1,2,Partly Cloudy,9.7,2023-05-28 08:00:00,8
333,254,587,60,17.5,2,Partly Cloudy,10.2,2023-05-28 09:00:00,9
476,374,850,55,18.8,2,Partly Cloudy,11.4,2023-05-28 10:00:00,10
660,415,1075,52,19.7,3,Cloudy,11.7,2023-05-28 11:00:00,11
654,407,1061,50,20.6,3,Cloudy,11.9,2023-05-28 12:00:00,12
760,444,1204,47,21.8,3,Cloudy,12.4,2023-05-28 13:00:00,13
763,449,1212,43,23.1,3,Cloudy,12.8,2023-05-28 14:00:00,14
669,501,1170,60,21.1,53,Heavy Drizzle,13.8,2023-05-28 15:00:00,15
698,492,1190,62,21.1,3,Cloudy,13.5,2023-05-28 16:00:00,16
592,441,1033,62,21.2,3,Cloudy,13.7,2023-05-28 17:00:00,17
481,358,839,66,20.5,3,Cloudy,5.1,2023-05-28 18:00:00,18
400,407,807,70,20.1,3,Cloudy,3.1,2023-05-28 19:00:00,19
283,265,548,74,19.6,3,Cloudy,5.4,2023-05-28 20:00:00,20
281,218,499,77,19.0,3,Cloudy,6.1,2023-05-28 21:00:00,21
203,188,391,80,18.5,2,Partly Cloudy,6.3,2023-05-28 22:00:00,22
153,159,312,82,18.2,51,Light Drizzle,7.4,2023-05-28 23:00:00,23
76,95,171,84,17.9,51,Light Drizzle,7.9,2023-05-29 00:00:00,0
44,62,106,86,17.6,51,Light Drizzle,7.3,2023-05-29 01:00:00,1
28,27,55,89,17.1,51,Light Drizzle,8.5,2023-05-29 02:00:00,2
20,27,47,93,17.4,53,Heavy Drizzle,7.9,2023-05-29 03:00:00,3
12,6,18,94,17.1,53,Heavy Drizzle,8.9,2023-05-29 04:00:00,4
8,8,16,95,17.0,53,Heavy Drizzle,9.9,2023-05-29 05:00:00,5
7,14,21,95,17.1,61,Light Rain,7.9,2023-05-29 06:00:00,6
29,57,86,96,17.1,55,Heavy Drizzle,8.5,2023-05-29 07:00:00,7
76,134,210,95,17.5,53,Heavy Drizzle,7.4,2023-05-29 08:00:00,8
244,234,478,93,18.2,51,Light Drizzle,7.9,2023-05-29 09:00:00,9
383,334,717,90,18.8,53,Heavy Drizzle,8.6,2023-05-29 10:00:00,10
453,433,886,87,19.7,51,Light Drizzle,9.0,2023-05-29 11:00:00,11
528,442,970,84,20.6,51,Light Drizzle,11.6,2023-05-29 12:00:00,12
413,409,822,80,21.9,51,Light Drizzle,11.6,2023-05-29 13:00:00,13
193,173,366,76,22.5,51,Light Drizzle,11.9,2023-05-29 14:00:00,14
188,174,362,77,22.5,53,Heavy Drizzle,11.5,2023-05-29 15:00:00,15
113,166,279,81,22.2,51,Light Drizzle,9.8,2023-05-29 16:00:00,16
226,303,529,79,22.7,3,Cloudy,9.4,2023-05-29 17:00:00,17
114,217,331,78,22.6,2,Partly Cloudy,11.9,2023-05-29 18:00:00,18
167,196,363,81,22.1,2,Partly Cloudy,10.1,2023-05-29 19:00:00,19
117,223,340,86,21.0,2,Partly Cloudy,11.6,2023-05-29 20:00:00,20
105,149,254,88,20.3,51,Light Drizzle,12.3,2023-05-29 21:00:00,21
111,131,242,88,19.5,3,Cloudy,13.3,2023-05-29 22:00:00,22
32,92,124,87,18.6,51,Light Drizzle,13.0,2023-05-29 23:00:00,23
5,17,22,85,17.7,51,Light Drizzle,13.4,2023-05-30 00:00:00,0
10,16,26,82,16.8,1,Mostly Clear,13.9,2023-05-30 01:00:00,1
6,9,15,81,16.2,0,Clear,12.6,2023-05-30 02:00:00,2
6,10,16,86,14.8,0,Clear,11.6,2023-05-30 03:00:00,3
9,15,24,86,14.5,1,Mostly Clear,11.8,2023-05-30 04:00:00,4
22,62,84,86,14.2,1,Mostly Clear,11.0,2023-05-30 05:00:00,5
59,185,244,87,14.0,0,Clear,9.1,2023-05-30 06:00:00,6
132,487,619,88,14.5,2,Partly Cloudy,10.0,2023-05-30 07:00:00,7
238,865,1103,79,15.7,3,Cloudy,15.0,2023-05-30 08:00:00,8
193,455,648,71,17.1,2,Partly Cloudy,14.5,2023-05-30 09:00:00,9
138,246,384,65,18.5,0,Clear,12.9,2023-05-30 10:00:00,10
159,282,441,59,20.1,0,Clear,12.9,2023-05-30 11:00:00,11
233,363,596,55,21.5,0,Clear,13.0,2023-05-30 12:00:00,12
230,317,547,51,22.6,0,Clear,14.0,2023-05-30 13:00:00,13
265,385,650,48,23.4,0,Clear,14.4,2023-05-30 14:00:00,14
336,465,801,49,23.5,0,Clear,14.2,2023-05-30 15:00:00,15
385,710,1095,47,23.4,0,Clear,13.8,2023-05-30 16:00:00,16
531,1150,1681,45,23.5,0,Clear,13.4,2023-05-30 17:00:00,17
531,1063,1594,45,23.1,1,Mostly Clear,9.8,2023-05-30 18:00:00,18
450,743,1193,49,22.2,1,Mostly Clear,9.4,2023-05-30 19:00:00,19
322,541,863,58,20.6,1,Mostly Clear,8.0,2023-05-30 20:00:00,20
225,382,607,66,18.9,1,Mostly Clear,8.2,2023-05-30 21:00:00,21
140,244,384,73,17.6,1,Mostly Clear,9.8,2023-05-30 22:00:00,22
92,122,214,77,16.5,1,Mostly Clear,9.2,2023-05-30 23:00:00,23
28,52,80,82,15.5,1,Mostly Clear,7.8,2023-05-31 00:00:00,0
8,23,31,86,14.4,1,Mostly Clear,6.2,2023-05-31 01:00:00,1
5,14,19,91,13.3,0,Clear,5.5,2023-05-31 02:00:00,2
4,14,18,91,12.6,0,Clear,6.2,2023-05-31 03:00:00,3
8,23,31,92,11.9,0,Clear,6.1,2023-05-31 04:00:00,4
29,83,112,93,11.3,0,Clear,6.0,2023-05-31 05:00:00,5
82,232,314,94,10.8,0,Clear,6.6,2023-05-31 06:00:00,6
163,532,695,93,12.0,0,Clear,7.2,2023-05-31 07:00:00,7
317,1033,1350,70,15.7,0,Clear,8.7,2023-05-31 08:00:00,8
231,531,762,54,17.5,0,Clear,8.4,2023-05-31 09:00:00,9
204,323,527,42,19.5,0,Clear,8.2,2023-05-31 10:00:00,10
198,331,529,34,21.4,0,Clear,7.9,2023-05-31 11:00:00,11
235,432,667,29,23.0,0,Clear,7.9,2023-05-31 12:00:00,12
245,434,679,26,24.3,0,Clear,8.7,2023-05-31 13:00:00,13
299,387,686,25,25.2,0,Clear,9.4,2023-05-31 14:00:00,14
317,572,889,29,24.9,0,Clear,10.1,2023-05-31 15:00:00,15
386,703,1089,30,24.9,0,Clear,10.2,2023-05-31 16:00:00,16
567,1264,1831,31,24.7,0,Clear,9.5,2023-05-31 17:00:00,17
587,1138,1725,34,24.1,0,Clear,7.3,2023-05-31 18:00:00,18
477,730,1207,39,23.0,0,Clear,6.8,2023-05-31 19:00:00,19
355,561,916,50,21.4,0,Clear,5.2,2023-05-31 20:00:00,20
246,413,659,59,19.4,0,Clear,6.2,2023-05-31 21:00:00,21
193,269,462,71,17.5,0,Clear,6.9,2023-05-31 22:00:00,22
97,120,217,75,16.5,0,Clear,7.6,2023-05-31 23:00:00,23
42,52,94,75,16.4,0,Clear,7.6,2023-06-01 00:00:00,0
15,20,35,73,17.1,0,Clear,7.6,2023-06-01 01:00:00,1
6,10,16,80,15.6,0,Clear,5.5,2023-06-01 02:00:00,2
7,9,16,92,13.2,0,Clear,5.6,2023-06-01 03:00:00,3
13,11,24,95,12.7,0,Clear,5.8,2023-06-01 04:00:00,4
19,68,87,96,12.4,0,Clear,6.2,2023-06-01 05:00:00,5
80,206,286,97,12.3,3,Cloudy,6.9,2023-06-01 06:00:00,6
177,559,736,96,14.0,2,Partly Cloudy,7.6,2023-06-01 07:00:00,7
280,967,1247,81,18.1,0,Clear,6.5,2023-06-01 08:00:00,8
239,556,795,70,20.5,0,Clear,7.2,2023-06-01 09:00:00,9
178,321,499,59,22.5,0,Clear,7.3,2023-06-01 10:00:00,10
249,319,568,50,24.1,0,Clear,6.9,2023-06-01 11:00:00,11
274,421,695,42,25.6,0,Clear,6.5,2023-06-01 12:00:00,12
229,371,600,38,26.7,0,Clear,6.6,2023-06-01 13:00:00,13
304,422,726,34,27.7,0,Clear,7.0,2023-06-01 14:00:00,14
334,602,936,36,28.4,0,Clear,7.9,2023-06-01 15:00:00,15
402,731,1133,34,28.7,0,Clear,8.4,2023-06-01 16:00:00,16
673,1233,1906,34,28.6,0,Clear,8.7,2023-06-01 17:00:00,17
588,1041,1629,37,27.9,0,Clear,6.9,2023-06-01 18:00:00,18
451,745,1196,44,26.4,0,Clear,6.0,2023-06-01 19:00:00,19
360,556,916,56,24.3,0,Clear,5.9,2023-06-01 20:00:00,20
230,389,619,63,22.4,0,Clear,6.6,2023-06-01 21:00:00,21
174,289,463,73,20.8,0,Clear,7.3,2023-06-01 22:00:00,22
104,181,285,82,19.1,0,Clear,6.8,2023-06-01 23:00:00,23
76,78,154,88,17.9,0,Clear,5.2,2023-06-02 00:00:00,0
33,33,66,90,17.0,0,Clear,6.2,2023-06-02 01:00:00,1
14,12,26,92,16.4,0,Clear,8.6,2023-06-02 02:00:00,2
5,9,14,81,16.3,0,Clear,8.7,2023-06-02 03:00:00,3
5,11,16,82,15.7,0,Clear,8.5,2023-06-02 04:00:00,4
26,65,91,80,15.5,0,Clear,7.2,2023-06-02 05:00:00,5
77,209,286,74,16.6,0,Clear,6.3,2023-06-02 06:00:00,6
132,428,560,72,17.7,0,Clear,6.0,2023-06-02 07:00:00,7
242,686,928,63,20.6,0,Clear,3.8,2023-06-02 08:00:00,8
262,411,673,51,23.9,0,Clear,4.0,2023-06-02 09:00:00,9
260,317,577,41,26.7,0,Clear,3.8,2023-06-02 10:00:00,10
330,368,698,35,29.0,0,Clear,4.1,2023-06-02 11:00:00,11
308,416,724,32,30.5,0,Clear,6.4,2023-06-02 12:00:00,12
336,458,794,30,31.6,0,Clear,8.0,2023-06-02 13:00:00,13
361,442,803,28,32.3,0,Clear,9.2,2023-06-02 14:00:00,14
379,616,995,29,32.9,0,Clear,10.4,2023-06-02 15:00:00,15
439,704,1143,27,33.0,0,Clear,10.2,2023-06-02 16:00:00,16
593,873,1466,27,33.0,0,Clear,9.4,2023-06-02 17:00:00,17
594,816,1410,30,32.4,1,Mostly Clear,6.1,2023-06-02 18:00:00,18
425,656,1081,38,31.0,1,Mostly Clear,3.9,2023-06-02 19:00:00,19
364,475,839,43,28.7,1,Mostly Clear,4.7,2023-06-02 20:00:00,20
283,358,641,50,26.2,1,Mostly Clear,3.7,2023-06-02 21:00:00,21
271,362,633,58,24.5,1,Mostly Clear,2.6,2023-06-02 22:00:00,22
244,269,513,63,23.3,1,Mostly Clear,3.6,2023-06-02 23:00:00,23
110,138,248,66,22.4,1,Mostly Clear,5.9,2023-06-03 00:00:00,0
135,169,304,69,21.6,0,Clear,8.6,2023-06-03 01:00:00,1
84,53,137,72,21.4,0,Clear,10.5,2023-06-03 02:00:00,2
25,20,45,68,20.4,0,Clear,10.0,2023-06-03 03:00:00,3
16,14,30,72,19.9,0,Clear,9.7,2023-06-03 04:00:00,4
22,26,48,72,19.6,0,Clear,10.5,2023-06-03 05:00:00,5
43,84,127,73,19.4,0,Clear,8.7,2023-06-03 06:00:00,6
103,178,281,74,20.1,0,Clear,9.7,2023-06-03 07:00:00,7
195,284,479,61,23.1,0,Clear,8.5,2023-06-03 08:00:00,8
373,458,831,57,24.8,1,Mostly Clear,9.2,2023-06-03 09:00:00,9
486,540,1026,53,26.4,1,Mostly Clear,13.0,2023-06-03 10:00:00,10
598,576,1174,49,27.9,1,Mostly Clear,10.9,2023-06-03 11:00:00,11
655,652,1307,46,28.9,1,Mostly Clear,10.3,2023-06-03 12:00:00,12
729,647,1376,47,28.5,53,Heavy Drizzle,12.5,2023-06-03 13:00:00,13
641,646,1287,45,28.5,51,Light Drizzle,13.7,2023-06-03 14:00:00,14
694,605,1299,49,27.5,51,Light Drizzle,14.5,2023-06-03 15:00:00,15
563,540,1103,49,27.2,51,Light Drizzle,15.1,2023-06-03 16:00:00,16
582,584,1166,51,26.5,1,Mostly Clear,14.5,2023-06-03 17:00:00,17
626,590,1216,55,25.4,1,Mostly Clear,15.4,2023-06-03 18:00:00,18
538,564,1102,60,24.1,1,Mostly Clear,15.6,2023-06-03 19:00:00,19
393,410,803,67,22.3,2,Partly Cloudy,17.4,2023-06-03 20:00:00,20
235,313,548,73,20.4,3,Cloudy,17.5,2023-06-03 21:00:00,21
228,275,503,76,18.9,3,Cloudy,16.4,2023-06-03 22:00:00,22
122,200,322,77,17.9,3,Cloudy,15.3,2023-06-03 23:00:00,23
111,172,283,78,17.2,51,Light Drizzle,13.0,2023-06-04 00:00:00,0
109,113,222,78,16.9,51,Light Drizzle,12.2,2023-06-04 01:00:00,1
74,70,144,75,16.6,3,Cloudy,12.0,2023-06-04 02:00:00,2
43,32,75,77,15.9,3,Cloudy,13.0,2023-06-04 03:00:00,3
12,15,27,75,15.7,3,Cloudy,13.4,2023-06-04 04:00:00,4
10,19,29,74,15.4,3,Cloudy,13.0,2023-06-04 05:00:00,5
30,71,101,72,15.2,3,Cloudy,9.5,2023-06-04 06:00:00,6
46,123,169,71,15.2,3,Cloudy,8.4,2023-06-04 07:00:00,7
118,221,339,69,15.3,3,Cloudy,6.9,2023-06-04 08:00:00,8
267,323,590,68,15.6,3,Cloudy,5.9,2023-06-04 09:00:00,9
450,524,974,63,16.3,3,Cloudy,5.8,2023-06-04 10:00:00,10
529,556,1085,58,17.4,3,Cloudy,5.4,2023-06-04 11:00:00,11
630,608,1238,51,19.2,3,Cloudy,4.8,2023-06-04 12:00:00,12
598,648,1246,47,20.5,3,Cloudy,5.4,2023-06-04 13:00:00,13
607,545,1152,42,22.0,3,Cloudy,6.0,2023-06-04 14:00:00,14
555,608,1163,46,21.4,3,Cloudy,4.1,2023-06-04 15:00:00,15
576,652,1228,43,22.2,3,Cloudy,5.1,2023-06-04 16:00:00,16
590,670,1260,39,23.2,1,Mostly Clear,5.8,2023-06-04 17:00:00,17
501,605,1106,36,23.7,1,Mostly Clear,5.4,2023-06-04 18:00:00,18
507,510,1017,37,23.3,0,Clear,2.7,2023-06-04 19:00:00,19
334,369,703,45,21.7,0,Clear,2.5,2023-06-04 20:00:00,20
209,246,455,55,20.0,0,Clear,2.9,2023-06-04 21:00:00,21
120,165,285,63,18.8,0,Clear,3.1,2023-06-04 22:00:00,22
59,104,163,68,17.9,0,Clear,4.0,2023-06-04 23:00:00,23
41,31,72,73,17.1,0,Clear,5.0,2023-06-05 00:00:00,0
13,19,32,78,16.2,0,Clear,7.0,2023-06-05 01:00:00,1
5,10,15,78,15.6,0,Clear,8.3,2023-06-05 02:00:00,2
5,8,13,70,14.2,0,Clear,9.2,2023-06-05 03:00:00,3
6,19,25,75,13.8,0,Clear,9.7,2023-06-05 04:00:00,4
24,67,91,85,13.4,0,Clear,9.4,2023-06-05 05:00:00,5
66,233,299,92,13.3,3,Cloudy,9.1,2023-06-05 06:00:00,6
141,452,593,91,15.0,3,Cloudy,9.4,2023-06-05 07:00:00,7
239,764,1003,84,16.5,2,Partly Cloudy,7.7,2023-06-05 08:00:00,8
207,420,627,71,18.4,0,Clear,5.2,2023-06-05 09:00:00,9
200,289,489,55,20.4,0,Clear,5.4,2023-06-05 10:00:00,10
242,269,511,44,22.1,0,Clear,7.3,2023-06-05 11:00:00,11
253,392,645,38,23.6,0,Clear,9.3,2023-06-05 12:00:00,12
261,356,617,33,25.0,0,Clear,9.8,2023-06-05 13:00:00,13
294,352,646,30,25.8,1,Mostly Clear,10.4,2023-06-05 14:00:00,14
290,454,744,31,26.3,1,Mostly Clear,11.6,2023-06-05 15:00:00,15
404,609,1013,28,26.8,1,Mostly Clear,13.1,2023-06-05 16:00:00,16
599,1107,1706,28,26.9,2,Partly Cloudy,14.4,2023-06-05 17:00:00,17
525,983,1508,28,26.6,0,Clear,13.3,2023-06-05 18:00:00,18
457,674,1131,29,25.9,0,Clear,12.8,2023-06-05 19:00:00,19
305,506,811,41,24.2,0,Clear,7.8,2023-06-05 20:00:00,20
221,352,573,41,22.6,0,Clear,7.8,2023-06-05 21:00:00,21
151,184,335,40,22.0,0,Clear,9.7,2023-06-05 22:00:00,22
57,89,146,57,18.6,0,Clear,8.7,2023-06-05 23:00:00,23
32,39,71,67,16.7,0,Clear,8.7,2023-06-06 00:00:00,0
6,12,18,71,15.8,0,Clear,7.3,2023-06-06 01:00:00,1
4,11,15,72,15.2,0,Clear,8.7,2023-06-06 02:00:00,2
6,8,14,62,14.5,0,Clear,9.9,2023-06-06 03:00:00,3
4,12,16,57,14.3,0,Clear,11.0,2023-06-06 04:00:00,4
27,75,102,55,14.0,0,Clear,11.3,2023-06-06 05:00:00,5
70,246,316,59,13.6,1,Mostly Clear,7.7,2023-06-06 06:00:00,6
179,570,749,59,14.7,1,Mostly Clear,10.2,2023-06-06 07:00:00,7
299,1007,1306,45,18.5,0,Clear,9.7,2023-06-06 08:00:00,8
225,499,724,38,21.5,0,Clear,11.6,2023-06-06 09:00:00,9
217,305,522,33,23.8,1,Mostly Clear,13.1,2023-06-06 10:00:00,10
240,316,556,32,25.6,1,Mostly Clear,14.2,2023-06-06 11:00:00,11
238,385,623,31,26.8,1,Mostly Clear,18.0,2023-06-06 12:00:00,12
259,348,607,30,27.1,1,Mostly Clear,18.6,2023-06-06 13:00:00,13
282,380,662,27,28.1,2,Partly Cloudy,17.2,2023-06-06 14:00:00,14
330,539,869,29,27.6,2,Partly Cloudy,17.7,2023-06-06 15:00:00,15
413,715,1128,27,28.0,2,Partly Cloudy,19.8,2023-06-06 16:00:00,16
647,1219,1866,25,28.1,2,Partly Cloudy,21.3,2023-06-06 17:00:00,17
573,1032,1605,25,27.8,2,Partly Cloudy,14.8,2023-06-06 18:00:00,18
437,757,1194,27,27.0,2,Partly Cloudy,13.0,2023-06-06 19:00:00,19
309,557,866,30,25.7,1,Mostly Clear,11.3,2023-06-06 20:00:00,20
247,438,685,33,24.0,1,Mostly Clear,11.9,2023-06-06 21:00:00,21
220,310,530,36,23.0,1,Mostly Clear,14.1,2023-06-06 22:00:00,22
85,160,245,42,22.1,1,Mostly Clear,15.7,2023-06-06 23:00:00,23
46,52,98,46,21.4,1,Mostly Clear,13.9,2023-06-07 00:00:00,0
21,12,33,50,20.3,1,Mostly Clear,10.8,2023-06-07 01:00:00,1
7,13,20,51,19.1,0,Clear,9.4,2023-06-07 02:00:00,2
7,8,15,53,18.1,0,Clear,8.6,2023-06-07 03:00:00,3
6,18,24,63,16.5,0,Clear,5.5,2023-06-07 04:00:00,4
20,79,99,67,15.7,0,Clear,5.1,2023-06-07 05:00:00,5
92,208,300,74,14.9,0,Clear,4.6,2023-06-07 06:00:00,6
193,578,771,73,15.9,0,Clear,6.2,2023-06-07 07:00:00,7
334,1019,1353,52,19.3,0,Clear,5.1,2023-06-07 08:00:00,8
225,511,736,43,21.1,1,Mostly Clear,6.8,2023-06-07 09:00:00,9
185,323,508,39,22.5,1,Mostly Clear,8.1,2023-06-07 10:00:00,10
167,326,493,33,24.0,1,Mostly Clear,9.6,2023-06-07 11:00:00,11
198,378,576,30,25.1,1,Mostly Clear,8.7,2023-06-07 12:00:00,12
197,383,580,26,25.9,1,Mostly Clear,7.4,2023-06-07 13:00:00,13
270,353,623,23,26.6,1,Mostly Clear,8.4,2023-06-07 14:00:00,14
270,468,738,27,25.8,1,Mostly Clear,9.8,2023-06-07 15:00:00,15
361,605,966,26,25.8,1,Mostly Clear,10.6,2023-06-07 16:00:00,16
501,1143,1644,26,25.6,1,Mostly Clear,10.9,2023-06-07 17:00:00,17
555,985,1540,27,25.3,1,Mostly Clear,9.2,2023-06-07 18:00:00,18
391,631,1022,29,24.7,1,Mostly Clear,7.2,2023-06-07 19:00:00,19
292,459,751,43,23.5,1,Mostly Clear,2.5,2023-06-07 20:00:00,20
246,365,611,40,21.6,0,Clear,2.5,2023-06-07 21:00:00,21
165,267,432,47,20.4,1,Mostly Clear,3.5,2023-06-07 22:00:00,22
98,160,258,58,19.3,1,Mostly Clear,4.9,2023-06-07 23:00:00,23
28,57,85,69,18.7,1,Mostly Clear,3.1,2023-06-08 00:00:00,0
12,22,34,76,18.1,1,Mostly Clear,1.1,2023-06-08 01:00:00,1
11,6,17,84,17.3,1,Mostly Clear,8.3,2023-06-08 02:00:00,2
3,11,14,72,16.7,1,Mostly Clear,10.6,2023-06-08 03:00:00,3
2,17,19,71,16.1,0,Clear,10.7,2023-06-08 04:00:00,4
22,56,78,66,15.7,0,Clear,10.3,2023-06-08 05:00:00,5
75,191,266,62,15.2,1,Mostly Clear,11.9,2023-06-08 06:00:00,6
140,445,585,57,15.8,1,Mostly Clear,11.6,2023-06-08 07:00:00,7
229,796,1025,44,18.0,1,Mostly Clear,9.7,2023-06-08 08:00:00,8
190,439,629,35,20.3,1,Mostly Clear,7.6,2023-06-08 09:00:00,9
128,250,378,29,22.0,1,Mostly Clear,8.0,2023-06-08 10:00:00,10
154,259,413,27,23.4,0,Clear,7.1,2023-06-08 11:00:00,11
176,336,512,25,24.3,0,Clear,6.2,2023-06-08 12:00:00,12
214,338,552,22,25.3,0,Clear,6.4,2023-06-08 13:00:00,13
199,308,507,19,26.0,1,Mostly Clear,5.6,2023-06-08 14:00:00,14
283,440,723,26,24.9,1,Mostly Clear,5.7,2023-06-08 15:00:00,15
306,539,845,24,25.2,1,Mostly Clear,4.6,2023-06-08 16:00:00,16
462,837,1299,22,25.1,1,Mostly Clear,5.2,2023-06-08 17:00:00,17
376,749,1125,22,24.8,1,Mostly Clear,5.2,2023-06-08 18:00:00,18
283,546,829,24,24.1,1,Mostly Clear,4.0,2023-06-08 19:00:00,19
223,358,581,32,22.5,1,Mostly Clear,3.3,2023-06-08 20:00:00,20
164,301,465,38,20.5,1,Mostly Clear,6.2,2023-06-08 21:00:00,21
178,226,404,43,19.2,0,Clear,7.1,2023-06-08 22:00:00,22
84,107,191,45,18.4,0,Clear,7.0,2023-06-08 23:00:00,23
51,66,117,48,17.8,0,Clear,5.7,2023-06-09 00:00:00,0
26,43,69,54,16.8,0,Clear,5.6,2023-06-09 01:00:00,1
20,19,39,61,15.8,0,Clear,6.1,2023-06-09 02:00:00,2
6,2,8,77,14.7,0,Clear,7.4,2023-06-09 03:00:00,3
7,16,23,81,14.1,0,Clear,7.4,2023-06-09 04:00:00,4
23,60,83,83,13.6,0,Clear,7.3,2023-06-09 05:00:00,5
64,193,257,85,13.2,1,Mostly Clear,5.0,2023-06-09 06:00:00,6
125,368,493,84,14.7,0,Clear,4.8,2023-06-09 07:00:00,7
212,612,824,63,18.0,0,Clear,6.4,2023-06-09 08:00:00,8
220,450,670,53,19.8,0,Clear,7.5,2023-06-09 09:00:00,9
216,319,535,45,21.2,0,Clear,8.5,2023-06-09 10:00:00,10
269,373,642,40,22.4,1,Mostly Clear,9.9,2023-06-09 11:00:00,11
296,364,660,38,23.4,2,Partly Cloudy,11.7,2023-06-09 12:00:00,12
362,402,764,35,24.3,2,Partly Cloudy,13.2,2023-06-09 13:00:00,13
339,466,805,36,24.2,51,Light Drizzle,14.8,2023-06-09 14:00:00,14
405,624,1029,42,22.7,1,Mostly Clear,12.9,2023-06-09 15:00:00,15
490,677,1167,36,23.6,0,Clear,15.1,2023-06-09 16:00:00,16
601,925,1526,33,24.4,1,Mostly Clear,17.1,2023-06-09 17:00:00,17
571,827,1398,41,22.7,53,Heavy Drizzle,16.3,2023-06-09 18:00:00,18
439,712,1151,42,21.7,1,Mostly Clear,11.2,2023-06-09 19:00:00,19
304,405,709,46,21.2,1,Mostly Clear,7.1,2023-06-09 20:00:00,20
227,332,559,50,19.9,1,Mostly Clear,7.7,2023-06-09 21:00:00,21
207,301,508,55,19.0,0,Clear,7.4,2023-06-09 22:00:00,22
182,259,441,56,18.3,0,Clear,7.4,2023-06-09 23:00:00,23
128,175,303,59,17.5,0,Clear,8.9,2023-06-10 00:00:00,0
123,132,255,62,16.8,0,Clear,8.6,2023-06-10 01:00:00,1
72,92,164,66,16.0,0,Clear,7.3,2023-06-10 02:00:00,2
40,43,83,79,14.9,0,Clear,7.9,2023-06-10 03:00:00,3
17,10,27,81,14.4,0,Clear,7.6,2023-06-10 04:00:00,4
24,34,58,82,14.1,0,Clear,7.9,2023-06-10 05:00:00,5
42,71,113,84,14.0,0,Clear,10.2,2023-06-10 06:00:00,6
86,160,246,80,15.2,0,Clear,10.9,2023-06-10 07:00:00,7
187,287,474,64,18.5,0,Clear,9.4,2023-06-10 08:00:00,8
342,424,766,52,21.3,0,Clear,10.2,2023-06-10 09:00:00,9
428,536,964,41,23.7,0,Clear,11.0,2023-06-10 10:00:00,10
618,602,1220,33,25.5,1,Mostly Clear,13.2,2023-06-10 11:00:00,11
638,654,1292,30,26.8,1,Mostly Clear,13.1,2023-06-10 12:00:00,12
668,638,1306,27,27.9,1,Mostly Clear,11.4,2023-06-10 13:00:00,13
777,668,1445,25,28.9,2,Partly Cloudy,11.6,2023-06-10 14:00:00,14
645,582,1227,27,29.1,2,Partly Cloudy,12.9,2023-06-10 15:00:00,15
586,487,1073,25,29.5,2,Partly Cloudy,13.4,2023-06-10 16:00:00,16
683,587,1270,25,29.3,2,Partly Cloudy,13.0,2023-06-10 17:00:00,17
719,626,1345,29,28.5,1,Mostly Clear,9.4,2023-06-10 18:00:00,18
619,580,1199,35,27.6,0,Clear,6.5,2023-06-10 19:00:00,19
508,384,892,40,26.3,0,Clear,5.0,2023-06-10 20:00:00,20
408,394,802,41,24.5,0,Clear,6.2,2023-06-10 21:00:00,21
320,335,655,47,22.8,0,Clear,8.0,2023-06-10 22:00:00,22
255,234,489,52,21.8,0,Clear,8.3,2023-06-10 23:00:00,23
176,210,386,57,21.2,0,Clear,8.7,2023-06-11 00:00:00,0
115,128,243,63,20.4,0,Clear,9.4,2023-06-11 01:00:00,1
94,68,162,68,19.6,0,Clear,10.4,2023-06-11 02:00:00,2
48,28,76,67,19.3,0,Clear,10.2,2023-06-11 03:00:00,3
21,26,47,64,19.4,0,Clear,9.6,2023-06-11 04:00:00,4
20,30,50,66,18.5,0,Clear,8.1,2023-06-11 05:00:00,5
42,92,134,71,17.7,0,Clear,4.9,2023-06-11 06:00:00,6
52,124,176,75,18.1,1,Mostly Clear,4.8,2023-06-11 07:00:00,7
128,210,338,59,21.1,1,Mostly Clear,3.2,2023-06-11 08:00:00,8
295,381,676,51,23.6,1,Mostly Clear,2.9,2023-06-11 09:00:00,9
509,471,980,44,26.2,2,Partly Cloudy,3.3,2023-06-11 10:00:00,10
547,561,1108,38,28.4,2,Partly Cloudy,5.5,2023-06-11 11:00:00,11
629,616,1245,32,30.1,1,Mostly Clear,7.9,2023-06-11 12:00:00,12
653,595,1248,29,30.8,2,Partly Cloudy,10.9,2023-06-11 13:00:00,13
621,621,1242,26,31.4,2,Partly Cloudy,12.5,2023-06-11 14:00:00,14
596,600,1196,31,30.4,2,Partly Cloudy,14.0,2023-06-11 15:00:00,15
561,591,1152,32,30.0,3,Cloudy,14.1,2023-06-11 16:00:00,16
574,588,1162,32,30.0,3,Cloudy,14.1,2023-06-11 17:00:00,17
506,595,1101,33,29.6,2,Partly Cloudy,15.7,2023-06-11 18:00:00,18
441,468,909,34,28.9,1,Mostly Clear,13.4,2023-06-11 19:00:00,19
331,322,653,41,27.4,2,Partly Cloudy,12.1,2023-06-11 20:00:00,20
265,290,555,48,25.8,1,Mostly Clear,13.0,2023-06-11 21:00:00,21
158,198,356,51,25.1,1,Mostly Clear,14.2,2023-06-11 22:00:00,22
80,124,204,53,24.3,1,Mostly Clear,13.6,2023-06-11 23:00:00,23
51,51,102,56,23.7,1,Mostly Clear,14.2,2023-06-12 00:00:00,0
20,27,47,59,23.1,2,Partly Cloudy,16.3,2023-06-12 01:00:00,1
11,24,35,61,22.9,2,Partly Cloudy,16.6,2023-06-12 02:00:00,2
10,11,21,64,23.0,2,Partly Cloudy,15.1,2023-06-12 03:00:00,3
12,13,25,69,22.5,1,Mostly Clear,14.4,2023-06-12 04:00:00,4
19,58,77,74,21.9,1,Mostly Clear,13.7,2023-06-12 05:00:00,5
63,190,253,78,21.5,3,Cloudy,9.5,2023-06-12 06:00:00,6
137,476,613,78,21.9,3,Cloudy,10.5,2023-06-12 07:00:00,7
261,848,1109,74,23.0,3,Cloudy,11.1,2023-06-12 08:00:00,8
197,464,661,70,23.9,3,Cloudy,14.4,2023-06-12 09:00:00,9
175,259,434,67,24.8,51,Light Drizzle,15.5,2023-06-12 10:00:00,10
181,310,491,66,25.1,51,Light Drizzle,14.1,2023-06-12 11:00:00,11
180,270,450,67,25.6,51,Light Drizzle,14.5,2023-06-12 12:00:00,12
181,278,459,68,25.8,53,Heavy Drizzle,15.0,2023-06-12 13:00:00,13
166,233,399,84,23.7,63,Rain,12.4,2023-06-12 14:00:00,14
208,315,523,81,22.8,63,Rain,14.7,2023-06-12 15:00:00,15
254,494,748,93,21.7,63,Rain,13.7,2023-06-12 16:00:00,16
388,808,1196,94,21.9,53,Heavy Drizzle,15.5,2023-06-12 17:00:00,17
308,765,1073,86,21.8,51,Light Drizzle,14.1,2023-06-12 18:00:00,18
278,536,814,81,21.7,2,Partly Cloudy,16.7,2023-06-12 19:00:00,19
287,473,760,78,21.3,1,Mostly Clear,15.8,2023-06-12 20:00:00,20
188,379,567,74,20.6,0,Clear,12.8,2023-06-12 21:00:00,21
140,201,341,73,20.1,0,Clear,11.8,2023-06-12 22:00:00,22
88,125,213,71,19.4,0,Clear,10.5,2023-06-12 23:00:00,23
38,38,76,69,18.8,0,Clear,10.2,2023-06-13 00:00:00,0
15,19,34,68,18.2,0,Clear,9.7,2023-06-13 01:00:00,1
4,3,7,69,17.5,0,Clear,9.0,2023-06-13 02:00:00,2
3,12,15,76,16.5,0,Clear,8.0,2023-06-13 03:00:00,3
6,11,17,79,15.8,0,Clear,8.3,2023-06-13 04:00:00,4
26,85,111,84,15.0,0,Clear,7.1,2023-06-13 05:00:00,5
74,247,321,88,14.1,0,Clear,7.1,2023-06-13 06:00:00,6
179,591,770,88,15.2,0,Clear,4.4,2023-06-13 07:00:00,7
296,1063,1359,73,18.3,2,Partly Cloudy,5.7,2023-06-13 08:00:00,8
232,550,782,61,20.3,2,Partly Cloudy,6.5,2023-06-13 09:00:00,9
234,342,576,51,21.6,2,Partly Cloudy,10.8,2023-06-13 10:00:00,10
233,335,568,47,22.4,3,Cloudy,12.3,2023-06-13 11:00:00,11
255,400,655,44,23.1,2,Partly Cloudy,13.4,2023-06-13 12:00:00,12
285,353,638,40,24.1,1,Mostly Clear,13.8,2023-06-13 13:00:00,13
263,348,611,36,24.9,2,Partly Cloudy,13.9,2023-06-13 14:00:00,14
298,491,789,36,25.2,2,Partly Cloudy,14.0,2023-06-13 15:00:00,15
419,738,1157,33,25.9,2,Partly Cloudy,12.6,2023-06-13 16:00:00,16
578,1242,1820,32,26.2,2,Partly Cloudy,12.1,2023-06-13 17:00:00,17
597,1094,1691,32,26.0,1,Mostly Clear,10.5,2023-06-13 18:00:00,18
515,851,1366,37,25.2,0,Clear,8.9,2023-06-13 19:00:00,19
372,632,1004,44,23.5,0,Clear,8.7,2023-06-13 20:00:00,20
250,418,668,48,21.8,0,Clear,10.4,2023-06-13 21:00:00,21
199,291,490,52,20.9,0,Clear,12.7,2023-06-13 22:00:00,22
98,123,221,54,20.0,0,Clear,12.2,2023-06-13 23:00:00,23
64,57,121,53,19.2,0,Clear,12.7,2023-06-14 00:00:00,0
17,27,44,54,18.3,0,Clear,12.4,2023-06-14 01:00:00,1
8,14,22,57,17.3,1,Mostly Clear,11.1,2023-06-14 02:00:00,2
11,7,18,71,16.9,0,Clear,10.2,2023-06-14 03:00:00,3
5,22,27,70,16.5,0,Clear,9.4,2023-06-14 04:00:00,4
23,88,111,70,16.1,1,Mostly Clear,9.9,2023-06-14 05:00:00,5
95,252,347,71,16.0,2,Partly Cloudy,11.5,2023-06-14 06:00:00,6
183,559,742,67,17.4,2,Partly Cloudy,11.5,2023-06-14 07:00:00,7
305,1010,1315,61,19.3,2,Partly Cloudy,10.2,2023-06-14 08:00:00,8
214,509,723,56,20.7,3,Cloudy,10.8,2023-06-14 09:00:00,9
108,171,279,51,21.7,51,Light Drizzle,14.7,2023-06-14 10:00:00,10
144,274,418,55,21.2,51,Light Drizzle,16.6,2023-06-14 11:00:00,11
228,403,631,53,22.0,1,Mostly Clear,13.5,2023-06-14 12:00:00,12
302,357,659,47,23.7,51,Light Drizzle,19.3,2023-06-14 13:00:00,13
311,430,741,44,24.4,51,Light Drizzle,23.0,2023-06-14 14:00:00,14
311,515,826,38,25.4,0,Clear,23.1,2023-06-14 15:00:00,15
409,729,1138,35,25.7,0,Clear,22.4,2023-06-14 16:00:00,16
630,1222,1852,34,25.7,0,Clear,23.2,2023-06-14 17:00:00,17
717,1162,1879,35,25.3,0,Clear,19.9,2023-06-14 18:00:00,18
630,865,1495,37,24.6,0,Clear,15.9,2023-06-14 19:00:00,19
335,637,972,43,23.2,0,Clear,11.6,2023-06-14 20:00:00,20
324,524,848,46,21.7,0,Clear,8.4,2023-06-14 21:00:00,21
251,348,599,50,20.4,0,Clear,7.9,2023-06-14 22:00:00,22
153,181,334,55,19.3,0,Clear,8.8,2023-06-14 23:00:00,23
44,92,136,59,18.5,0,Clear,8.2,2023-06-15 00:00:00,0
16,34,50,65,17.6,0,Clear,7.4,2023-06-15 01:00:00,1
8,25,33,72,16.4,0,Clear,7.5,2023-06-15 02:00:00,2
6,5,11,74,15.4,0,Clear,7.7,2023-06-15 03:00:00,3
6,12,18,77,14.7,0,Clear,8.0,2023-06-15 04:00:00,4
31,68,99,81,14.1,0,Clear,8.0,2023-06-15 05:00:00,5
74,212,286,83,13.7,0,Clear,8.4,2023-06-15 06:00:00,6
146,553,699,82,15.1,0,Clear,9.2,2023-06-15 07:00:00,7
361,996,1357,63,18.8,0,Clear,7.8,2023-06-15 08:00:00,8
291,573,864,53,20.6,0,Clear,8.1,2023-06-15 09:00:00,9
242,357,599,46,22.3,0,Clear,5.5,2023-06-15 10:00:00,10
261,359,620,41,23.7,0,Clear,3.2,2023-06-15 11:00:00,11
263,470,733,37,25.1,1,Mostly Clear,3.4,2023-06-15 12:00:00,12
335,404,739,34,26.3,1,Mostly Clear,6.2,2023-06-15 13:00:00,13
311,434,745,31,27.3,1,Mostly Clear,9.4,2023-06-15 14:00:00,14
365,579,944,31,27.4,0,Clear,10.2,2023-06-15 15:00:00,15
451,721,1172,29,28.4,0,Clear,10.3,2023-06-15 16:00:00,16
644,1215,1859,28,28.6,0,Clear,10.5,2023-06-15 17:00:00,17
630,1095,1725,28,28.5,0,Clear,10.5,2023-06-15 18:00:00,18
495,830,1325,38,27.5,0,Clear,7.2,2023-06-15 19:00:00,19
417,650,1067,41,25.9,0,Clear,5.1,2023-06-15 20:00:00,20
262,434,696,47,23.3,0,Clear,2.6,2023-06-15 21:00:00,21
177,354,531,56,21.6,0,Clear,4.2,2023-06-15 22:00:00,22
126,185,311,62,20.6,0,Clear,5.8,2023-06-15 23:00:00,23
71,91,162,67,19.9,0,Clear,6.2,2023-06-16 00:00:00,0
34,42,76,74,19.2,0,Clear,6.8,2023-06-16 01:00:00,1
20,22,42,83,18.3,1,Mostly Clear,6.1,2023-06-16 02:00:00,2
7,13,20,85,17.8,1,Mostly Clear,6.9,2023-06-16 03:00:00,3
9,17,26,90,17.7,1,Mostly Clear,8.1,2023-06-16 04:00:00,4
30,66,96,93,17.8,0,Clear,8.4,2023-06-16 05:00:00,5
83,189,272,96,17.7,1,Mostly Clear,7.0,2023-06-16 06:00:00,6
124,391,515,96,18.4,3,Cloudy,6.6,2023-06-16 07:00:00,7
247,665,912,83,21.5,3,Cloudy,6.7,2023-06-16 08:00:00,8
261,487,748,72,23.3,3,Cloudy,6.2,2023-06-16 09:00:00,9
289,376,665,63,25.1,3,Cloudy,10.5,2023-06-16 10:00:00,10
284,373,657,54,27.1,2,Partly Cloudy,13.5,2023-06-16 11:00:00,11
227,361,588,48,28.2,1,Mostly Clear,7.6,2023-06-16 12:00:00,12
348,459,807,43,29.1,0,Clear,9.7,2023-06-16 13:00:00,13
419,488,907,50,27.6,61,Light Rain,9.8,2023-06-16 14:00:00,14
446,647,1093,43,28.4,0,Clear,8.8,2023-06-16 15:00:00,15
530,743,1273,41,29.2,2,Partly Cloudy,8.6,2023-06-16 16:00:00,16
544,866,1410,44,27.5,53,Heavy Drizzle,8.7,2023-06-16 17:00:00,17
473,685,1158,66,23.6,61,Light Rain,10.2,2023-06-16 18:00:00,18
408,564,972,79,22.0,51,Light Drizzle,7.4,2023-06-16 19:00:00,19
353,401,754,82,21.3,1,Mostly Clear,8.0,2023-06-16 20:00:00,20
242,342,584,82,20.9,1,Mostly Clear,8.7,2023-06-16 21:00:00,21
241,320,561,83,20.2,0,Clear,10.6,2023-06-16 22:00:00,22
159,252,411,83,19.5,0,Clear,11.7,2023-06-16 23:00:00,23
156,131,287,82,19.0,0,Clear,14.0,2023-06-17 00:00:00,0
107,91,198,82,18.4,0,Clear,14.5,2023-06-17 01:00:00,1
71,68,139,83,17.9,0,Clear,15.1,2023-06-17 02:00:00,2
36,29,65,81,18.0,0,Clear,13.8,2023-06-17 03:00:00,3
4,24,28,82,17.6,0,Clear,13.2,2023-06-17 04:00:00,4
29,26,55,83,17.2,0,Clear,13.5,2023-06-17 05:00:00,5
42,77,119,84,16.9,1,Mostly Clear,11.2,2023-06-17 06:00:00,6
93,175,268,83,17.3,1,Mostly Clear,10.6,2023-06-17 07:00:00,7
177,268,445,75,18.4,1,Mostly Clear,13.5,2023-06-17 08:00:00,8
326,456,782,66,20.0,2,Partly Cloudy,14.8,2023-06-17 09:00:00,9
558,521,1079,58,21.8,1,Mostly Clear,13.7,2023-06-17 10:00:00,10
638,561,1199,50,23.4,1,Mostly Clear,14.5,2023-06-17 11:00:00,11
661,612,1273,42,25.1,1,Mostly Clear,16.1,2023-06-17 12:00:00,12
698,546,1244,38,26.2,1,Mostly Clear,18.3,2023-06-17 13:00:00,13
694,598,1292,35,26.8,1,Mostly Clear,18.3,2023-06-17 14:00:00,14
802,614,1416,35,27.3,1,Mostly Clear,19.2,2023-06-17 15:00:00,15
630,516,1146,33,27.6,0,Clear,19.7,2023-06-17 16:00:00,16
633,555,1188,30,27.5,0,Clear,19.6,2023-06-17 17:00:00,17
608,558,1166,29,27.1,0,Clear,17.8,2023-06-17 18:00:00,18
579,490,1069,30,26.3,1,Mostly Clear,14.3,2023-06-17 19:00:00,19
383,354,737,35,24.9,0,Clear,10.7,2023-06-17 20:00:00,20
327,386,713,37,23.0,0,Clear,10.1,2023-06-17 21:00:00,21
238,306,544,41,21.5,0,Clear,10.7,2023-06-17 22:00:00,22
199,255,454,44,20.4,0,Clear,11.8,2023-06-17 23:00:00,23
130,174,304,48,19.5,0,Clear,12.4,2023-06-18 00:00:00,0
127,147,274,52,18.6,0,Clear,11.6,2023-06-18 01:00:00,1
76,90,166,59,17.5,0,Clear,10.1,2023-06-18 02:00:00,2
45,46,91,61,16.9,0,Clear,9.4,2023-06-18 03:00:00,3
14,19,33,65,16.2,0,Clear,9.3,2023-06-18 04:00:00,4
17,31,48,69,15.6,0,Clear,9.4,2023-06-18 05:00:00,5
40,72,112,75,15.1,0,Clear,8.6,2023-06-18 06:00:00,6
77,111,188,76,16.2,0,Clear,9.7,2023-06-18 07:00:00,7
140,226,366,58,20.3,0,Clear,7.7,2023-06-18 08:00:00,8
293,363,656,50,22.9,0,Clear,8.4,2023-06-18 09:00:00,9
438,500,938,39,25.0,0,Clear,8.2,2023-06-18 10:00:00,10
546,543,1089,32,26.4,0,Clear,6.4,2023-06-18 11:00:00,11
599,517,1116,28,27.6,0,Clear,5.2,2023-06-18 12:00:00,12
645,520,1165,26,28.6,0,Clear,4.6,2023-06-18 13:00:00,13
616,517,1133,24,29.4,0,Clear,4.7,2023-06-18 14:00:00,14
628,540,1168,26,29.5,0,Clear,5.0,2023-06-18 15:00:00,15
616,537,1153,25,29.9,0,Clear,5.1,2023-06-18 16:00:00,16
656,517,1173,24,30.1,0,Clear,4.4,2023-06-18 17:00:00,17
509,520,1029,23,29.9,0,Clear,8.8,2023-06-18 18:00:00,18
478,450,928,30,29.1,0,Clear,4.6,2023-06-18 19:00:00,19
400,363,763,33,27.1,0,Clear,2.2,2023-06-18 20:00:00,20
282,315,597,41,24.7,0,Clear,2.8,2023-06-18 21:00:00,21
184,214,398,51,22.8,0,Clear,4.7,2023-06-18 22:00:00,22
135,164,299,58,21.7,0,Clear,6.5,2023-06-18 23:00:00,23
89,90,179,63,20.9,0,Clear,8.4,2023-06-19 00:00:00,0
34,43,77,67,20.2,0,Clear,9.3,2023-06-19 01:00:00,1
25,34,59,72,19.4,0,Clear,9.3,2023-06-19 02:00:00,2
12,31,43,83,18.6,0,Clear,8.9,2023-06-19 03:00:00,3
13,25,38,89,17.9,0,Clear,7.0,2023-06-19 04:00:00,4
23,46,69,92,17.3,0,Clear,6.3,2023-06-19 05:00:00,5
36,129,165,94,17.1,0,Clear,2.5,2023-06-19 06:00:00,6
71,238,309,91,18.9,0,Clear,1.4,2023-06-19 07:00:00,7
143,293,436,79,22.2,1,Mostly Clear,2.7,2023-06-19 08:00:00,8
347,393,740,69,24.6,1,Mostly Clear,4.8,2023-06-19 09:00:00,9
418,421,839,54,27.2,1,Mostly Clear,6.6,2023-06-19 10:00:00,10
533,489,1022,41,29.0,1,Mostly Clear,9.9,2023-06-19 11:00:00,11
545,583,1128,38,29.8,1,Mostly Clear,10.9,2023-06-19 12:00:00,12
560,595,1155,37,30.6,1,Mostly Clear,11.8,2023-06-19 13:00:00,13
552,579,1131,36,31.0,2,Partly Cloudy,12.2,2023-06-19 14:00:00,14
537,614,1151,39,30.9,2,Partly Cloudy,13.2,2023-06-19 15:00:00,15
491,546,1037,43,29.7,51,Light Drizzle,14.0,2023-06-19 16:00:00,16
467,637,1104,47,29.2,51,Light Drizzle,13.5,2023-06-19 17:00:00,17
490,653,1143,54,27.7,51,Light Drizzle,10.2,2023-06-19 18:00:00,18
379,508,887,58,27.3,3,Cloudy,11.2,2023-06-19 19:00:00,19
313,381,694,64,26.3,3,Cloudy,8.3,2023-06-19 20:00:00,20
207,240,447,68,25.1,3,Cloudy,7.3,2023-06-19 21:00:00,21
137,199,336,70,24.2,3,Cloudy,8.4,2023-06-19 22:00:00,22
61,92,153,71,23.4,3,Cloudy,8.8,2023-06-19 23:00:00,23
55,47,102,72,22.7,3,Cloudy,10.0,2023-06-20 00:00:00,0
13,23,36,73,22.4,3,Cloudy,10.4,2023-06-20 01:00:00,1
6,6,12,75,22.1,2,Partly Cloudy,9.6,2023-06-20 02:00:00,2
5,13,18,85,21.6,2,Partly Cloudy,8.2,2023-06-20 03:00:00,3
8,18,26,87,21.3,3,Cloudy,7.8,2023-06-20 04:00:00,4
20,72,92,89,21.1,3,Cloudy,7.9,2023-06-20 05:00:00,5
79,254,333,90,21.0,3,Cloudy,7.7,2023-06-20 06:00:00,6
164,545,709,90,21.1,3,Cloudy,8.8,2023-06-20 07:00:00,7
320,959,1279,88,21.6,2,Partly Cloudy,10.8,2023-06-20 08:00:00,8
294,496,790,84,22.1,2,Partly Cloudy,14.6,2023-06-20 09:00:00,9
242,297,539,79,22.9,2,Partly Cloudy,16.6,2023-06-20 10:00:00,10
223,381,604,72,23.8,3,Cloudy,17.6,2023-06-20 11:00:00,11
301,376,677,64,24.6,3,Cloudy,18.4,2023-06-20 12:00:00,12
320,411,731,57,25.8,3,Cloudy,18.8,2023-06-20 13:00:00,13
311,394,705,53,26.6,3,Cloudy,19.5,2023-06-20 14:00:00,14
314,496,810,71,24.1,51,Light Drizzle,18.2,2023-06-20 15:00:00,15
388,685,1073,69,24.2,51,Light Drizzle,18.8,2023-06-20 16:00:00,16
644,1243,1887,68,24.1,51,Light Drizzle,18.1,2023-06-20 17:00:00,17
641,1063,1704,67,24.0,3,Cloudy,13.4,2023-06-20 18:00:00,18
410,745,1155,68,23.5,3,Cloudy,12.1,2023-06-20 19:00:00,19
300,542,842,71,23.0,3,Cloudy,11.6,2023-06-20 20:00:00,20
241,442,683,73,22.3,2,Partly Cloudy,14.1,2023-06-20 21:00:00,21
159,272,431,75,21.8,1,Mostly Clear,13.0,2023-06-20 22:00:00,22
106,152,258,77,21.3,3,Cloudy,12.8,2023-06-20 23:00:00,23
43,52,95,79,20.8,2,Partly Cloudy,13.6,2023-06-21 00:00:00,0
17,22,39,81,20.3,2,Partly Cloudy,13.7,2023-06-21 01:00:00,1
7,9,16,82,19.9,2,Partly Cloudy,14.4,2023-06-21 02:00:00,2
13,12,25,81,19.9,2,Partly Cloudy,16.1,2023-06-21 03:00:00,3
16,13,29,80,19.6,3,Cloudy,17.2,2023-06-21 04:00:00,4
22,59,81,81,19.4,3,Cloudy,17.7,2023-06-21 05:00:00,5
52,146,198,84,19.1,3,Cloudy,15.5,2023-06-21 06:00:00,6
90,347,437,85,19.0,3,Cloudy,15.1,2023-06-21 07:00:00,7
109,440,549,85,19.2,51,Light Drizzle,16.8,2023-06-21 08:00:00,8
101,299,400,85,19.3,51,Light Drizzle,18.6,2023-06-21 09:00:00,9
62,135,197,85,19.3,51,Light Drizzle,17.9,2023-06-21 10:00:00,10
38,111,149,87,19.2,53,Heavy Drizzle,19.1,2023-06-21 11:00:00,11
49,120,169,90,18.8,53,Heavy Drizzle,19.1,2023-06-21 12:00:00,12
64,156,220,92,18.8,53,Heavy Drizzle,21.1,2023-06-21 13:00:00,13
114,250,364,92,18.4,53,Heavy Drizzle,23.2,2023-06-21 14:00:00,14
166,376,542,96,17.9,53,Heavy Drizzle,23.3,2023-06-21 15:00:00,15
152,415,567,95,17.7,55,Heavy Drizzle,21.8,2023-06-21 16:00:00,16
141,394,535,95,17.5,55,Heavy Drizzle,24.2,2023-06-21 17:00:00,17
112,415,527,94,17.3,53,Heavy Drizzle,22.5,2023-06-21 18:00:00,18
150,375,525,93,17.0,51,Light Drizzle,22.5,2023-06-21 19:00:00,19
114,285,399,92,16.5,55,Heavy Drizzle,21.6,2023-06-21 20:00:00,20
107,219,326,91,16.0,51,Light Drizzle,21.4,2023-06-21 21:00:00,21
67,120,187,89,16.0,51,Light Drizzle,19.7,2023-06-21 22:00:00,22
34,79,113,89,16.1,3,Cloudy,18.4,2023-06-21 23:00:00,23
23,37,60,89,16.3,3,Cloudy,16.9,2023-06-22 00:00:00,0
11,20,31,88,16.4,3,Cloudy,15.9,2023-06-22 01:00:00,1
6,10,16,88,16.4,3,Cloudy,15.5,2023-06-22 02:00:00,2
5,6,11,92,15.9,3,Cloudy,16.0,2023-06-22 03:00:00,3
16,17,33,92,16.0,3,Cloudy,16.0,2023-06-22 04:00:00,4
15,57,72,92,16.1,3,Cloudy,14.8,2023-06-22 05:00:00,5
59,199,258,91,16.2,3,Cloudy,9.8,2023-06-22 06:00:00,6
110,398,508,91,16.4,3,Cloudy,10.2,2023-06-22 07:00:00,7
196,792,988,89,16.7,3,Cloudy,12.7,2023-06-22 08:00:00,8
161,441,602,86,17.2,3,Cloudy,15.1,2023-06-22 09:00:00,9
134,286,420,84,17.6,3,Cloudy,13.9,2023-06-22 10:00:00,10
182,307,489,82,18.3,3,Cloudy,13.5,2023-06-22 11:00:00,11
229,379,608,80,18.9,3,Cloudy,14.7,2023-06-22 12:00:00,12
224,379,603,77,19.7,3,Cloudy,15.9,2023-06-22 13:00:00,13
242,345,587,77,20.0,3,Cloudy,16.9,2023-06-22 14:00:00,14
251,491,742,77,19.7,3,Cloudy,17.3,2023-06-22 15:00:00,15
273,656,929,78,19.9,51,Light Drizzle,17.7,2023-06-22 16:00:00,16
516,1133,1649,79,20.0,51,Light Drizzle,17.9,2023-06-22 17:00:00,17
421,917,1338,80,20.2,51,Light Drizzle,15.6,2023-06-22 18:00:00,18
254,568,822,84,19.9,51,Light Drizzle,14.0,2023-06-22 19:00:00,19
171,363,534,87,19.7,51,Light Drizzle,13.4,2023-06-22 20:00:00,20
129,295,424,91,19.4,51,Light Drizzle,13.2,2023-06-22 21:00:00,21
123,226,349,94,19.1,53,Heavy Drizzle,13.6,2023-06-22 22:00:00,22
74,124,198,97,19.0,53,Heavy Drizzle,14.5,2023-06-22 23:00:00,23
45,77,122,98,18.9,55,Heavy Drizzle,14.6,2023-06-23 00:00:00,0
12,24,36,99,19.1,61,Light Rain,14.9,2023-06-23 01:00:00,1
18,19,37,99,19.4,61,Light Rain,14.8,2023-06-23 02:00:00,2
9,7,16,99,18.7,55,Heavy Drizzle,14.4,2023-06-23 03:00:00,3
6,13,19,99,19.1,61,Light Rain,13.4,2023-06-23 04:00:00,4
15,43,58,99,19.6,61,Light Rain,12.5,2023-06-23 05:00:00,5
54,122,176,99,20.1,53,Heavy Drizzle,12.3,2023-06-23 06:00:00,6
72,276,348,99,20.4,51,Light Drizzle,11.4,2023-06-23 07:00:00,7
131,446,577,97,21.0,51,Light Drizzle,10.0,2023-06-23 08:00:00,8
110,282,392,95,21.4,51,Light Drizzle,8.1,2023-06-23 09:00:00,9
92,195,287,96,21.7,51,Light Drizzle,6.6,2023-06-23 10:00:00,10
114,228,342,98,22.2,53,Heavy Drizzle,6.1,2023-06-23 11:00:00,11
180,304,484,96,22.8,51,Light Drizzle,4.4,2023-06-23 12:00:00,12
154,349,503,94,23.8,53,Heavy Drizzle,2.7,2023-06-23 13:00:00,13
245,357,602,88,24.2,61,Light Rain,3.4,2023-06-23 14:00:00,14
183,402,585,89,23.6,63,Rain,3.7,2023-06-23 15:00:00,15
211,471,682,89,23.8,63,Rain,5.1,2023-06-23 16:00:00,16
353,662,1015,90,23.6,63,Rain,5.2,2023-06-23 17:00:00,17
189,472,661,90,23.3,61,Light Rain,5.8,2023-06-23 18:00:00,18
241,425,666,94,22.7,61,Light Rain,5.1,2023-06-23 19:00:00,19
223,366,589,96,22.1,53,Heavy Drizzle,5.2,2023-06-23 20:00:00,20
185,287,472,98,21.5,51,Light Drizzle,5.9,2023-06-23 21:00:00,21
137,261,398,98,21.3,51,Light Drizzle,4.6,2023-06-23 22:00:00,22
133,191,324,99,21.1,51,Light Drizzle,4.0,2023-06-23 23:00:00,23
141,192,333,99,20.8,3,Cloudy,2.6,2023-06-24 00:00:00,0
150,136,286,99,20.3,3,Cloudy,3.3,2023-06-24 01:00:00,1
73,72,145,99,19.9,3,Cloudy,3.8,2023-06-24 02:00:00,2
29,23,52,100,20.7,3,Cloudy,3.2,2023-06-24 03:00:00,3
15,7,22,99,21.0,3,Cloudy,3.7,2023-06-24 04:00:00,4
18,21,39,99,20.9,3,Cloudy,4.0,2023-06-24 05:00:00,5
46,53,99,100,20.5,3,Cloudy,5.4,2023-06-24 06:00:00,6
80,135,215,100,20.9,51,Light Drizzle,5.1,2023-06-24 07:00:00,7
141,251,392,98,21.4,51,Light Drizzle,3.6,2023-06-24 08:00:00,8
314,397,711,92,22.4,51,Light Drizzle,4.2,2023-06-24 09:00:00,9
377,456,833,85,23.5,51,Light Drizzle,4.6,2023-06-24 10:00:00,10
503,591,1094,83,24.3,51,Light Drizzle,3.6,2023-06-24 11:00:00,11
576,645,1221,79,25.3,51,Light Drizzle,4.8,2023-06-24 12:00:00,12
611,611,1222,73,26.9,51,Light Drizzle,5.4,2023-06-24 13:00:00,13
680,598,1278,71,27.4,51,Light Drizzle,6.6,2023-06-24 14:00:00,14
636,631,1267,64,28.4,51,Light Drizzle,6.4,2023-06-24 15:00:00,15
578,628,1206,62,28.6,51,Light Drizzle,7.6,2023-06-24 16:00:00,16
562,574,1136,66,27.8,51,Light Drizzle,7.4,2023-06-24 17:00:00,17
619,586,1205,78,25.9,63,Rain,5.6,2023-06-24 18:00:00,18
541,569,1110,81,25.7,51,Light Drizzle,3.0,2023-06-24 19:00:00,19
471,420,891,83,25.4,1,Mostly Clear,4.5,2023-06-24 20:00:00,20
383,418,801,83,24.6,1,Mostly Clear,5.2,2023-06-24 21:00:00,21
348,358,706,85,23.7,1,Mostly Clear,5.6,2023-06-24 22:00:00,22
257,292,549,86,23.1,1,Mostly Clear,6.6,2023-06-24 23:00:00,23
229,232,461,87,22.5,1,Mostly Clear,7.8,2023-06-25 00:00:00,0
129,138,267,86,22.0,0,Clear,7.9,2023-06-25 01:00:00,1
99,90,189,85,21.5,0,Clear,8.4,2023-06-25 02:00:00,2
33,37,70,92,21.1,0,Clear,8.7,2023-06-25 03:00:00,3
11,22,33,91,20.8,0,Clear,9.8,2023-06-25 04:00:00,4
13,34,47,91,20.4,0,Clear,9.8,2023-06-25 05:00:00,5
42,97,139,91,20.1,0,Clear,8.9,2023-06-25 06:00:00,6
66,134,200,91,20.7,0,Clear,7.7,2023-06-25 07:00:00,7
162,243,405,84,22.5,0,Clear,4.3,2023-06-25 08:00:00,8
356,392,748,78,24.0,1,Mostly Clear,4.4,2023-06-25 09:00:00,9
505,495,1000,71,25.2,0,Clear,4.8,2023-06-25 10:00:00,10
590,614,1204,63,26.6,1,Mostly Clear,5.0,2023-06-25 11:00:00,11
635,603,1238,61,27.4,2,Partly Cloudy,6.6,2023-06-25 12:00:00,12
649,631,1280,58,28.6,1,Mostly Clear,7.6,2023-06-25 13:00:00,13
652,618,1270,57,29.4,1,Mostly Clear,8.9,2023-06-25 14:00:00,14
607,585,1192,51,30.1,1,Mostly Clear,9.0,2023-06-25 15:00:00,15
533,604,1137,51,30.1,1,Mostly Clear,9.2,2023-06-25 16:00:00,16
498,580,1078,49,30.2,1,Mostly Clear,9.4,2023-06-25 17:00:00,17
482,533,1015,50,29.9,1,Mostly Clear,5.8,2023-06-25 18:00:00,18
417,420,837,55,29.0,1,Mostly Clear,0.8,2023-06-25 19:00:00,19
346,382,728,62,27.4,1,Mostly Clear,4.8,2023-06-25 20:00:00,20
237,305,542,66,25.9,2,Partly Cloudy,6.4,2023-06-25 21:00:00,21
172,219,391,71,25.1,2,Partly Cloudy,10.1,2023-06-25 22:00:00,22
88,123,211,78,24.3,1,Mostly Clear,9.8,2023-06-25 23:00:00,23
40,57,97,83,23.8,1,Mostly Clear,8.7,2023-06-26 00:00:00,0
36,39,75,86,23.4,1,Mostly Clear,8.9,2023-06-26 01:00:00,1
17,17,34,87,23.0,0,Clear,9.0,2023-06-26 02:00:00,2
6,11,17,94,22.6,0,Clear,9.1,2023-06-26 03:00:00,3
10,11,21,94,22.4,0,Clear,8.6,2023-06-26 04:00:00,4
26,65,91,93,22.1,0,Clear,8.3,2023-06-26 05:00:00,5
68,216,284,93,21.7,2,Partly Cloudy,8.4,2023-06-26 06:00:00,6
139,419,558,90,22.2,1,Mostly Clear,8.8,2023-06-26 07:00:00,7
276,742,1018,85,23.6,1,Mostly Clear,9.4,2023-06-26 08:00:00,8
219,447,666,79,24.8,1,Mostly Clear,10.0,2023-06-26 09:00:00,9
217,322,539,75,26.0,1,Mostly Clear,6.8,2023-06-26 10:00:00,10
236,335,571,68,27.8,1,Mostly Clear,5.3,2023-06-26 11:00:00,11
276,376,652,62,29.7,2,Partly Cloudy,5.1,2023-06-26 12:00:00,12
216,396,612,58,30.9,3,Cloudy,7.2,2023-06-26 13:00:00,13
238,364,602,55,31.3,2,Partly Cloudy,9.4,2023-06-26 14:00:00,14
305,480,785,69,27.7,63,Rain,10.0,2023-06-26 15:00:00,15
356,636,992,65,28.5,1,Mostly Clear,10.6,2023-06-26 16:00:00,16
473,939,1412,60,29.0,0,Clear,10.7,2023-06-26 17:00:00,17
413,767,1180,61,28.8,51,Light Drizzle,8.1,2023-06-26 18:00:00,18
350,597,947,82,25.0,63,Rain,8.5,2023-06-26 19:00:00,19
278,477,755,90,23.6,63,Rain,8.6,2023-06-26 20:00:00,20
202,348,550,92,23.2,51,Light Drizzle,8.6,2023-06-26 21:00:00,21
128,187,315,93,22.8,0,Clear,9.2,2023-06-26 22:00:00,22
77,125,202,94,22.3,1,Mostly Clear,10.3,2023-06-26 23:00:00,23
22,42,64,93,22.0,1,Mostly Clear,10.4,2023-06-27 00:00:00,0
13,26,39,93,21.8,1,Mostly Clear,9.8,2023-06-27 01:00:00,1
6,11,17,94,21.5,1,Mostly Clear,7.8,2023-06-27 02:00:00,2
3,8,11,90,21.8,0,Clear,6.0,2023-06-27 03:00:00,3
12,21,33,93,21.4,1,Mostly Clear,5.9,2023-06-27 04:00:00,4
24,68,92,95,21.0,53,Heavy Drizzle,5.6,2023-06-27 05:00:00,5
92,236,328,97,20.6,55,Heavy Drizzle,6.3,2023-06-27 06:00:00,6
183,569,752,97,21.1,51,Light Drizzle,5.9,2023-06-27 07:00:00,7
303,997,1300,92,22.4,51,Light Drizzle,5.4,2023-06-27 08:00:00,8
295,551,846,88,23.4,51,Light Drizzle,4.0,2023-06-27 09:00:00,9
202,297,499,82,24.6,51,Light Drizzle,4.1,2023-06-27 10:00:00,10
222,383,605,73,25.9,51,Light Drizzle,3.1,2023-06-27 11:00:00,11
230,400,630,69,27.2,51,Light Drizzle,5.2,2023-06-27 12:00:00,12
290,407,697,62,28.2,51,Light Drizzle,8.8,2023-06-27 13:00:00,13
250,360,610,59,28.5,51,Light Drizzle,10.9,2023-06-27 14:00:00,14
107,266,373,59,28.4,1,Mostly Clear,10.2,2023-06-27 15:00:00,15
160,406,566,62,27.4,61,Light Rain,10.3,2023-06-27 16:00:00,16
480,1023,1503,79,24.3,63,Rain,14.4,2023-06-27 17:00:00,17
540,978,1518,81,23.6,51,Light Drizzle,3.1,2023-06-27 18:00:00,18
197,383,580,83,23.1,2,Partly Cloudy,2.1,2023-06-27 19:00:00,19
232,446,678,85,23.0,2,Partly Cloudy,2.8,2023-06-27 20:00:00,20
181,329,510,88,22.4,3,Cloudy,6.8,2023-06-27 21:00:00,21
169,237,406,88,22.2,2,Partly Cloudy,7.6,2023-06-27 22:00:00,22
92,98,190,86,22.0,1,Mostly Clear,8.9,2023-06-27 23:00:00,23
52,57,109,81,21.8,1,Mostly Clear,10.5,2023-06-28 00:00:00,0
8,27,35,79,21.3,1,Mostly Clear,12.3,2023-06-28 01:00:00,1
11,31,42,80,20.7,1,Mostly Clear,13.0,2023-06-28 02:00:00,2
6,11,17,82,20.1,0,Clear,12.6,2023-06-28 03:00:00,3
8,17,25,83,19.7,0,Clear,12.4,2023-06-28 04:00:00,4
22,79,101,84,19.4,0,Clear,12.1,2023-06-28 05:00:00,5
78,257,335,86,19.2,0,Clear,9.1,2023-06-28 06:00:00,6
165,568,733,85,19.6,0,Clear,10.1,2023-06-28 07:00:00,7
335,996,1331,80,20.9,2,Partly Cloudy,8.0,2023-06-28 08:00:00,8
255,530,785,73,22.0,2,Partly Cloudy,8.9,2023-06-28 09:00:00,9
176,322,498,67,23.3,1,Mostly Clear,11.9,2023-06-28 10:00:00,10
215,377,592,63,23.9,1,Mostly Clear,12.2,2023-06-28 11:00:00,11
266,435,701,58,24.8,1,Mostly Clear,13.4,2023-06-28 12:00:00,12
279,371,650,54,25.5,1,Mostly Clear,14.0,2023-06-28 13:00:00,13
323,438,761,55,25.4,1,Mostly Clear,13.0,2023-06-28 14:00:00,14
354,490,844,56,26.4,2,Partly Cloudy,13.8,2023-06-28 15:00:00,15
440,668,1108,54,26.4,2,Partly Cloudy,16.0,2023-06-28 16:00:00,16
660,1200,1860,57,25.5,1,Mostly Clear,15.0,2023-06-28 17:00:00,17
606,985,1591,57,25.4,3,Cloudy,11.0,2023-06-28 18:00:00,18
481,761,1242,61,24.9,3,Cloudy,8.9,2023-06-28 19:00:00,19
342,625,967,65,24.3,3,Cloudy,7.9,2023-06-28 20:00:00,20
304,434,738,68,23.3,3,Cloudy,9.0,2023-06-28 21:00:00,21
207,310,517,72,22.4,2,Partly Cloudy,9.2,2023-06-28 22:00:00,22
98,161,259,73,21.6,1,Mostly Clear,8.4,2023-06-28 23:00:00,23
40,73,113,75,21.0,1,Mostly Clear,8.7,2023-06-29 00:00:00,0
19,28,47,75,20.5,1,Mostly Clear,8.9,2023-06-29 01:00:00,1
5,7,12,76,19.9,0,Clear,9.2,2023-06-29 02:00:00,2
6,11,17,79,19.0,0,Clear,8.9,2023-06-29 03:00:00,3
8,20,28,82,18.3,0,Clear,8.8,2023-06-29 04:00:00,4
27,61,88,85,17.8,0,Clear,8.0,2023-06-29 05:00:00,5
70,208,278,88,17.2,0,Clear,5.8,2023-06-29 06:00:00,6
154,458,612,88,17.9,0,Clear,7.4,2023-06-29 07:00:00,7
296,795,1091,77,20.5,0,Clear,5.3,2023-06-29 08:00:00,8
254,497,751,70,22.6,0,Clear,4.0,2023-06-29 09:00:00,9
201,306,507,61,24.2,0,Clear,3.2,2023-06-29 10:00:00,10
261,302,563,55,25.3,0,Clear,1.5,2023-06-29 11:00:00,11
267,357,624,51,26.4,0,Clear,2.2,2023-06-29 12:00:00,12
287,336,623,47,27.3,0,Clear,3.1,2023-06-29 13:00:00,13
283,348,631,44,28.1,1,Mostly Clear,3.1,2023-06-29 14:00:00,14
312,486,798,40,28.8,0,Clear,2.5,2023-06-29 15:00:00,15
336,584,920,38,29.2,0,Clear,2.1,2023-06-29 16:00:00,16
504,950,1454,38,29.2,0,Clear,2.5,2023-06-29 17:00:00,17
463,903,1366,39,28.9,0,Clear,4.6,2023-06-29 18:00:00,18
366,676,1042,46,27.9,0,Clear,5.0,2023-06-29 19:00:00,19
309,510,819,59,25.9,0,Clear,5.1,2023-06-29 20:00:00,20
264,395,659,65,24.1,0,Clear,7.3,2023-06-29 21:00:00,21
170,309,479,70,23.1,0,Clear,8.5,2023-06-29 22:00:00,22
107,187,294,73,22.3,0,Clear,8.9,2023-06-29 23:00:00,23
48,87,135,76,21.6,0,Clear,8.0,2023-06-30 00:00:00,0
34,33,67,81,20.9,0,Clear,7.7,2023-06-30 01:00:00,1
15,24,39,86,20.2,0,Clear,7.6,2023-06-30 02:00:00,2
8,8,16,87,20.0,0,Clear,8.4,2023-06-30 03:00:00,3
5,19,24,90,19.6,0,Clear,7.8,2023-06-30 04:00:00,4
20,62,82,93,19.2,0,Clear,7.4,2023-06-30 05:00:00,5
68,193,261,95,18.9,0,Clear,8.4,2023-06-30 06:00:00,6
112,347,459,94,20.1,0,Clear,9.0,2023-06-30 07:00:00,7
234,563,797,84,22.8,2,Partly Cloudy,8.0,2023-06-30 08:00:00,8
226,406,632,78,24.3,2,Partly Cloudy,8.5,2023-06-30 09:00:00,9
236,359,595,72,25.8,1,Mostly Clear,9.7,2023-06-30 10:00:00,10
239,354,593,65,27.3,2,Partly Cloudy,10.3,2023-06-30 11:00:00,11
335,426,761,60,28.4,51,Light Drizzle,10.3,2023-06-30 12:00:00,12
343,467,810,58,28.7,2,Partly Cloudy,9.5,2023-06-30 13:00:00,13
359,501,860,57,29.4,51,Light Drizzle,7.8,2023-06-30 14:00:00,14
413,559,972,64,28.3,51,Light Drizzle,7.9,2023-06-30 15:00:00,15
319,550,869,74,27.2,61,Light Rain,7.1,2023-06-30 16:00:00,16
354,694,1048,77,25.5,65,Heavy Rain,10.0,2023-06-30 17:00:00,17
397,687,1084,89,24.2,63,Rain,5.5,2023-06-30 18:00:00,18
355,537,892,91,24.0,53,Heavy Drizzle,7.9,2023-06-30 19:00:00,19
272,412,684,92,23.6,3,Cloudy,9.0,2023-06-30 20:00:00,20
247,324,571,92,22.9,3,Cloudy,10.5,2023-06-30 21:00:00,21
172,266,438,93,22.5,3,Cloudy,10.6,2023-06-30 22:00:00,22
177,223,400,93,22.1,1,Mostly Clear,9.9,2023-06-30 23:00:00,23
111,126,237,18,29.0,0,Clear,9.8,2023-07-01 00:00:00,0
96,99,195,15,30.4,0,Clear,11.7,2023-07-01 01:00:00,1
85,68,153,14,31.4,0,Clear,16.8,2023-07-01 02:00:00,2
54,39,93,13,31.8,0,Clear,18.2,2023-07-01 03:00:00,3
20,14,34,12,32.4,0,Clear,14.0,2023-07-01 04:00:00,4
19,14,33,13,32.6,0,Clear,8.6,2023-07-01 05:00:00,5
44,99,143,14,32.8,0,Clear,5.6,2023-07-01 06:00:00,6
82,143,225,12,32.4,0,Clear,11.5,2023-07-01 07:00:00,7
179,248,427,12,32.0,0,Clear,11.9,2023-07-01 08:00:00,8
325,384,709,13,31.1,0,Clear,11.4,2023-07-01 09:00:00,9
480,437,917,19,29.4,0,Clear,16.6,2023-07-01 10:00:00,10
546,483,1029,25,27.2,0,Clear,17.6,2023-07-01 11:00:00,11
578,535,1113,29,26.0,0,Clear,13.7,2023-07-01 12:00:00,12
552,606,1158,32,24.9,0,Clear,14.3,2023-07-01 13:00:00,13
607,542,1149,37,23.9,0,Clear,12.7,2023-07-01 14:00:00,14
539,605,1144,41,23.0,0,Clear,9.7,2023-07-01 15:00:00,15
458,484,942,42,22.2,0,Clear,9.4,2023-07-01 16:00:00,16
484,438,922,42,21.7,0,Clear,11.6,2023-07-01 17:00:00,17
289,313,602,44,21.1,0,Clear,13.4,2023-07-01 18:00:00,18
115,166,281,55,18.4,0,Clear,6.2,2023-07-01 19:00:00,19
204,207,411,51,19.2,0,Clear,5.5,2023-07-01 20:00:00,20
189,273,462,38,21.9,0,Clear,4.3,2023-07-01 21:00:00,21
164,225,389,29,24.4,0,Clear,5.6,2023-07-01 22:00:00,22
115,154,269,24,26.8,0,Clear,3.3,2023-07-01 23:00:00,23
95,110,205,21,28.9,0,Clear,3.4,2023-07-02 00:00:00,0
114,102,216,18,30.7,0,Clear,4.7,2023-07-02 01:00:00,1
71,65,136,15,32.3,0,Clear,6.1,2023-07-02 02:00:00,2
31,33,64,12,33.6,0,Clear,8.5,2023-07-02 03:00:00,3
13,18,31,11,34.3,0,Clear,10.5,2023-07-02 04:00:00,4
18,19,37,10,34.6,0,Clear,11.5,2023-07-02 05:00:00,5
32,57,89,10,34.7,0,Clear,10.8,2023-07-02 06:00:00,6
53,133,186,9,33.7,0,Clear,1.6,2023-07-02 07:00:00,7
159,214,373,9,33.6,1,Mostly Clear,2.5,2023-07-02 08:00:00,8
318,313,631,9,33.0,0,Clear,6.2,2023-07-02 09:00:00,9
433,435,868,11,31.4,0,Clear,8.1,2023-07-02 10:00:00,10
511,473,984,13,30.4,1,Mostly Clear,6.9,2023-07-02 11:00:00,11
584,567,1151,13,30.3,0,Clear,4.5,2023-07-02 12:00:00,12
618,495,1113,15,27.8,0,Clear,6.6,2023-07-02 13:00:00,13
616,530,1146,17,27.2,0,Clear,11.3,2023-07-02 14:00:00,14
545,514,1059,22,25.5,1,Mostly Clear,9.7,2023-07-02 15:00:00,15
493,413,906,26,23.9,0,Clear,6.0,2023-07-02 16:00:00,16
374,405,779,27,23.0,0,Clear,7.2,2023-07-02 17:00:00,17
371,449,820,28,22.1,0,Clear,9.0,2023-07-02 18:00:00,18
343,369,712,31,23.0,1,Mostly Clear,9.0,2023-07-02 19:00:00,19
346,385,731,30,23.5,1,Mostly Clear,6.0,2023-07-02 20:00:00,20
239,292,531,27,25.3,0,Clear,4.9,2023-07-02 21:00:00,21
185,216,401,23,27.7,0,Clear,5.5,2023-07-02 22:00:00,22
114,145,259,21,29.7,0,Clear,4.5,2023-07-02 23:00:00,23
69,76,145,17,31.7,0,Clear,5.2,2023-07-03 00:00:00,0
32,36,68,14,33.2,0,Clear,4.2,2023-07-03 01:00:00,1
21,11,32,12,34.2,0,Clear,2.1,2023-07-03 02:00:00,2
10,8,18,10,35.5,0,Clear,8.9,2023-07-03 03:00:00,3
5,11,16,9,36.1,0,Clear,16.3,2023-07-03 04:00:00,4
29,48,77,9,36.0,0,Clear,11.3,2023-07-03 05:00:00,5
63,156,219,9,36.0,0,Clear,6.0,2023-07-03 06:00:00,6
105,286,391,8,35.4,0,Clear,0.8,2023-07-03 07:00:00,7
187,433,620,8,35.3,1,Mostly Clear,5.2,2023-07-03 08:00:00,8
287,342,629,9,35.5,2,Partly Cloudy,2.5,2023-07-03 09:00:00,9
422,320,742,17,31.1,2,Partly Cloudy,28.2,2023-07-03 10:00:00,10
473,380,853,18,30.6,3,Cloudy,33.5,2023-07-03 11:00:00,11
463,420,883,21,29.5,3,Cloudy,29.4,2023-07-03 12:00:00,12
472,469,941,22,29.2,3,Cloudy,19.2,2023-07-03 13:00:00,13
548,513,1061,21,29.0,2,Partly Cloudy,10.4,2023-07-03 14:00:00,14
507,570,1077,24,28.2,3,Cloudy,23.2,2023-07-03 15:00:00,15
456,571,1027,24,28.1,3,Cloudy,35.8,2023-07-03 16:00:00,16
541,559,1100,23,27.6,3,Cloudy,26.0,2023-07-03 17:00:00,17
485,562,1047,23,27.0,3,Cloudy,12.7,2023-07-03 18:00:00,18
425,528,953,31,25.8,2,Partly Cloudy,13.2,2023-07-03 19:00:00,19
363,449,812,31,25.9,2,Partly Cloudy,8.9,2023-07-03 20:00:00,20
384,353,737,28,27.0,1,Mostly Clear,10.4,2023-07-03 21:00:00,21
254,266,520,23,29.0,3,Cloudy,17.6,2023-07-03 22:00:00,22
48,63,111,20,30.3,3,Cloudy,20.1,2023-07-03 23:00:00,23
49,64,113,17,31.3,3,Cloudy,15.8,2023-07-04 00:00:00,0
45,44,89,15,32.4,3,Cloudy,12.2,2023-07-04 01:00:00,1
43,34,77,13,33.3,3,Cloudy,10.1,2023-07-04 02:00:00,2
19,15,34,13,33.9,2,Partly Cloudy,6.6,2023-07-04 03:00:00,3
9,7,16,13,34.2,2,Partly Cloudy,1.8,2023-07-04 04:00:00,4
14,24,38,12,34.8,0,Clear,2.4,2023-07-04 05:00:00,5
43,56,99,11,35.2,0,Clear,7.9,2023-07-04 06:00:00,6
86,160,246,11,35.0,1,Mostly Clear,24.2,2023-07-04 07:00:00,7
194,253,447,11,33.6,1,Mostly Clear,16.2,2023-07-04 08:00:00,8
404,353,757,13,32.7,1,Mostly Clear,10.8,2023-07-04 09:00:00,9
639,495,1134,14,32.5,0,Clear,9.0,2023-07-04 10:00:00,10
670,550,1220,12,32.5,1,Mostly Clear,17.4,2023-07-04 11:00:00,11
721,534,1255,12,31.6,1,Mostly Clear,17.3,2023-07-04 12:00:00,12
785,513,1298,14,30.2,1,Mostly Clear,21.2,2023-07-04 13:00:00,13
794,606,1400,17,28.1,0,Clear,21.3,2023-07-04 14:00:00,14
765,564,1329,22,25.4,1,Mostly Clear,5.4,2023-07-04 15:00:00,15
689,512,1201,22,24.6,1,Mostly Clear,10.2,2023-07-04 16:00:00,16
764,531,1295,23,24.6,2,Partly Cloudy,18.9,2023-07-04 17:00:00,17
930,518,1448,24,23.8,1,Mostly Clear,12.5,2023-07-04 18:00:00,18
884,549,1433,33,23.2,1,Mostly Clear,16.3,2023-07-04 19:00:00,19
958,522,1480,33,23.8,1,Mostly Clear,21.1,2023-07-04 20:00:00,20
972,672,1644,30,25.2,1,Mostly Clear,18.7,2023-07-04 21:00:00,21
813,567,1380,25,27.3,1,Mostly Clear,19.9,2023-07-04 22:00:00,22
260,237,497,22,28.9,2,Partly Cloudy,18.4,2023-07-04 23:00:00,23
93,101,194,20,30.0,2,Partly Cloudy,16.9,2023-07-05 00:00:00,0
32,32,64,18,30.7,2,Partly Cloudy,16.5,2023-07-05 01:00:00,1
46,25,71,17,31.2,1,Mostly Clear,13.1,2023-07-05 02:00:00,2
6,12,18,17,31.7,0,Clear,6.7,2023-07-05 03:00:00,3
10,15,25,15,32.5,0,Clear,6.3,2023-07-05 04:00:00,4
20,54,74,14,32.8,0,Clear,10.2,2023-07-05 05:00:00,5
55,192,247,14,33.0,0,Clear,14.8,2023-07-05 06:00:00,6
166,397,563,15,32.4,2,Partly Cloudy,2.6,2023-07-05 07:00:00,7
283,776,1059,14,32.3,2,Partly Cloudy,4.9,2023-07-05 08:00:00,8
262,495,757,15,32.0,3,Cloudy,6.3,2023-07-05 09:00:00,9
250,313,563,16,31.0,2,Partly Cloudy,5.4,2023-07-05 10:00:00,10
346,328,674,18,29.9,2,Partly Cloudy,8.4,2023-07-05 11:00:00,11
359,347,706,20,28.7,2,Partly Cloudy,10.0,2023-07-05 12:00:00,12
334,364,698,21,27.6,3,Cloudy,14.3,2023-07-05 13:00:00,13
281,370,651,18,27.3,2,Partly Cloudy,19.1,2023-07-05 14:00:00,14
217,285,502,19,26.5,2,Partly Cloudy,23.4,2023-07-05 15:00:00,15
267,462,729,20,25.2,0,Clear,22.1,2023-07-05 16:00:00,16
506,971,1477,21,24.5,0,Clear,21.5,2023-07-05 17:00:00,17
481,970,1451,21,23.9,0,Clear,20.6,2023-07-05 18:00:00,18
459,636,1095,26,24.1,0,Clear,24.8,2023-07-05 19:00:00,19
315,504,819,23,24.7,0,Clear,29.2,2023-07-05 20:00:00,20
290,376,666,20,26.1,0,Clear,25.1,2023-07-05 21:00:00,21
189,275,464,19,27.7,0,Clear,29.6,2023-07-05 22:00:00,22
74,108,182,27,28.0,0,Clear,23.6,2023-07-05 23:00:00,23
51,64,115,23,29.8,0,Clear,23.9,2023-07-06 00:00:00,0
41,21,62,28,28.6,51,Light Drizzle,23.9,2023-07-06 01:00:00,1
10,17,27,24,29.8,0,Clear,24.7,2023-07-06 02:00:00,2
5,5,10,23,30.4,0,Clear,20.7,2023-07-06 03:00:00,3
5,16,21,21,31.1,0,Clear,12.5,2023-07-06 04:00:00,4
27,82,109,20,31.4,0,Clear,7.4,2023-07-06 05:00:00,5
79,226,305,19,31.6,0,Clear,4.3,2023-07-06 06:00:00,6
165,499,664,16,32.5,0,Clear,7.9,2023-07-06 07:00:00,7
303,872,1175,16,32.2,0,Clear,11.3,2023-07-06 08:00:00,8
269,520,789,16,31.4,1,Mostly Clear,15.2,2023-07-06 09:00:00,9
235,320,555,16,30.6,2,Partly Cloudy,17.6,2023-07-06 10:00:00,10
266,329,595,16,30.1,2,Partly Cloudy,12.1,2023-07-06 11:00:00,11
295,333,628,16,29.0,3,Cloudy,10.8,2023-07-06 12:00:00,12
260,258,518,23,28.0,3,Cloudy,12.8,2023-07-06 13:00:00,13
236,249,485,25,27.6,2,Partly Cloudy,11.4,2023-07-06 14:00:00,14
234,392,626,26,27.3,3,Cloudy,12.6,2023-07-06 15:00:00,15
398,600,998,28,26.1,3,Cloudy,6.9,2023-07-06 16:00:00,16
592,1054,1646,30,25.5,1,Mostly Clear,6.7,2023-07-06 17:00:00,17
529,906,1435,31,24.8,1,Mostly Clear,9.5,2023-07-06 18:00:00,18
493,783,1276,42,22.9,1,Mostly Clear,4.0,2023-07-06 19:00:00,19
422,568,990,40,23.3,1,Mostly Clear,11.7,2023-07-06 20:00:00,20
287,413,700,39,23.9,1,Mostly Clear,18.7,2023-07-06 21:00:00,21
170,291,461,37,24.8,2,Partly Cloudy,15.6,2023-07-06 22:00:00,22
97,154,251,35,25.8,2,Partly Cloudy,14.0,2023-07-06 23:00:00,23
69,82,151,32,26.6,1,Mostly Clear,13.5,2023-07-07 00:00:00,0
37,44,81,31,27.4,1,Mostly Clear,12.3,2023-07-07 01:00:00,1
12,13,25,27,28.7,1,Mostly Clear,9.7,2023-07-07 02:00:00,2
13,7,20,25,29.2,1,Mostly Clear,7.9,2023-07-07 03:00:00,3
3,21,24,24,29.5,1,Mostly Clear,5.0,2023-07-07 04:00:00,4
32,65,97,23,29.6,1,Mostly Clear,0.8,2023-07-07 05:00:00,5
91,212,303,23,29.8,1,Mostly Clear,2.5,2023-07-07 06:00:00,6
146,409,555,27,27.3,1,Mostly Clear,4.3,2023-07-07 07:00:00,7
271,652,923,26,27.6,1,Mostly Clear,6.8,2023-07-07 08:00:00,8
276,496,772,26,27.4,1,Mostly Clear,5.9,2023-07-07 09:00:00,9
272,362,634,31,26.4,1,Mostly Clear,14.6,2023-07-07 10:00:00,10
224,351,575,36,25.0,1,Mostly Clear,26.2,2023-07-07 11:00:00,11
211,353,564,38,24.2,1,Mostly Clear,21.1,2023-07-07 12:00:00,12
222,316,538,39,23.8,1,Mostly Clear,17.7,2023-07-07 13:00:00,13
292,413,705,40,23.2,0,Clear,14.2,2023-07-07 14:00:00,14
351,490,841,41,22.5,0,Clear,10.0,2023-07-07 15:00:00,15
436,689,1125,42,21.9,1,Mostly Clear,13.2,2023-07-07 16:00:00,16
611,870,1481,44,21.3,1,Mostly Clear,11.1,2023-07-07 17:00:00,17
619,850,1469,45,20.8,1,Mostly Clear,8.7,2023-07-07 18:00:00,18
503,634,1137,50,20.1,1,Mostly Clear,8.4,2023-07-07 19:00:00,19
362,489,851,47,21.1,1,Mostly Clear,6.7,2023-07-07 20:00:00,20
332,418,750,42,22.8,1,Mostly Clear,5.7,2023-07-07 21:00:00,21
261,320,581,36,25.0,1,Mostly Clear,5.2,2023-07-07 22:00:00,22
177,248,425,31,26.9,1,Mostly Clear,8.0,2023-07-07 23:00:00,23
130,178,308,27,28.2,1,Mostly Clear,9.9,2023-07-08 00:00:00,0
94,96,190,22,29.6,2,Partly Cloudy,12.6,2023-07-08 01:00:00,1
63,59,122,19,30.5,1,Mostly Clear,15.7,2023-07-08 02:00:00,2
29,33,62,20,31.1,1,Mostly Clear,15.8,2023-07-08 03:00:00,3
8,17,25,20,31.2,1,Mostly Clear,16.8,2023-07-08 04:00:00,4
19,31,50,18,31.5,0,Clear,15.0,2023-07-08 05:00:00,5
48,98,146,17,31.7,0,Clear,13.8,2023-07-08 06:00:00,6
90,179,269,19,30.1,1,Mostly Clear,6.5,2023-07-08 07:00:00,7
207,283,490,19,30.3,0,Clear,3.3,2023-07-08 08:00:00,8
361,480,841,19,30.2,1,Mostly Clear,5.4,2023-07-08 09:00:00,9
434,523,957,19,29.1,0,Clear,17.1,2023-07-08 10:00:00,10
649,576,1225,20,28.1,1,Mostly Clear,12.0,2023-07-08 11:00:00,11
574,611,1185,21,27.4,1,Mostly Clear,9.9,2023-07-08 12:00:00,12
613,640,1253,23,26.3,1,Mostly Clear,13.6,2023-07-08 13:00:00,13
570,662,1232,23,25.5,1,Mostly Clear,12.1,2023-07-08 14:00:00,14
637,593,1230,24,25.0,2,Partly Cloudy,13.1,2023-07-08 15:00:00,15
574,580,1154,26,24.1,3,Cloudy,15.7,2023-07-08 16:00:00,16
447,484,931,27,23.5,1,Mostly Clear,14.2,2023-07-08 17:00:00,17
383,456,839,26,23.1,1,Mostly Clear,14.4,2023-07-08 18:00:00,18
487,472,959,29,22.0,2,Partly Cloudy,10.1,2023-07-08 19:00:00,19
492,394,886,27,22.8,1,Mostly Clear,8.0,2023-07-08 20:00:00,20
386,350,736,24,24.4,1,Mostly Clear,6.3,2023-07-08 21:00:00,21
289,318,607,21,26.4,2,Partly Cloudy,8.8,2023-07-08 22:00:00,22
229,265,494,16,28.6,2,Partly Cloudy,12.1,2023-07-08 23:00:00,23
191,198,389,13,30.2,1,Mostly Clear,14.0,2023-07-09 00:00:00,0
125,127,252,12,31.4,1,Mostly Clear,13.8,2023-07-09 01:00:00,1
110,74,184,12,32.2,2,Partly Cloudy,8.7,2023-07-09 02:00:00,2
49,43,92,12,32.6,0,Clear,5.0,2023-07-09 03:00:00,3
11,18,29,12,33.1,0,Clear,5.5,2023-07-09 04:00:00,4
21,26,47,12,33.2,0,Clear,4.8,2023-07-09 05:00:00,5
48,90,138,11,33.3,1,Mostly Clear,5.9,2023-07-09 06:00:00,6
71,157,228,11,31.7,0,Clear,3.4,2023-07-09 07:00:00,7
147,258,405,11,31.4,0,Clear,2.8,2023-07-09 08:00:00,8
269,414,683,11,30.8,1,Mostly Clear,6.2,2023-07-09 09:00:00,9
410,504,914,12,30.1,0,Clear,7.6,2023-07-09 10:00:00,10
481,522,1003,14,29.3,0,Clear,13.2,2023-07-09 11:00:00,11
517,606,1123,22,27.0,0,Clear,16.5,2023-07-09 12:00:00,12
536,601,1137,24,25.9,0,Clear,15.4,2023-07-09 13:00:00,13
562,575,1137,25,24.9,0,Clear,16.3,2023-07-09 14:00:00,14
372,428,800,26,23.8,1,Mostly Clear,14.7,2023-07-09 15:00:00,15
295,347,642,26,23.8,1,Mostly Clear,14.4,2023-07-09 16:00:00,16
405,499,904,26,23.2,1,Mostly Clear,13.6,2023-07-09 17:00:00,17
412,532,944,25,22.9,1,Mostly Clear,11.5,2023-07-09 18:00:00,18
396,442,838,31,22.2,1,Mostly Clear,9.1,2023-07-09 19:00:00,19
325,371,696,28,23.2,1,Mostly Clear,9.5,2023-07-09 20:00:00,20
238,271,509,25,24.8,1,Mostly Clear,9.4,2023-07-09 21:00:00,21
142,189,331,23,26.6,1,Mostly Clear,10.5,2023-07-09 22:00:00,22
81,110,191,20,28.1,1,Mostly Clear,10.4,2023-07-09 23:00:00,23
33,51,84,18,29.6,2,Partly Cloudy,9.2,2023-07-10 00:00:00,0
23,15,38,17,30.5,2,Partly Cloudy,6.5,2023-07-10 01:00:00,1
17,11,28,16,31.8,1,Mostly Clear,6.7,2023-07-10 02:00:00,2
9,17,26,14,32.7,1,Mostly Clear,7.2,2023-07-10 03:00:00,3
12,21,33,13,33.0,1,Mostly Clear,6.3,2023-07-10 04:00:00,4
16,69,85,12,33.4,1,Mostly Clear,9.7,2023-07-10 05:00:00,5
73,223,296,12,33.5,1,Mostly Clear,10.9,2023-07-10 06:00:00,6
162,491,653,14,32.6,2,Partly Cloudy,14.3,2023-07-10 07:00:00,7
268,800,1068,15,32.2,2,Partly Cloudy,15.8,2023-07-10 08:00:00,8
215,467,682,16,31.6,1,Mostly Clear,16.2,2023-07-10 09:00:00,9
214,337,551,18,30.4,1,Mostly Clear,13.8,2023-07-10 10:00:00,10
264,355,619,19,29.6,2,Partly Cloudy,8.3,2023-07-10 11:00:00,11
305,390,695,22,28.7,2,Partly Cloudy,10.5,2023-07-10 12:00:00,12
282,353,635,24,27.5,1,Mostly Clear,9.2,2023-07-10 13:00:00,13
301,392,693,28,25.9,0,Clear,5.0,2023-07-10 14:00:00,14
336,489,825,26,25.5,1,Mostly Clear,10.2,2023-07-10 15:00:00,15
392,626,1018,22,25.4,1,Mostly Clear,13.5,2023-07-10 16:00:00,16
527,1028,1555,21,24.7,2,Partly Cloudy,14.5,2023-07-10 17:00:00,17
583,994,1577,21,23.9,3,Cloudy,13.9,2023-07-10 18:00:00,18
463,783,1246,29,22.5,1,Mostly Clear,8.1,2023-07-10 19:00:00,19
394,599,993,24,23.6,1,Mostly Clear,5.5,2023-07-10 20:00:00,20
251,410,661,22,25.1,1,Mostly Clear,8.0,2023-07-10 21:00:00,21
144,253,397,20,26.7,0,Clear,8.5,2023-07-10 22:00:00,22
92,128,220,15,29.6,0,Clear,19.5,2023-07-10 23:00:00,23
46,72,118,13,30.9,0,Clear,20.9,2023-07-11 00:00:00,0
14,28,42,14,31.5,0,Clear,16.3,2023-07-11 01:00:00,1
16,18,34,14,32.1,0,Clear,14.6,2023-07-11 02:00:00,2
7,5,12,12,32.9,0,Clear,11.2,2023-07-11 03:00:00,3
7,15,22,10,33.3,0,Clear,8.9,2023-07-11 04:00:00,4
29,66,95,9,34.0,1,Mostly Clear,11.7,2023-07-11 05:00:00,5
78,244,322,8,34.6,2,Partly Cloudy,18.4,2023-07-11 06:00:00,6
187,597,784,9,32.6,0,Clear,21.3,2023-07-11 07:00:00,7
351,997,1348,9,32.3,0,Clear,8.1,2023-07-11 08:00:00,8
241,574,815,12,31.2,0,Clear,3.1,2023-07-11 09:00:00,9
213,272,485,12,29.7,0,Clear,6.4,2023-07-11 10:00:00,10
244,347,591,13,28.4,0,Clear,6.1,2023-07-11 11:00:00,11
289,373,662,15,26.9,0,Clear,7.7,2023-07-11 12:00:00,12
270,360,630,19,25.5,0,Clear,7.5,2023-07-11 13:00:00,13
252,372,624,19,25.3,0,Clear,5.4,2023-07-11 14:00:00,14
295,477,772,17,25.8,0,Clear,1.3,2023-07-11 15:00:00,15
385,708,1093,25,22.2,0,Clear,7.6,2023-07-11 16:00:00,16
591,1236,1827,31,21.3,0,Clear,9.0,2023-07-11 17:00:00,17
609,1093,1702,38,20.9,0,Clear,18.0,2023-07-11 18:00:00,18
491,782,1273,53,20.7,0,Clear,8.6,2023-07-11 19:00:00,19
434,669,1103,51,21.3,0,Clear,9.9,2023-07-11 20:00:00,20
301,461,762,48,23.0,0,Clear,11.0,2023-07-11 21:00:00,21
196,307,503,42,25.1,0,Clear,11.2,2023-07-11 22:00:00,22
111,126,237,32,27.4,0,Clear,13.0,2023-07-11 23:00:00,23
32,61,93,24,29.8,0,Clear,13.1,2023-07-12 00:00:00,0
16,32,48,19,32.0,0,Clear,13.8,2023-07-12 01:00:00,1
9,18,27,15,33.1,0,Clear,13.0,2023-07-12 02:00:00,2
5,5,10,14,33.8,0,Clear,16.1,2023-07-12 03:00:00,3
7,16,23,14,34.1,0,Clear,17.0,2023-07-12 04:00:00,4
30,61,91,14,34.2,0,Clear,14.5,2023-07-12 05:00:00,5
91,253,344,14,33.9,0,Clear,11.5,2023-07-12 06:00:00,6
197,596,793,13,33.7,0,Clear,8.9,2023-07-12 07:00:00,7
323,980,1303,13,33.5,0,Clear,5.2,2023-07-12 08:00:00,8
242,522,764,14,33.0,0,Clear,3.6,2023-07-12 09:00:00,9
218,304,522,14,31.6,0,Clear,9.6,2023-07-12 10:00:00,10
223,303,526,16,30.3,0,Clear,10.6,2023-07-12 11:00:00,11
224,386,610,19,29.0,0,Clear,13.0,2023-07-12 12:00:00,12
269,379,648,23,28.1,0,Clear,19.3,2023-07-12 13:00:00,13
255,360,615,23,27.4,0,Clear,21.7,2023-07-12 14:00:00,14
294,460,754,25,26.0,0,Clear,15.0,2023-07-12 15:00:00,15
387,722,1109,28,24.8,0,Clear,11.7,2023-07-12 16:00:00,16
576,1143,1719,31,23.9,0,Clear,12.2,2023-07-12 17:00:00,17
609,1077,1686,33,23.3,0,Clear,10.8,2023-07-12 18:00:00,18
487,786,1273,39,22.1,0,Clear,10.5,2023-07-12 19:00:00,19
391,629,1020,38,22.8,0,Clear,7.5,2023-07-12 20:00:00,20
289,496,785,35,24.3,0,Clear,2.9,2023-07-12 21:00:00,21
209,301,510,31,26.3,0,Clear,5.5,2023-07-12 22:00:00,22
115,136,251,26,28.8,0,Clear,9.2,2023-07-12 23:00:00,23
44,65,109,22,31.1,0,Clear,10.1,2023-07-13 00:00:00,0
20,26,46,18,32.9,0,Clear,9.7,2023-07-13 01:00:00,1
27,10,37,16,34.1,0,Clear,9.2,2023-07-13 02:00:00,2
6,9,15,15,35.2,0,Clear,10.7,2023-07-13 03:00:00,3
10,11,21,14,35.8,0,Clear,12.9,2023-07-13 04:00:00,4
32,72,104,13,36.2,0,Clear,14.3,2023-07-13 05:00:00,5
92,248,340,13,36.4,0,Clear,15.6,2023-07-13 06:00:00,6
171,510,681,13,35.3,0,Clear,13.0,2023-07-13 07:00:00,7
340,948,1288,14,34.9,0,Clear,15.2,2023-07-13 08:00:00,8
285,538,823,14,34.0,0,Clear,16.9,2023-07-13 09:00:00,9
245,325,570,16,32.5,0,Clear,12.7,2023-07-13 10:00:00,10
226,336,562,18,30.9,0,Clear,10.1,2023-07-13 11:00:00,11
307,397,704,20,29.5,0,Clear,10.0,2023-07-13 12:00:00,12
235,374,609,22,28.3,0,Clear,10.1,2023-07-13 13:00:00,13
298,356,654,24,27.0,0,Clear,10.4,2023-07-13 14:00:00,14
305,452,757,26,25.9,0,Clear,10.3,2023-07-13 15:00:00,15
321,601,922,29,24.5,0,Clear,9.8,2023-07-13 16:00:00,16
577,1041,1618,31,23.6,0,Clear,10.0,2023-07-13 17:00:00,17
616,914,1530,30,23.2,0,Clear,11.2,2023-07-13 18:00:00,18
509,735,1244,31,22.4,0,Clear,10.2,2023-07-13 19:00:00,19
391,536,927,30,22.8,0,Clear,10.0,2023-07-13 20:00:00,20
283,452,735,25,24.6,0,Clear,2.2,2023-07-13 21:00:00,21
210,315,525,20,27.7,0,Clear,4.0,2023-07-13 22:00:00,22
135,181,316,17,30.1,0,Clear,4.9,2023-07-13 23:00:00,23
64,85,149,15,32.2,0,Clear,3.0,2023-07-14 00:00:00,0
28,39,67,14,33.9,0,Clear,1.8,2023-07-14 01:00:00,1
21,16,37,12,35.4,0,Clear,8.6,2023-07-14 02:00:00,2
10,15,25,11,36.5,0,Clear,11.3,2023-07-14 03:00:00,3
4,28,32,10,37.2,0,Clear,10.0,2023-07-14 04:00:00,4
24,52,76,10,37.6,0,Clear,9.9,2023-07-14 05:00:00,5
74,216,290,10,37.7,0,Clear,13.8,2023-07-14 06:00:00,6
130,403,533,10,37.0,0,Clear,5.8,2023-07-14 07:00:00,7
255,649,904,10,36.6,0,Clear,8.4,2023-07-14 08:00:00,8
216,495,711,11,35.2,0,Clear,13.1,2023-07-14 09:00:00,9
226,336,562,12,33.3,0,Clear,12.6,2023-07-14 10:00:00,10
255,385,640,13,31.9,0,Clear,11.2,2023-07-14 11:00:00,11
303,440,743,15,30.7,0,Clear,10.8,2023-07-14 12:00:00,12
343,456,799,17,29.8,0,Clear,10.6,2023-07-14 13:00:00,13
359,477,836,19,28.4,0,Clear,9.8,2023-07-14 14:00:00,14
376,527,903,22,26.8,0,Clear,8.2,2023-07-14 15:00:00,15
462,672,1134,23,26.5,0,Clear,4.4,2023-07-14 16:00:00,16
597,857,1454,24,24.8,0,Clear,6.5,2023-07-14 17:00:00,17
90,194,284,20,26.2,0,Clear,4.2,2023-07-14 18:00:00,18
269,454,723,24,22.4,0,Clear,9.4,2023-07-14 19:00:00,19
347,455,802,22,23.1,0,Clear,9.3,2023-07-14 20:00:00,20
310,344,654,23,25.7,0,Clear,7.4,2023-07-14 21:00:00,21
243,304,547,19,29.1,0,Clear,5.4,2023-07-14 22:00:00,22
190,245,435,16,31.7,0,Clear,5.2,2023-07-14 23:00:00,23
113,184,297,14,33.6,0,Clear,4.9,2023-07-15 00:00:00,0
136,110,246,12,35.3,0,Clear,6.4,2023-07-15 01:00:00,1
94,99,193,10,36.8,0,Clear,6.8,2023-07-15 02:00:00,2
40,30,70,9,37.6,0,Clear,8.6,2023-07-15 03:00:00,3
8,27,35,9,38.1,0,Clear,7.4,2023-07-15 04:00:00,4
17,48,65,8,39.0,0,Clear,10.8,2023-07-15 05:00:00,5
57,90,147,8,39.0,0,Clear,20.7,2023-07-15 06:00:00,6
95,193,288,7,38.5,0,Clear,17.7,2023-07-15 07:00:00,7
240,287,527,7,37.3,0,Clear,24.8,2023-07-15 08:00:00,8
381,507,888,8,36.0,0,Clear,21.5,2023-07-15 09:00:00,9
511,528,1039,9,34.0,0,Clear,17.3,2023-07-15 10:00:00,10
584,532,1116,10,33.0,0,Clear,14.8,2023-07-15 11:00:00,11
655,598,1253,11,31.9,0,Clear,13.0,2023-07-15 12:00:00,12
740,523,1263,11,30.6,0,Clear,11.5,2023-07-15 13:00:00,13
601,547,1148,13,29.0,0,Clear,9.7,2023-07-15 14:00:00,14
624,554,1178,13,28.4,0,Clear,11.3,2023-07-15 15:00:00,15
512,557,1069,16,26.1,0,Clear,7.8,2023-07-15 16:00:00,16
611,503,1114,20,24.7,0,Clear,6.4,2023-07-15 17:00:00,17
500,585,1085,20,23.9,0,Clear,8.7,2023-07-15 18:00:00,18
549,496,1045,20,24.0,0,Clear,5.6,2023-07-15 19:00:00,19
451,440,891,19,24.6,0,Clear,10.1,2023-07-15 20:00:00,20
331,315,646,16,27.1,1,Mostly Clear,7.6,2023-07-15 21:00:00,21
114,140,254,14,30.1,1,Mostly Clear,8.0,2023-07-15 22:00:00,22
67,142,209,13,32.3,1,Mostly Clear,10.6,2023-07-15 23:00:00,23
81,130,211,13,34.0,0,Clear,11.4,2023-07-16 00:00:00,0
60,63,123,11,35.6,0,Clear,11.6,2023-07-16 01:00:00,1
86,95,181,10,37.1,0,Clear,10.2,2023-07-16 02:00:00,2
51,32,83,9,38.3,0,Clear,7.6,2023-07-16 03:00:00,3
17,15,32,7,39.4,0,Clear,11.5,2023-07-16 04:00:00,4
17,16,33,8,39.7,1,Mostly Clear,15.9,2023-07-16 05:00:00,5
39,81,120,8,39.5,1,Mostly Clear,10.2,2023-07-16 06:00:00,6
60,130,190,9,37.3,3,Cloudy,21.5,2023-07-16 07:00:00,7
133,220,353,9,36.7,3,Cloudy,25.7,2023-07-16 08:00:00,8
242,357,599,9,36.2,2,Partly Cloudy,25.4,2023-07-16 09:00:00,9
338,358,696,9,35.2,2,Partly Cloudy,21.6,2023-07-16 10:00:00,10
295,373,668,11,34.4,2,Partly Cloudy,17.6,2023-07-16 11:00:00,11
317,334,651,11,33.7,2,Partly Cloudy,15.5,2023-07-16 12:00:00,12
451,445,896,12,32.7,2,Partly Cloudy,14.6,2023-07-16 13:00:00,13
544,532,1076,13,31.7,2,Partly Cloudy,15.5,2023-07-16 14:00:00,14
517,546,1063,14,31.0,3,Cloudy,18.1,2023-07-16 15:00:00,15
500,595,1095,15,30.2,3,Cloudy,16.5,2023-07-16 16:00:00,16
507,650,1157,16,29.8,3,Cloudy,19.5,2023-07-16 17:00:00,17
488,605,1093,21,29.5,3,Cloudy,22.1,2023-07-16 18:00:00,18
438,467,905,19,31.0,3,Cloudy,30.3,2023-07-16 19:00:00,19
366,376,742,21,30.6,3,Cloudy,26.3,2023-07-16 20:00:00,20
226,290,516,24,31.0,1,Mostly Clear,33.2,2023-07-16 21:00:00,21
210,187,397,20,32.9,3,Cloudy,25.3,2023-07-16 22:00:00,22
103,108,211,18,33.6,3,Cloudy,26.5,2023-07-16 23:00:00,23
36,47,83,17,34.3,2,Partly Cloudy,27.1,2023-07-17 00:00:00,0
22,29,51,14,35.7,1,Mostly Clear,24.2,2023-07-17 01:00:00,1
9,22,31,12,37.4,1,Mostly Clear,15.8,2023-07-17 02:00:00,2
17,12,29,11,38.1,0,Clear,16.2,2023-07-17 03:00:00,3
13,16,29,10,38.5,1,Mostly Clear,14.2,2023-07-17 04:00:00,4
33,65,98,10,38.8,0,Clear,14.1,2023-07-17 05:00:00,5
82,227,309,10,39.2,0,Clear,12.4,2023-07-17 06:00:00,6
138,481,619,10,37.9,0,Clear,10.4,2023-07-17 07:00:00,7
311,813,1124,10,37.6,0,Clear,9.8,2023-07-17 08:00:00,8
254,456,710,11,36.4,0,Clear,11.5,2023-07-17 09:00:00,9
253,240,493,12,34.9,0,Clear,11.5,2023-07-17 10:00:00,10
259,302,561,13,33.4,0,Clear,9.9,2023-07-17 11:00:00,11
310,373,683,15,31.9,0,Clear,8.9,2023-07-17 12:00:00,12
279,335,614,14,32.0,0,Clear,3.3,2023-07-17 13:00:00,13
262,334,596,18,29.2,0,Clear,8.3,2023-07-17 14:00:00,14
337,467,804,18,28.6,0,Clear,10.8,2023-07-17 15:00:00,15
363,612,975,20,27.6,0,Clear,13.1,2023-07-17 16:00:00,16
534,952,1486,21,26.9,0,Clear,15.0,2023-07-17 17:00:00,17
560,919,1479,24,25.7,0,Clear,16.1,2023-07-17 18:00:00,18
482,712,1194,31,24.7,0,Clear,9.0,2023-07-17 19:00:00,19
368,527,895,30,26.1,0,Clear,12.5,2023-07-17 20:00:00,20
217,353,570,27,28.3,0,Clear,9.9,2023-07-17 21:00:00,21
175,245,420,24,30.7,0,Clear,10.3,2023-07-17 22:00:00,22
92,111,203,22,32.5,0,Clear,11.2,2023-07-17 23:00:00,23
37,37,74,18,34.6,0,Clear,6.9,2023-07-18 00:00:00,0
15,19,34,15,36.2,0,Clear,3.2,2023-07-18 01:00:00,1
22,9,31,13,37.3,0,Clear,1.3,2023-07-18 02:00:00,2
12,14,26,12,38.2,0,Clear,2.8,2023-07-18 03:00:00,3
11,16,27,11,38.9,0,Clear,2.3,2023-07-18 04:00:00,4
34,62,96,11,39.3,0,Clear,1.8,2023-07-18 05:00:00,5
78,261,339,11,39.6,0,Clear,1.8,2023-07-18 06:00:00,6
178,595,773,11,39.0,0,Clear,8.1,2023-07-18 07:00:00,7
334,1018,1352,11,38.7,0,Clear,11.5,2023-07-18 08:00:00,8
245,556,801,12,37.6,0,Clear,13.6,2023-07-18 09:00:00,9
190,319,509,13,36.2,0,Clear,10.5,2023-07-18 10:00:00,10
218,350,568,15,34.9,0,Clear,4.7,2023-07-18 11:00:00,11
221,340,561,15,34.5,0,Clear,5.4,2023-07-18 12:00:00,12
296,377,673,17,32.5,0,Clear,7.8,2023-07-18 13:00:00,13
276,370,646,17,31.3,0,Clear,9.2,2023-07-18 14:00:00,14
311,496,807,19,30.3,0,Clear,6.9,2023-07-18 15:00:00,15
382,754,1136,19,30.0,1,Mostly Clear,9.8,2023-07-18 16:00:00,16
604,1168,1772,19,29.9,1,Mostly Clear,12.2,2023-07-18 17:00:00,17
637,1089,1726,19,29.5,1,Mostly Clear,13.4,2023-07-18 18:00:00,18
586,825,1411,23,29.2,2,Partly Cloudy,7.3,2023-07-18 19:00:00,19
389,656,1045,25,28.6,1,Mostly Clear,5.4,2023-07-18 20:00:00,20
325,478,803,21,30.2,0,Clear,10.5,2023-07-18 21:00:00,21
228,314,542,19,32.3,1,Mostly Clear,18.1,2023-07-18 22:00:00,22
126,155,281,17,34.0,0,Clear,26.0,2023-07-18 23:00:00,23
45,53,98,15,35.8,0,Clear,24.3,2023-07-19 00:00:00,0
16,30,46,14,37.1,0,Clear,21.9,2023-07-19 01:00:00,1
5,7,12,12,38.6,0,Clear,21.8,2023-07-19 02:00:00,2
9,7,16,11,39.7,0,Clear,23.8,2023-07-19 03:00:00,3
6,20,26,11,40.2,0,Clear,24.9,2023-07-19 04:00:00,4
15,27,42,10,40.6,0,Clear,22.7,2023-07-19 05:00:00,5
35,99,134,9,41.5,2,Partly Cloudy,17.7,2023-07-19 06:00:00,6
64,247,311,11,39.5,0,Clear,19.2,2023-07-19 07:00:00,7
253,849,1102,10,40.0,2,Partly Cloudy,20.3,2023-07-19 08:00:00,8
249,575,824,12,37.8,2,Partly Cloudy,26.1,2023-07-19 09:00:00,9
219,359,578,13,36.3,2,Partly Cloudy,24.1,2023-07-19 10:00:00,10
231,401,632,14,35.3,1,Mostly Clear,24.3,2023-07-19 11:00:00,11
254,415,669,15,34.1,0,Clear,30.8,2023-07-19 12:00:00,12
250,409,659,16,33.1,1,Mostly Clear,23.5,2023-07-19 13:00:00,13
273,382,655,17,32.4,0,Clear,23.0,2023-07-19 14:00:00,14
304,494,798,18,31.7,0,Clear,24.9,2023-07-19 15:00:00,15
438,700,1138,18,30.8,0,Clear,24.2,2023-07-19 16:00:00,16
677,1183,1860,19,29.9,0,Clear,22.3,2023-07-19 17:00:00,17
674,1119,1793,21,28.3,0,Clear,9.0,2023-07-19 18:00:00,18
534,815,1349,26,26.9,0,Clear,13.0,2023-07-19 19:00:00,19
459,647,1106,25,27.7,0,Clear,12.6,2023-07-19 20:00:00,20
288,478,766,22,29.7,1,Mostly Clear,11.8,2023-07-19 21:00:00,21
253,318,571,20,31.0,2,Partly Cloudy,10.1,2023-07-19 22:00:00,22
157,187,344,19,31.8,2,Partly Cloudy,9.4,2023-07-19 23:00:00,23
57,79,136,16,33.9,1,Mostly Clear,11.7,2023-07-20 00:00:00,0
34,34,68,13,35.8,0,Clear,11.6,2023-07-20 01:00:00,1
11,15,26,12,37.1,0,Clear,13.6,2023-07-20 02:00:00,2
4,6,10,10,38.6,0,Clear,10.9,2023-07-20 03:00:00,3
10,12,22,9,39.9,1,Mostly Clear,7.0,2023-07-20 04:00:00,4
24,70,94,9,40.4,2,Partly Cloudy,19.8,2023-07-20 05:00:00,5
97,259,356,9,39.6,1,Mostly Clear,19.5,2023-07-20 06:00:00,6
172,530,702,10,39.2,2,Partly Cloudy,18.9,2023-07-20 07:00:00,7
315,953,1268,11,38.1,2,Partly Cloudy,17.9,2023-07-20 08:00:00,8
260,570,830,12,37.3,2,Partly Cloudy,15.0,2023-07-20 09:00:00,9
220,361,581,13,36.4,2,Partly Cloudy,14.5,2023-07-20 10:00:00,10
279,337,616,13,36.0,3,Cloudy,12.8,2023-07-20 11:00:00,11
312,457,769,14,35.2,3,Cloudy,11.3,2023-07-20 12:00:00,12
299,421,720,15,34.1,2,Partly Cloudy,12.5,2023-07-20 13:00:00,13
332,390,722,16,33.1,2,Partly Cloudy,7.7,2023-07-20 14:00:00,14
395,469,864,16,32.7,2,Partly Cloudy,13.0,2023-07-20 15:00:00,15
466,671,1137,17,32.3,1,Mostly Clear,23.7,2023-07-20 16:00:00,16
713,1188,1901,18,30.9,0,Clear,20.3,2023-07-20 17:00:00,17
668,1045,1713,19,29.6,0,Clear,18.1,2023-07-20 18:00:00,18
470,749,1219,22,29.5,2,Partly Cloudy,18.5,2023-07-20 19:00:00,19
488,659,1147,22,29.2,2,Partly Cloudy,11.3,2023-07-20 20:00:00,20
303,430,733,21,29.9,2,Partly Cloudy,8.6,2023-07-20 21:00:00,21
258,369,627,21,30.8,1,Mostly Clear,16.5,2023-07-20 22:00:00,22
148,210,358,19,32.1,1,Mostly Clear,21.1,2023-07-20 23:00:00,23
94,112,206,17,33.2,2,Partly Cloudy,19.4,2023-07-21 00:00:00,0
41,60,101,15,34.3,0,Clear,16.6,2023-07-21 01:00:00,1
23,12,35,13,36.0,1,Mostly Clear,16.8,2023-07-21 02:00:00,2
8,18,26,12,36.6,0,Clear,18.7,2023-07-21 03:00:00,3
4,10,14,12,37.3,0,Clear,17.4,2023-07-21 04:00:00,4
16,40,56,11,37.8,0,Clear,14.6,2023-07-21 05:00:00,5
47,144,191,10,38.2,0,Clear,13.7,2023-07-21 06:00:00,6
141,386,527,13,36.3,0,Clear,14.8,2023-07-21 07:00:00,7
260,673,933,13,35.9,0,Clear,11.1,2023-07-21 08:00:00,8
258,447,705,13,35.2,0,Clear,5.1,2023-07-21 09:00:00,9
352,353,705,15,33.8,1,Mostly Clear,6.0,2023-07-21 10:00:00,10
380,419,799,15,33.3,1,Mostly Clear,9.0,2023-07-21 11:00:00,11
414,469,883,16,32.9,2,Partly Cloudy,7.7,2023-07-21 12:00:00,12
427,497,924,17,32.2,3,Cloudy,7.3,2023-07-21 13:00:00,13
392,469,861,18,31.4,2,Partly Cloudy,9.7,2023-07-21 14:00:00,14
455,591,1046,20,30.4,0,Clear,4.2,2023-07-21 15:00:00,15
557,769,1326,22,28.7,0,Clear,7.6,2023-07-21 16:00:00,16
701,979,1680,23,28.0,0,Clear,8.7,2023-07-21 17:00:00,17
641,883,1524,25,27.3,1,Mostly Clear,11.0,2023-07-21 18:00:00,18
541,655,1196,31,27.3,0,Clear,15.5,2023-07-21 19:00:00,19
509,535,1044,31,27.2,0,Clear,12.0,2023-07-21 20:00:00,20
336,429,765,27,29.1,0,Clear,9.2,2023-07-21 21:00:00,21
330,353,683,22,31.4,0,Clear,8.7,2023-07-21 22:00:00,22
275,326,601,19,33.1,0,Clear,8.3,2023-07-21 23:00:00,23
179,225,404,17,34.4,0,Clear,6.4,2023-07-22 00:00:00,0
173,143,316,15,35.5,0,Clear,8.4,2023-07-22 01:00:00,1
105,61,166,14,36.5,0,Clear,12.5,2023-07-22 02:00:00,2
32,36,68,13,37.2,0,Clear,12.5,2023-07-22 03:00:00,3
13,19,32,12,38.4,0,Clear,12.9,2023-07-22 04:00:00,4
17,30,47,12,38.9,0,Clear,23.9,2023-07-22 05:00:00,5
37,71,108,13,37.8,0,Clear,30.0,2023-07-22 06:00:00,6
96,162,258,12,37.8,0,Clear,14.7,2023-07-22 07:00:00,7
214,311,525,13,36.6,0,Clear,21.0,2023-07-22 08:00:00,8
370,416,786,14,35.6,0,Clear,23.5,2023-07-22 09:00:00,9
551,581,1132,15,34.5,0,Clear,19.6,2023-07-22 10:00:00,10
685,577,1262,16,33.7,0,Clear,14.3,2023-07-22 11:00:00,11
772,573,1345,17,32.5,0,Clear,10.8,2023-07-22 12:00:00,12
782,638,1420,19,31.2,1,Mostly Clear,9.8,2023-07-22 13:00:00,13
748,569,1317,22,29.3,0,Clear,5.8,2023-07-22 14:00:00,14
690,639,1329,24,28.0,0,Clear,6.7,2023-07-22 15:00:00,15
690,584,1274,24,27.5,0,Clear,9.8,2023-07-22 16:00:00,16
672,589,1261,25,27.0,0,Clear,12.3,2023-07-22 17:00:00,17
644,524,1168,25,26.5,1,Mostly Clear,13.5,2023-07-22 18:00:00,18
639,554,1193,28,25.8,1,Mostly Clear,8.7,2023-07-22 19:00:00,19
551,465,1016,29,25.7,2,Partly Cloudy,7.3,2023-07-22 20:00:00,20
431,389,820,27,26.9,2,Partly Cloudy,7.3,2023-07-22 21:00:00,21
285,346,631,24,28.9,2,Partly Cloudy,6.5,2023-07-22 22:00:00,22
248,240,488,25,30.6,1,Mostly Clear,12.3,2023-07-22 23:00:00,23
207,195,402,23,32.1,1,Mostly Clear,15.9,2023-07-23 00:00:00,0
169,145,314,20,34.4,0,Clear,15.4,2023-07-23 01:00:00,1
97,68,165,17,36.0,0,Clear,16.6,2023-07-23 02:00:00,2
37,36,73,15,36.9,0,Clear,15.1,2023-07-23 03:00:00,3
15,21,36,14,37.7,0,Clear,17.1,2023-07-23 04:00:00,4
23,25,48,15,37.5,0,Clear,24.1,2023-07-23 05:00:00,5
54,76,130,15,36.8,0,Clear,22.7,2023-07-23 06:00:00,6
65,139,204,15,36.9,1,Mostly Clear,20.1,2023-07-23 07:00:00,7
180,279,459,16,35.9,2,Partly Cloudy,17.9,2023-07-23 08:00:00,8
379,391,770,16,35.6,2,Partly Cloudy,12.7,2023-07-23 09:00:00,9
527,506,1033,24,32.8,3,Cloudy,25.8,2023-07-23 10:00:00,10
624,532,1156,32,29.4,1,Mostly Clear,39.3,2023-07-23 11:00:00,11
616,568,1184,34,29.1,51,Light Drizzle,21.5,2023-07-23 12:00:00,12
630,613,1243,31,29.6,2,Partly Cloudy,20.2,2023-07-23 13:00:00,13
654,499,1153,37,27.9,2,Partly Cloudy,27.5,2023-07-23 14:00:00,14
569,594,1163,41,26.7,2,Partly Cloudy,15.8,2023-07-23 15:00:00,15
529,611,1140,44,25.9,51,Light Drizzle,12.4,2023-07-23 16:00:00,16
572,544,1116,43,25.9,51,Light Drizzle,10.2,2023-07-23 17:00:00,17
512,613,1125,44,25.1,51,Light Drizzle,6.2,2023-07-23 18:00:00,18
473,490,963,47,24.7,2,Partly Cloudy,17.5,2023-07-23 19:00:00,19
359,415,774,50,24.6,1,Mostly Clear,14.7,2023-07-23 20:00:00,20
263,287,550,41,26.1,0,Clear,15.7,2023-07-23 21:00:00,21
178,204,382,35,28.3,0,Clear,20.2,2023-07-23 22:00:00,22
105,110,215,32,29.6,0,Clear,20.3,2023-07-23 23:00:00,23
39,52,91,28,30.8,0,Clear,15.3,2023-07-24 00:00:00,0
22,32,54,25,32.2,0,Clear,13.3,2023-07-24 01:00:00,1
36,22,58,23,33.5,0,Clear,11.5,2023-07-24 02:00:00,2
11,2,13,21,34.4,0,Clear,12.2,2023-07-24 03:00:00,3
7,12,19,20,35.0,0,Clear,14.0,2023-07-24 04:00:00,4
13,52,65,19,35.3,0,Clear,13.2,2023-07-24 05:00:00,5
50,195,245,19,35.0,0,Clear,11.3,2023-07-24 06:00:00,6
147,453,600,19,34.5,1,Mostly Clear,14.3,2023-07-24 07:00:00,7
246,721,967,20,34.1,0,Clear,12.5,2023-07-24 08:00:00,8
221,495,716,21,33.3,0,Clear,8.7,2023-07-24 09:00:00,9
218,318,536,21,33.0,1,Mostly Clear,12.0,2023-07-24 10:00:00,10
239,318,557,22,32.4,2,Partly Cloudy,6.3,2023-07-24 11:00:00,11
302,397,699,24,30.9,1,Mostly Clear,16.8,2023-07-24 12:00:00,12
309,373,682,28,29.6,1,Mostly Clear,14.1,2023-07-24 13:00:00,13
314,352,666,30,28.5,2,Partly Cloudy,4.9,2023-07-24 14:00:00,14
281,463,744,32,27.7,2,Partly Cloudy,2.2,2023-07-24 15:00:00,15
389,642,1031,35,26.9,51,Light Drizzle,6.6,2023-07-24 16:00:00,16
563,1107,1670,36,26.5,0,Clear,6.2,2023-07-24 17:00:00,17
552,994,1546,37,25.6,0,Clear,7.9,2023-07-24 18:00:00,18
439,738,1177,50,23.4,1,Mostly Clear,9.6,2023-07-24 19:00:00,19
376,569,945,50,23.8,1,Mostly Clear,5.9,2023-07-24 20:00:00,20
267,385,652,46,25.2,0,Clear,5.2,2023-07-24 21:00:00,21
148,272,420,42,26.6,0,Clear,8.7,2023-07-24 22:00:00,22
80,118,198,38,27.9,0,Clear,5.1,2023-07-24 23:00:00,23
33,43,76,34,29.2,0,Clear,2.3,2023-07-25 00:00:00,0
15,30,45,31,30.7,0,Clear,4.0,2023-07-25 01:00:00,1
7,17,24,28,32.0,0,Clear,5.4,2023-07-25 02:00:00,2
6,10,16,26,33.1,0,Clear,5.9,2023-07-25 03:00:00,3
6,9,15,24,33.8,0,Clear,7.9,2023-07-25 04:00:00,4
29,69,98,23,34.4,0,Clear,9.8,2023-07-25 05:00:00,5
75,261,336,22,34.4,0,Clear,9.8,2023-07-25 06:00:00,6
190,567,757,25,33.0,0,Clear,18.1,2023-07-25 07:00:00,7
349,988,1337,27,32.1,0,Clear,18.4,2023-07-25 08:00:00,8
240,578,818,28,31.4,0,Clear,17.4,2023-07-25 09:00:00,9
244,338,582,29,30.8,0,Clear,18.0,2023-07-25 10:00:00,10
249,320,569,31,30.0,0,Clear,15.5,2023-07-25 11:00:00,11
246,411,657,32,29.4,0,Clear,8.6,2023-07-25 12:00:00,12
254,407,661,34,28.6,0,Clear,7.2,2023-07-25 13:00:00,13
288,375,663,35,27.8,0,Clear,7.3,2023-07-25 14:00:00,14
325,469,794,37,26.7,0,Clear,6.6,2023-07-25 15:00:00,15
340,668,1008,38,26.0,0,Clear,10.1,2023-07-25 16:00:00,16
598,1091,1689,41,24.7,0,Clear,5.8,2023-07-25 17:00:00,17
624,1063,1687,40,25.0,0,Clear,2.6,2023-07-25 18:00:00,18
414,742,1156,48,22.7,0,Clear,5.0,2023-07-25 19:00:00,19
255,420,675,46,23.1,0,Clear,3.2,2023-07-25 20:00:00,20
160,279,439,41,24.9,0,Clear,2.5,2023-07-25 21:00:00,21
91,220,311,37,26.7,0,Clear,1.5,2023-07-25 22:00:00,22
55,124,179,33,28.6,0,Clear,1.3,2023-07-25 23:00:00,23
42,56,98,29,30.4,0,Clear,4.4,2023-07-26 00:00:00,0
14,23,37,26,32.1,0,Clear,7.2,2023-07-26 01:00:00,1
11,11,22,24,33.3,0,Clear,8.7,2023-07-26 02:00:00,2
13,4,17,23,34.3,0,Clear,9.4,2023-07-26 03:00:00,3
9,20,29,21,35.1,0,Clear,8.7,2023-07-26 04:00:00,4
27,69,96,21,35.3,0,Clear,8.4,2023-07-26 05:00:00,5
90,244,334,20,35.4,0,Clear,8.3,2023-07-26 06:00:00,6
190,558,748,22,34.5,0,Clear,14.2,2023-07-26 07:00:00,7
333,948,1281,22,34.4,0,Clear,13.4,2023-07-26 08:00:00,8
268,556,824,23,33.5,0,Clear,15.5,2023-07-26 09:00:00,9
221,306,527,24,32.8,0,Clear,17.3,2023-07-26 10:00:00,10
234,365,599,24,32.3,0,Clear,12.6,2023-07-26 11:00:00,11
277,446,723,25,31.5,0,Clear,6.0,2023-07-26 12:00:00,12
265,374,639,25,31.2,0,Clear,2.2,2023-07-26 13:00:00,13
252,374,626,29,29.7,1,Mostly Clear,8.6,2023-07-26 14:00:00,14
320,464,784,34,28.7,0,Clear,15.1,2023-07-26 15:00:00,15
374,678,1052,35,27.9,0,Clear,14.7,2023-07-26 16:00:00,16
612,1174,1786,37,26.8,0,Clear,14.5,2023-07-26 17:00:00,17
610,1031,1641,39,26.2,0,Clear,11.2,2023-07-26 18:00:00,18
480,813,1293,46,24.5,0,Clear,9.0,2023-07-26 19:00:00,19
404,649,1053,44,24.9,0,Clear,11.7,2023-07-26 20:00:00,20
275,419,694,38,26.7,0,Clear,11.2,2023-07-26 21:00:00,21
213,334,547,32,29.0,0,Clear,15.2,2023-07-26 22:00:00,22
203,276,479,29,30.7,1,Mostly Clear,21.0,2023-07-26 23:00:00,23
60,73,133,28,31.9,0,Clear,17.5,2023-07-27 00:00:00,0
28,39,67,24,33.5,0,Clear,8.8,2023-07-27 01:00:00,1
12,13,25,22,34.6,0,Clear,6.4,2023-07-27 02:00:00,2
5,13,18,21,35.3,0,Clear,2.9,2023-07-27 03:00:00,3
13,17,30,20,36.0,0,Clear,4.6,2023-07-27 04:00:00,4
36,71,107,19,36.2,0,Clear,8.0,2023-07-27 05:00:00,5
82,248,330,19,36.2,0,Clear,12.3,2023-07-27 06:00:00,6
203,482,685,19,35.8,0,Clear,14.6,2023-07-27 07:00:00,7
297,887,1184,18,35.3,0,Clear,12.2,2023-07-27 08:00:00,8
250,561,811,19,34.8,0,Clear,13.4,2023-07-27 09:00:00,9
237,296,533,20,33.7,0,Clear,16.3,2023-07-27 10:00:00,10
261,304,565,21,32.8,0,Clear,12.5,2023-07-27 11:00:00,11
288,396,684,22,32.1,1,Mostly Clear,6.8,2023-07-27 12:00:00,12
291,369,660,24,31.2,1,Mostly Clear,6.5,2023-07-27 13:00:00,13
251,355,606,24,30.6,1,Mostly Clear,11.8,2023-07-27 14:00:00,14
319,444,763,25,30.1,2,Partly Cloudy,13.8,2023-07-27 15:00:00,15
337,634,971,27,29.4,2,Partly Cloudy,19.0,2023-07-27 16:00:00,16
562,1084,1646,30,28.5,3,Cloudy,20.2,2023-07-27 17:00:00,17
506,931,1437,25,28.3,3,Cloudy,20.6,2023-07-27 18:00:00,18
327,616,943,27,27.3,3,Cloudy,18.4,2023-07-27 19:00:00,19
331,519,850,27,27.7,1,Mostly Clear,16.7,2023-07-27 20:00:00,20
236,449,685,25,28.8,1,Mostly Clear,12.3,2023-07-27 21:00:00,21
186,295,481,24,29.8,1,Mostly Clear,14.5,2023-07-27 22:00:00,22
121,174,295,22,30.4,3,Cloudy,13.8,2023-07-27 23:00:00,23
65,71,136,23,31.0,3,Cloudy,10.5,2023-07-28 00:00:00,0
41,43,84,23,32.1,2,Partly Cloudy,6.7,2023-07-28 01:00:00,1
20,20,40,20,33.7,1,Mostly Clear,7.8,2023-07-28 02:00:00,2
17,9,26,18,34.7,1,Mostly Clear,9.9,2023-07-28 03:00:00,3
11,16,27,17,35.3,2,Partly Cloudy,4.7,2023-07-28 04:00:00,4
28,60,88,15,35.5,2,Partly Cloudy,3.2,2023-07-28 05:00:00,5
76,237,313,14,35.7,1,Mostly Clear,1.6,2023-07-28 06:00:00,6
156,443,599,18,34.1,1,Mostly Clear,18.1,2023-07-28 07:00:00,7
265,614,879,22,32.4,1,Mostly Clear,35.4,2023-07-28 08:00:00,8
280,468,748,23,31.6,1,Mostly Clear,27.8,2023-07-28 09:00:00,9
235,352,587,23,31.1,0,Clear,19.9,2023-07-28 10:00:00,10
269,395,664,24,30.2,1,Mostly Clear,16.2,2023-07-28 11:00:00,11
323,426,749,25,29.6,1,Mostly Clear,13.1,2023-07-28 12:00:00,12
291,411,702,26,28.7,2,Partly Cloudy,14.1,2023-07-28 13:00:00,13
326,385,711,28,27.7,2,Partly Cloudy,12.6,2023-07-28 14:00:00,14
296,504,800,29,27.3,2,Partly Cloudy,7.9,2023-07-28 15:00:00,15
371,608,979,30,26.7,2,Partly Cloudy,5.4,2023-07-28 16:00:00,16
492,843,1335,33,26.1,2,Partly Cloudy,7.4,2023-07-28 17:00:00,17
475,696,1171,39,25.3,2,Partly Cloudy,8.9,2023-07-28 18:00:00,18
359,568,927,35,25.1,3,Cloudy,13.1,2023-07-28 19:00:00,19
109,172,281,57,22.6,2,Partly Cloudy,24.0,2023-07-28 20:00:00,20
178,256,434,61,22.8,2,Partly Cloudy,22.2,2023-07-28 21:00:00,21
142,284,426,58,23.6,3,Cloudy,21.9,2023-07-28 22:00:00,22
176,225,401,53,24.8,51,Light Drizzle,18.9,2023-07-28 23:00:00,23
150,171,321,50,25.5,3,Cloudy,12.9,2023-07-29 00:00:00,0
100,105,205,49,25.8,3,Cloudy,13.0,2023-07-29 01:00:00,1
76,81,157,43,26.5,3,Cloudy,7.6,2023-07-29 02:00:00,2
30,40,70,41,26.6,3,Cloudy,8.0,2023-07-29 03:00:00,3
12,14,26,34,27.4,3,Cloudy,8.8,2023-07-29 04:00:00,4
26,28,54,30,28.6,3,Cloudy,9.2,2023-07-29 05:00:00,5
67,88,155,28,29.3,0,Clear,7.0,2023-07-29 06:00:00,6
128,192,320,34,27.4,2,Partly Cloudy,3.6,2023-07-29 07:00:00,7
227,317,544,35,27.4,3,Cloudy,12.6,2023-07-29 08:00:00,8
397,449,846,42,26.4,3,Cloudy,17.4,2023-07-29 09:00:00,9
446,524,970,46,25.2,2,Partly Cloudy,16.9,2023-07-29 10:00:00,10
498,577,1075,46,24.8,1,Mostly Clear,13.2,2023-07-29 11:00:00,11
497,526,1023,48,24.2,0,Clear,11.3,2023-07-29 12:00:00,12
534,503,1037,49,23.6,0,Clear,12.4,2023-07-29 13:00:00,13
477,482,959,52,22.6,0,Clear,9.7,2023-07-29 14:00:00,14
458,453,911,56,21.4,0,Clear,7.2,2023-07-29 15:00:00,15
302,329,631,59,20.7,0,Clear,11.0,2023-07-29 16:00:00,16
190,244,434,60,20.0,0,Clear,10.3,2023-07-29 17:00:00,17
388,401,789,61,19.4,0,Clear,9.0,2023-07-29 18:00:00,18
431,434,865,63,18.8,0,Clear,8.7,2023-07-29 19:00:00,19
410,436,846,60,19.5,0,Clear,3.5,2023-07-29 20:00:00,20
316,328,644,54,21.2,0,Clear,7.1,2023-07-29 21:00:00,21
255,280,535,47,23.4,0,Clear,8.3,2023-07-29 22:00:00,22
252,299,551,39,25.7,0,Clear,5.6,2023-07-29 23:00:00,23
200,210,410,34,27.7,0,Clear,1.4,2023-07-30 00:00:00,0
156,142,298,29,29.5,0,Clear,2.3,2023-07-30 01:00:00,1
121,89,210,26,31.0,0,Clear,4.7,2023-07-30 02:00:00,2
70,46,116,23,32.2,0,Clear,6.6,2023-07-30 03:00:00,3
19,20,39,21,33.2,0,Clear,7.2,2023-07-30 04:00:00,4
33,34,67,19,33.8,0,Clear,7.2,2023-07-30 05:00:00,5
51,85,136,17,34.2,1,Mostly Clear,4.3,2023-07-30 06:00:00,6
76,148,224,17,34.0,0,Clear,7.4,2023-07-30 07:00:00,7
153,241,394,18,33.7,0,Clear,10.8,2023-07-30 08:00:00,8
334,443,777,20,32.4,0,Clear,20.6,2023-07-30 09:00:00,9
471,515,986,21,31.2,1,Mostly Clear,18.8,2023-07-30 10:00:00,10
527,564,1091,21,30.8,2,Partly Cloudy,8.1,2023-07-30 11:00:00,11
553,616,1169,33,28.4,0,Clear,27.1,2023-07-30 12:00:00,12
594,606,1200,36,27.5,0,Clear,20.5,2023-07-30 13:00:00,13
596,586,1182,38,26.5,0,Clear,15.1,2023-07-30 14:00:00,14
587,589,1176,40,25.6,0,Clear,8.7,2023-07-30 15:00:00,15
526,602,1128,43,24.8,2,Partly Cloudy,9.0,2023-07-30 16:00:00,16
576,551,1127,47,23.8,1,Mostly Clear,3.6,2023-07-30 17:00:00,17
457,560,1017,47,23.6,0,Clear,4.1,2023-07-30 18:00:00,18
392,469,861,51,23.1,1,Mostly Clear,10.5,2023-07-30 19:00:00,19
367,403,770,49,23.4,0,Clear,3.2,2023-07-30 20:00:00,20
251,274,525,48,24.3,0,Clear,10.2,2023-07-30 21:00:00,21
157,210,367,43,25.8,0,Clear,8.5,2023-07-30 22:00:00,22
91,121,212,37,27.5,0,Clear,5.2,2023-07-30 23:00:00,23
46,42,88,33,29.1,0,Clear,3.9,2023-07-31 00:00:00,0
14,24,38,28,30.9,0,Clear,5.7,2023-07-31 01:00:00,1
3,8,11,24,32.1,1,Mostly Clear,4.7,2023-07-31 02:00:00,2
7,1,8,23,32.6,0,Clear,4.2,2023-07-31 03:00:00,3
5,16,21,21,33.3,0,Clear,2.5,2023-07-31 04:00:00,4
18,52,70,20,33.8,1,Mostly Clear,2.8,2023-07-31 05:00:00,5
53,193,246,18,33.8,1,Mostly Clear,5.1,2023-07-31 06:00:00,6
131,455,586,21,33.1,1,Mostly Clear,16.2,2023-07-31 07:00:00,7
242,699,941,24,31.9,0,Clear,17.5,2023-07-31 08:00:00,8
235,438,673,26,30.8,1,Mostly Clear,18.1,2023-07-31 09:00:00,9
242,318,560,26,30.6,1,Mostly Clear,11.6,2023-07-31 10:00:00,10
285,371,656,27,30.0,1,Mostly Clear,10.8,2023-07-31 11:00:00,11
279,404,683,28,29.2,0,Clear,10.6,2023-07-31 12:00:00,12
262,418,680,31,27.9,0,Clear,7.2,2023-07-31 13:00:00,13
330,373,703,34,26.7,0,Clear,6.0,2023-07-31 14:00:00,14
314,487,801,37,26.0,0,Clear,4.3,2023-07-31 15:00:00,15
381,655,1036,40,25.3,0,Clear,12.5,2023-07-31 16:00:00,16
529,1058,1587,45,24.4,0,Clear,9.7,2023-07-31 17:00:00,17
597,1049,1646,49,23.1,0,Clear,6.4,2023-07-31 18:00:00,18
468,803,1271,53,22.6,0,Clear,10.0,2023-07-31 19:00:00,19
349,513,862,50,23.0,0,Clear,6.9,2023-07-31 20:00:00,20
264,420,684,44,24.5,0,Clear,5.8,2023-07-31 21:00:00,21
176,255,431,37,26.4,0,Clear,4.3,2023-07-31 22:00:00,22
60,120,180,33,28.3,0,Clear,3.0,2023-07-31 23:00:00,23
42,57,99,28,30.4,0,Clear,4.9,2023-08-01 00:00:00,0
22,29,51,22,32.6,0,Clear,10.9,2023-08-01 01:00:00,1
15,23,38,20,33.9,0,Clear,12.0,2023-08-01 02:00:00,2
6,7,13,17,34.9,0,Clear,10.7,2023-08-01 03:00:00,3
6,25,31,15,35.5,0,Clear,10.3,2023-08-01 04:00:00,4
31,83,114,14,35.6,0,Clear,7.5,2023-08-01 05:00:00,5
66,257,323,15,35.5,0,Clear,4.1,2023-08-01 06:00:00,6
196,601,797,15,35.0,0,Clear,0.7,2023-08-01 07:00:00,7
292,985,1277,15,35.2,0,Clear,4.6,2023-08-01 08:00:00,8
235,560,795,16,34.6,0,Clear,4.0,2023-08-01 09:00:00,9
222,370,592,18,33.4,0,Clear,10.7,2023-08-01 10:00:00,10
245,356,601,20,32.0,0,Clear,10.9,2023-08-01 11:00:00,11
261,402,663,21,30.9,0,Clear,11.5,2023-08-01 12:00:00,12
258,416,674,23,29.8,0,Clear,13.4,2023-08-01 13:00:00,13
319,367,686,25,28.8,0,Clear,12.8,2023-08-01 14:00:00,14
302,496,798,28,27.3,0,Clear,9.0,2023-08-01 15:00:00,15
422,775,1197,30,26.2,0,Clear,8.6,2023-08-01 16:00:00,16
644,1284,1928,31,25.8,0,Clear,12.0,2023-08-01 17:00:00,17
672,1132,1804,31,25.4,0,Clear,13.0,2023-08-01 18:00:00,18
486,851,1337,35,24.4,0,Clear,12.5,2023-08-01 19:00:00,19
387,579,966,34,24.7,0,Clear,9.2,2023-08-01 20:00:00,20
299,455,754,31,26.1,0,Clear,2.5,2023-08-01 21:00:00,21
193,307,500,28,27.6,0,Clear,0.5,2023-08-01 22:00:00,22
110,155,265,24,30.0,0,Clear,8.4,2023-08-01 23:00:00,23
50,55,105,22,32.2,0,Clear,11.9,2023-08-02 00:00:00,0
17,17,34,20,34.3,0,Clear,14.6,2023-08-02 01:00:00,1
9,8,17,17,35.4,0,Clear,16.5,2023-08-02 02:00:00,2
10,14,24,15,36.3,0,Clear,16.2,2023-08-02 03:00:00,3
6,21,27,15,36.7,0,Clear,18.7,2023-08-02 04:00:00,4
24,65,89,15,36.9,0,Clear,17.6,2023-08-02 05:00:00,5
81,240,321,15,36.4,1,Mostly Clear,10.0,2023-08-02 06:00:00,6
170,554,724,16,35.9,1,Mostly Clear,14.0,2023-08-02 07:00:00,7
355,1025,1380,22,33.3,1,Mostly Clear,32.8,2023-08-02 08:00:00,8
283,568,851,20,32.9,2,Partly Cloudy,22.7,2023-08-02 09:00:00,9
233,345,578,26,30.8,3,Cloudy,25.1,2023-08-02 10:00:00,10
257,367,624,27,30.1,2,Partly Cloudy,18.9,2023-08-02 11:00:00,11
304,520,824,28,29.7,3,Cloudy,11.6,2023-08-02 12:00:00,12
255,431,686,35,27.8,3,Cloudy,19.8,2023-08-02 13:00:00,13
294,419,713,39,25.9,3,Cloudy,22.5,2023-08-02 14:00:00,14
333,527,860,42,25.4,3,Cloudy,15.5,2023-08-02 15:00:00,15
440,798,1238,39,25.8,2,Partly Cloudy,11.3,2023-08-02 16:00:00,16
655,1218,1873,44,25.0,2,Partly Cloudy,19.1,2023-08-02 17:00:00,17
643,1118,1761,42,24.8,1,Mostly Clear,17.7,2023-08-02 18:00:00,18
499,788,1287,39,23.7,0,Clear,12.2,2023-08-02 19:00:00,19
375,560,935,36,23.3,0,Clear,7.9,2023-08-02 20:00:00,20
256,466,722,32,24.9,0,Clear,9.3,2023-08-02 21:00:00,21
175,290,465,28,26.8,0,Clear,11.2,2023-08-02 22:00:00,22
99,166,265,25,28.5,0,Clear,12.5,2023-08-02 23:00:00,23
50,73,123,26,29.6,0,Clear,10.4,2023-08-03 00:00:00,0
19,22,41,25,30.9,0,Clear,10.5,2023-08-03 01:00:00,1
13,13,26,22,32.2,0,Clear,10.5,2023-08-03 02:00:00,2
8,7,15,18,33.4,0,Clear,11.6,2023-08-03 03:00:00,3
12,25,37,15,34.2,0,Clear,12.7,2023-08-03 04:00:00,4
20,69,89,14,34.6,0,Clear,13.3,2023-08-03 05:00:00,5
65,206,271,13,34.8,0,Clear,12.0,2023-08-03 06:00:00,6
162,503,665,13,34.0,0,Clear,1.8,2023-08-03 07:00:00,7
298,907,1205,14,33.7,0,Clear,3.5,2023-08-03 08:00:00,8
239,571,810,14,32.8,0,Clear,5.5,2023-08-03 09:00:00,9
249,348,597,16,31.6,0,Clear,5.8,2023-08-03 10:00:00,10
237,364,601,18,30.1,0,Clear,5.2,2023-08-03 11:00:00,11
270,425,695,18,29.0,0,Clear,10.2,2023-08-03 12:00:00,12
305,474,779,20,28.2,0,Clear,12.8,2023-08-03 13:00:00,13
344,457,801,28,27.4,0,Clear,15.8,2023-08-03 14:00:00,14
369,557,926,34,26.1,0,Clear,12.8,2023-08-03 15:00:00,15
370,662,1032,37,25.3,0,Clear,12.3,2023-08-03 16:00:00,16
465,803,1268,39,24.6,0,Clear,11.8,2023-08-03 17:00:00,17
396,741,1137,43,23.4,0,Clear,9.7,2023-08-03 18:00:00,18
237,493,730,50,22.5,0,Clear,4.8,2023-08-03 19:00:00,19
162,350,512,51,22.8,0,Clear,3.0,2023-08-03 20:00:00,20
145,308,453,47,24.1,0,Clear,1.9,2023-08-03 21:00:00,21
96,206,302,40,26.4,0,Clear,4.5,2023-08-03 22:00:00,22
63,128,191,35,28.8,0,Clear,8.7,2023-08-03 23:00:00,23
26,44,70,33,30.8,0,Clear,10.7,2023-08-04 00:00:00,0
27,31,58,28,32.5,0,Clear,10.1,2023-08-04 01:00:00,1
20,14,34,22,34.1,0,Clear,9.3,2023-08-04 02:00:00,2
7,11,18,18,34.9,0,Clear,8.3,2023-08-04 03:00:00,3
11,11,22,16,35.6,0,Clear,6.9,2023-08-04 04:00:00,4
20,56,76,16,35.9,0,Clear,7.1,2023-08-04 05:00:00,5
62,174,236,15,36.1,0,Clear,9.2,2023-08-04 06:00:00,6
125,384,509,15,35.9,0,Clear,12.3,2023-08-04 07:00:00,7
248,563,811,15,35.6,0,Clear,10.6,2023-08-04 08:00:00,8
230,459,689,16,34.2,0,Clear,11.4,2023-08-04 09:00:00,9
257,388,645,18,32.7,0,Clear,14.0,2023-08-04 10:00:00,10
394,419,813,17,31.6,0,Clear,8.0,2023-08-04 11:00:00,11
358,518,876,19,30.1,0,Clear,6.1,2023-08-04 12:00:00,12
392,484,876,20,29.7,0,Clear,3.7,2023-08-04 13:00:00,13
401,505,906,20,29.5,0,Clear,0.5,2023-08-04 14:00:00,14
412,638,1050,23,27.6,0,Clear,10.1,2023-08-04 15:00:00,15
497,745,1242,25,26.7,1,Mostly Clear,6.1,2023-08-04 16:00:00,16
624,888,1512,29,25.1,2,Partly Cloudy,6.6,2023-08-04 17:00:00,17
553,768,1321,28,25.4,2,Partly Cloudy,6.8,2023-08-04 18:00:00,18
509,678,1187,30,25.3,2,Partly Cloudy,3.3,2023-08-04 19:00:00,19
428,524,952,31,25.5,2,Partly Cloudy,10.5,2023-08-04 20:00:00,20
285,357,642,32,26.3,2,Partly Cloudy,8.0,2023-08-04 21:00:00,21
278,300,578,29,28.1,2,Partly Cloudy,8.2,2023-08-04 22:00:00,22
199,281,480,25,30.2,2,Partly Cloudy,11.7,2023-08-04 23:00:00,23
163,172,335,21,32.2,2,Partly Cloudy,10.8,2023-08-05 00:00:00,0
129,105,234,19,33.7,0,Clear,5.4,2023-08-05 01:00:00,1
67,84,151,16,35.0,0,Clear,1.6,2023-08-05 02:00:00,2
50,35,85,14,35.8,0,Clear,3.6,2023-08-05 03:00:00,3
14,18,32,13,36.5,0,Clear,6.3,2023-08-05 04:00:00,4
28,35,63,13,36.7,0,Clear,10.4,2023-08-05 05:00:00,5
48,91,139,13,36.7,0,Clear,10.0,2023-08-05 06:00:00,6
98,193,291,16,35.8,0,Clear,7.2,2023-08-05 07:00:00,7
221,329,550,16,35.8,0,Clear,12.7,2023-08-05 08:00:00,8
317,446,763,17,35.0,1,Mostly Clear,15.9,2023-08-05 09:00:00,9
514,501,1015,17,34.9,2,Partly Cloudy,8.6,2023-08-05 10:00:00,10
639,638,1277,18,33.4,1,Mostly Clear,11.6,2023-08-05 11:00:00,11
658,642,1300,25,31.1,2,Partly Cloudy,22.3,2023-08-05 12:00:00,12
725,627,1352,27,30.7,2,Partly Cloudy,21.5,2023-08-05 13:00:00,13
685,572,1257,27,30.4,2,Partly Cloudy,21.1,2023-08-05 14:00:00,14
678,614,1292,27,30.1,2,Partly Cloudy,20.9,2023-08-05 15:00:00,15
680,633,1313,30,29.0,2,Partly Cloudy,21.8,2023-08-05 16:00:00,16
609,584,1193,36,27.8,2,Partly Cloudy,20.1,2023-08-05 17:00:00,17
561,596,1157,41,26.9,2,Partly Cloudy,19.5,2023-08-05 18:00:00,18
481,489,970,35,27.2,1,Mostly Clear,16.2,2023-08-05 19:00:00,19
385,403,788,37,26.6,0,Clear,17.7,2023-08-05 20:00:00,20
330,335,665,39,26.8,0,Clear,19.5,2023-08-05 21:00:00,21
234,295,529,35,28.6,0,Clear,23.5,2023-08-05 22:00:00,22
227,267,494,26,30.9,0,Clear,22.4,2023-08-05 23:00:00,23
139,179,318,22,32.3,0,Clear,20.5,2023-08-06 00:00:00,0
93,121,214,20,33.5,0,Clear,18.1,2023-08-06 01:00:00,1
76,75,151,20,34.1,0,Clear,17.6,2023-08-06 02:00:00,2
42,48,90,20,34.6,0,Clear,19.1,2023-08-06 03:00:00,3
34,40,74,19,34.8,0,Clear,18.0,2023-08-06 04:00:00,4
26,32,58,18,35.0,0,Clear,13.8,2023-08-06 05:00:00,5
27,72,99,18,35.1,0,Clear,12.7,2023-08-06 06:00:00,6
80,121,201,21,33.4,0,Clear,19.1,2023-08-06 07:00:00,7
126,259,385,24,32.2,0,Clear,22.7,2023-08-06 08:00:00,8
316,380,696,29,30.0,0,Clear,26.0,2023-08-06 09:00:00,9
399,486,885,33,28.6,0,Clear,22.3,2023-08-06 10:00:00,10
513,518,1031,36,27.8,0,Clear,18.5,2023-08-06 11:00:00,11
614,547,1161,37,27.1,0,Clear,16.0,2023-08-06 12:00:00,12
553,613,1166,39,26.5,1,Mostly Clear,11.9,2023-08-06 13:00:00,13
574,556,1130,40,25.9,1,Mostly Clear,7.5,2023-08-06 14:00:00,14
624,594,1218,41,25.3,0,Clear,8.7,2023-08-06 15:00:00,15
535,554,1089,44,24.2,1,Mostly Clear,6.3,2023-08-06 16:00:00,16
531,575,1106,47,23.7,1,Mostly Clear,3.1,2023-08-06 17:00:00,17
351,476,827,49,22.9,1,Mostly Clear,5.6,2023-08-06 18:00:00,18
114,212,326,69,20.7,1,Mostly Clear,17.6,2023-08-06 19:00:00,19
103,167,270,66,20.5,1,Mostly Clear,12.9,2023-08-06 20:00:00,20
80,114,194,62,21.3,2,Partly Cloudy,10.9,2023-08-06 21:00:00,21
47,83,130,56,22.6,2,Partly Cloudy,12.5,2023-08-06 22:00:00,22
43,59,102,48,24.4,3,Cloudy,8.7,2023-08-06 23:00:00,23
28,40,68,43,25.7,3,Cloudy,6.2,2023-08-07 00:00:00,0
41,47,88,41,26.5,1,Mostly Clear,3.4,2023-08-07 01:00:00,1
14,29,43,38,27.6,0,Clear,3.3,2023-08-07 02:00:00,2
8,7,15,34,29.2,1,Mostly Clear,7.9,2023-08-07 03:00:00,3
8,17,25,31,30.0,0,Clear,12.5,2023-08-07 04:00:00,4
20,66,86,29,30.7,0,Clear,10.0,2023-08-07 05:00:00,5
79,190,269,27,30.9,0,Clear,5.6,2023-08-07 06:00:00,6
126,396,522,34,27.8,1,Mostly Clear,10.6,2023-08-07 07:00:00,7
235,735,970,38,26.8,2,Partly Cloudy,18.3,2023-08-07 08:00:00,8
244,448,692,42,25.7,1,Mostly Clear,9.4,2023-08-07 09:00:00,9
191,265,456,43,25.4,2,Partly Cloudy,5.8,2023-08-07 10:00:00,10
227,326,553,43,25.2,3,Cloudy,5.5,2023-08-07 11:00:00,11
252,411,663,43,25.2,3,Cloudy,4.4,2023-08-07 12:00:00,12
289,448,737,44,24.9,1,Mostly Clear,3.3,2023-08-07 13:00:00,13
382,598,980,47,24.5,1,Mostly Clear,5.2,2023-08-07 14:00:00,14
471,879,1350,50,24.0,1,Mostly Clear,5.0,2023-08-07 15:00:00,15
376,664,1040,51,23.5,1,Mostly Clear,6.5,2023-08-07 16:00:00,16
169,357,526,54,22.8,0,Clear,7.9,2023-08-07 17:00:00,17
21,70,91,56,22.0,0,Clear,10.6,2023-08-07 18:00:00,18
115,227,342,66,20.3,0,Clear,8.4,2023-08-07 19:00:00,19
94,156,250,64,20.5,0,Clear,7.3,2023-08-07 20:00:00,20
75,154,229,54,22.6,0,Clear,8.6,2023-08-07 21:00:00,21
40,101,141,38,25.3,0,Clear,14.8,2023-08-07 22:00:00,22
40,79,119,25,27.5,0,Clear,18.0,2023-08-07 23:00:00,23
19,31,50,21,29.4,0,Clear,15.8,2023-08-08 00:00:00,0
13,16,29,17,31.2,0,Clear,12.1,2023-08-08 01:00:00,1
9,8,17,15,32.3,0,Clear,9.4,2023-08-08 02:00:00,2
4,12,16,14,33.1,0,Clear,6.7,2023-08-08 03:00:00,3
3,27,30,14,33.6,0,Clear,3.3,2023-08-08 04:00:00,4
27,69,96,13,33.9,0,Clear,2.3,2023-08-08 05:00:00,5
78,261,339,13,34.1,0,Clear,5.9,2023-08-08 06:00:00,6
203,568,771,12,33.7,0,Clear,6.7,2023-08-08 07:00:00,7
284,936,1220,13,33.5,0,Clear,9.2,2023-08-08 08:00:00,8
242,565,807,13,32.6,0,Clear,10.1,2023-08-08 09:00:00,9
236,363,599,15,31.2,0,Clear,6.5,2023-08-08 10:00:00,10
276,399,675,17,29.9,0,Clear,10.5,2023-08-08 11:00:00,11
313,432,745,20,28.7,0,Clear,12.6,2023-08-08 12:00:00,12
312,456,768,22,28.0,0,Clear,12.0,2023-08-08 13:00:00,13
339,357,696,27,26.5,0,Clear,8.8,2023-08-08 14:00:00,14
343,522,865,29,25.4,0,Clear,11.5,2023-08-08 15:00:00,15
483,766,1249,30,24.0,0,Clear,7.1,2023-08-08 16:00:00,16
632,1255,1887,31,23.7,0,Clear,10.5,2023-08-08 17:00:00,17
587,1125,1712,31,23.5,0,Clear,11.8,2023-08-08 18:00:00,18
506,776,1282,31,23.1,0,Clear,12.3,2023-08-08 19:00:00,19
445,600,1045,34,22.6,0,Clear,4.9,2023-08-08 20:00:00,20
268,421,689,29,24.6,0,Clear,4.8,2023-08-08 21:00:00,21
171,307,478,27,26.6,0,Clear,13.1,2023-08-08 22:00:00,22
88,155,243,22,29.2,0,Clear,10.2,2023-08-08 23:00:00,23
46,50,96,20,30.8,0,Clear,9.1,2023-08-09 00:00:00,0
19,25,44,18,32.3,0,Clear,8.6,2023-08-09 01:00:00,1
8,3,11,17,33.7,0,Clear,9.9,2023-08-09 02:00:00,2
5,7,12,15,34.9,0,Clear,9.2,2023-08-09 03:00:00,3
3,12,15,14,35.3,0,Clear,4.1,2023-08-09 04:00:00,4
31,81,112,13,35.8,0,Clear,3.6,2023-08-09 05:00:00,5
74,238,312,12,36.1,0,Clear,10.7,2023-08-09 06:00:00,6
189,559,748,14,34.9,0,Clear,7.5,2023-08-09 07:00:00,7
296,910,1206,14,34.8,0,Clear,10.1,2023-08-09 08:00:00,8
278,566,844,15,33.7,0,Clear,11.9,2023-08-09 09:00:00,9
227,358,585,17,32.5,0,Clear,7.9,2023-08-09 10:00:00,10
210,333,543,19,31.3,0,Clear,7.6,2023-08-09 11:00:00,11
284,447,731,20,30.6,0,Clear,4.5,2023-08-09 12:00:00,12
245,393,638,19,30.8,0,Clear,3.6,2023-08-09 13:00:00,13
314,364,678,23,28.7,0,Clear,4.8,2023-08-09 14:00:00,14
255,425,680,23,28.5,0,Clear,2.6,2023-08-09 15:00:00,15
320,576,896,28,26.7,0,Clear,1.6,2023-08-09 16:00:00,16
577,1146,1723,33,24.6,0,Clear,6.0,2023-08-09 17:00:00,17
689,1074,1763,36,23.8,0,Clear,6.7,2023-08-09 18:00:00,18
520,811,1331,43,23.1,0,Clear,12.6,2023-08-09 19:00:00,19
381,596,977,44,23.3,0,Clear,13.5,2023-08-09 20:00:00,20
220,404,624,37,24.8,0,Clear,11.3,2023-08-09 21:00:00,21
163,325,488,31,27.2,0,Clear,11.5,2023-08-09 22:00:00,22
106,177,283,25,30.1,0,Clear,11.2,2023-08-09 23:00:00,23
45,55,100,21,32.3,0,Clear,8.2,2023-08-10 00:00:00,0
18,33,51,18,34.0,0,Clear,8.0,2023-08-10 01:00:00,1
11,19,30,16,35.2,0,Clear,10.0,2023-08-10 02:00:00,2
5,7,12,15,36.4,0,Clear,11.7,2023-08-10 03:00:00,3
12,22,34,14,37.0,0,Clear,14.6,2023-08-10 04:00:00,4
21,75,96,14,37.3,0,Clear,16.3,2023-08-10 05:00:00,5
89,216,305,15,37.1,0,Clear,15.9,2023-08-10 06:00:00,6
162,454,616,15,36.5,0,Clear,11.8,2023-08-10 07:00:00,7
292,844,1136,15,36.1,0,Clear,12.7,2023-08-10 08:00:00,8
229,555,784,16,35.1,1,Mostly Clear,10.6,2023-08-10 09:00:00,9
200,298,498,17,34.4,1,Mostly Clear,6.0,2023-08-10 10:00:00,10
177,364,541,23,32.3,1,Mostly Clear,23.0,2023-08-10 11:00:00,11
232,421,653,26,30.4,1,Mostly Clear,18.3,2023-08-10 12:00:00,12
240,349,589,25,30.1,3,Cloudy,17.3,2023-08-10 13:00:00,13
271,400,671,27,29.2,2,Partly Cloudy,20.0,2023-08-10 14:00:00,14
328,502,830,29,28.7,2,Partly Cloudy,16.3,2023-08-10 15:00:00,15
391,676,1067,32,27.5,2,Partly Cloudy,10.7,2023-08-10 16:00:00,16
300,665,965,35,26.4,2,Partly Cloudy,13.4,2023-08-10 17:00:00,17
470,857,1327,36,26.1,1,Mostly Clear,18.6,2023-08-10 18:00:00,18
397,702,1099,39,26.0,3,Cloudy,14.1,2023-08-10 19:00:00,19
371,530,901,41,25.8,1,Mostly Clear,16.8,2023-08-10 20:00:00,20
245,404,649,48,24.9,0,Clear,25.7,2023-08-10 21:00:00,21
212,275,487,42,26.9,2,Partly Cloudy,20.2,2023-08-10 22:00:00,22
126,202,328,36,28.4,1,Mostly Clear,22.0,2023-08-10 23:00:00,23
56,103,159,33,29.1,1,Mostly Clear,22.7,2023-08-11 00:00:00,0
43,39,82,27,31.0,0,Clear,16.5,2023-08-11 01:00:00,1
16,31,47,24,32.1,0,Clear,15.9,2023-08-11 02:00:00,2
10,9,19,22,32.9,0,Clear,15.5,2023-08-11 03:00:00,3
8,23,31,22,33.3,0,Clear,13.5,2023-08-11 04:00:00,4
26,69,95,22,33.6,0,Clear,12.7,2023-08-11 05:00:00,5
67,189,256,21,33.5,0,Clear,13.0,2023-08-11 06:00:00,6
136,404,540,27,30.7,0,Clear,7.9,2023-08-11 07:00:00,7
231,634,865,27,30.3,0,Clear,10.0,2023-08-11 08:00:00,8
285,487,772,28,29.8,0,Clear,12.6,2023-08-11 09:00:00,9
306,361,667,30,29.3,0,Clear,16.3,2023-08-11 10:00:00,10
328,467,795,33,28.4,1,Mostly Clear,12.0,2023-08-11 11:00:00,11
457,503,960,34,27.7,2,Partly Cloudy,8.2,2023-08-11 12:00:00,12
421,503,924,36,27.0,1,Mostly Clear,8.6,2023-08-11 13:00:00,13
424,488,912,37,26.4,0,Clear,9.3,2023-08-11 14:00:00,14
448,608,1056,38,25.7,0,Clear,10.4,2023-08-11 15:00:00,15
520,718,1238,41,24.8,0,Clear,10.5,2023-08-11 16:00:00,16
632,933,1565,45,23.9,0,Clear,11.8,2023-08-11 17:00:00,17
586,775,1361,48,22.8,0,Clear,6.2,2023-08-11 18:00:00,18
509,645,1154,46,23.0,0,Clear,9.2,2023-08-11 19:00:00,19
385,454,839,45,23.2,0,Clear,6.8,2023-08-11 20:00:00,20
261,326,587,40,24.7,0,Clear,10.0,2023-08-11 21:00:00,21
255,311,566,29,27.3,0,Clear,16.3,2023-08-11 22:00:00,22
194,272,466,26,29.5,0,Clear,17.6,2023-08-11 23:00:00,23
129,169,298,27,31.0,0,Clear,14.0,2023-08-12 00:00:00,0
94,111,205,25,32.2,0,Clear,8.9,2023-08-12 01:00:00,1
71,65,136,22,33.1,0,Clear,6.1,2023-08-12 02:00:00,2
28,31,59,20,33.8,0,Clear,4.9,2023-08-12 03:00:00,3
10,20,30,17,34.4,0,Clear,3.5,2023-08-12 04:00:00,4
11,45,56,15,35.1,0,Clear,4.4,2023-08-12 05:00:00,5
50,94,144,13,35.5,0,Clear,5.9,2023-08-12 06:00:00,6
84,190,274,13,34.2,0,Clear,16.5,2023-08-12 07:00:00,7
219,251,470,13,33.7,0,Clear,17.3,2023-08-12 08:00:00,8
364,458,822,14,32.6,0,Clear,14.2,2023-08-12 09:00:00,9
462,532,994,16,31.6,1,Mostly Clear,5.6,2023-08-12 10:00:00,10
604,561,1165,17,30.9,1,Mostly Clear,11.6,2023-08-12 11:00:00,11
580,597,1177,18,30.8,2,Partly Cloudy,13.8,2023-08-12 12:00:00,12
603,589,1192,14,29.6,2,Partly Cloudy,23.2,2023-08-12 13:00:00,13
548,507,1055,14,28.5,1,Mostly Clear,22.8,2023-08-12 14:00:00,14
550,606,1156,16,27.6,0,Clear,24.5,2023-08-12 15:00:00,15
609,552,1161,18,26.5,0,Clear,24.2,2023-08-12 16:00:00,16
590,571,1161,19,25.6,0,Clear,22.9,2023-08-12 17:00:00,17
527,573,1100,21,24.9,0,Clear,23.6,2023-08-12 18:00:00,18
479,437,916,21,25.7,0,Clear,29.0,2023-08-12 19:00:00,19
340,423,763,21,25.6,0,Clear,28.7,2023-08-12 20:00:00,20
291,374,665,20,26.5,0,Clear,21.1,2023-08-12 21:00:00,21
300,312,612,17,28.2,0,Clear,20.9,2023-08-12 22:00:00,22
190,239,429,12,30.3,0,Clear,20.0,2023-08-12 23:00:00,23
151,182,333,10,32.0,0,Clear,21.9,2023-08-13 00:00:00,0
121,110,231,9,33.4,0,Clear,21.3,2023-08-13 01:00:00,1
52,84,136,9,34.5,0,Clear,18.5,2023-08-13 02:00:00,2
45,42,87,10,35.2,0,Clear,13.0,2023-08-13 03:00:00,3
13,21,34,10,35.8,0,Clear,12.6,2023-08-13 04:00:00,4
13,18,31,9,36.2,0,Clear,12.4,2023-08-13 05:00:00,5
52,81,133,6,36.2,0,Clear,9.7,2023-08-13 06:00:00,6
64,171,235,7,34.9,0,Clear,9.3,2023-08-13 07:00:00,7
162,240,402,8,34.3,0,Clear,4.8,2023-08-13 08:00:00,8
310,416,726,8,32.6,0,Clear,9.5,2023-08-13 09:00:00,9
443,505,948,8,31.6,1,Mostly Clear,8.8,2023-08-13 10:00:00,10
531,503,1034,8,30.7,2,Partly Cloudy,10.7,2023-08-13 11:00:00,11
528,514,1042,9,30.1,2,Partly Cloudy,11.9,2023-08-13 12:00:00,12
581,532,1113,10,28.7,2,Partly Cloudy,6.4,2023-08-13 13:00:00,13
511,476,987,12,29.1,2,Partly Cloudy,10.2,2023-08-13 14:00:00,14
604,561,1165,11,27.9,1,Mostly Clear,29.0,2023-08-13 15:00:00,15
535,551,1086,10,27.2,0,Clear,26.7,2023-08-13 16:00:00,16
430,534,964,11,25.9,0,Clear,25.0,2023-08-13 17:00:00,17
422,535,957,12,25.0,0,Clear,23.5,2023-08-13 18:00:00,18
370,499,869,15,23.1,0,Clear,13.8,2023-08-13 19:00:00,19
330,363,693,17,23.0,0,Clear,17.8,2023-08-13 20:00:00,20
202,299,501,16,24.7,0,Clear,18.4,2023-08-13 21:00:00,21
121,164,285,14,26.2,0,Clear,20.2,2023-08-13 22:00:00,22
83,112,195,16,28.6,0,Clear,23.1,2023-08-13 23:00:00,23
40,59,99,14,31.0,0,Clear,20.4,2023-08-14 00:00:00,0
21,19,40,10,32.8,0,Clear,21.6,2023-08-14 01:00:00,1
16,11,27,10,33.8,0,Clear,21.1,2023-08-14 02:00:00,2
10,15,25,10,34.2,0,Clear,20.2,2023-08-14 03:00:00,3
10,12,22,10,34.6,0,Clear,18.9,2023-08-14 04:00:00,4
35,72,107,10,34.4,0,Clear,19.3,2023-08-14 05:00:00,5
68,200,268,9,35.6,2,Partly Cloudy,7.0,2023-08-14 06:00:00,6
159,465,624,11,32.8,2,Partly Cloudy,14.1,2023-08-14 07:00:00,7
224,744,968,13,32.0,3,Cloudy,24.9,2023-08-14 08:00:00,8
221,418,639,13,31.4,3,Cloudy,23.0,2023-08-14 09:00:00,9
261,296,557,16,30.2,2,Partly Cloudy,26.6,2023-08-14 10:00:00,10
206,330,536,20,29.2,2,Partly Cloudy,24.3,2023-08-14 11:00:00,11
237,443,680,18,28.5,0,Clear,26.3,2023-08-14 12:00:00,12
273,402,675,13,26.9,0,Clear,27.0,2023-08-14 13:00:00,13
291,372,663,12,25.8,0,Clear,27.7,2023-08-14 14:00:00,14
324,512,836,12,25.0,0,Clear,24.8,2023-08-14 15:00:00,15
128,266,394,13,24.0,0,Clear,23.2,2023-08-14 16:00:00,16
212,501,713,10,24.0,0,Clear,27.4,2023-08-14 17:00:00,17
274,630,904,11,22.5,0,Clear,20.4,2023-08-14 18:00:00,18
302,562,864,16,22.4,0,Clear,18.7,2023-08-14 19:00:00,19
252,414,666,17,22.4,0,Clear,15.5,2023-08-14 20:00:00,20
191,282,473,16,24.3,0,Clear,15.1,2023-08-14 21:00:00,21
138,193,331,16,26.7,0,Clear,18.4,2023-08-14 22:00:00,22
85,110,195,11,28.2,0,Clear,18.8,2023-08-14 23:00:00,23
42,43,85,8,29.6,0,Clear,14.8,2023-08-15 00:00:00,0
19,19,38,6,30.7,0,Clear,13.0,2023-08-15 01:00:00,1
12,20,32,5,31.6,0,Clear,15.3,2023-08-15 02:00:00,2
10,15,25,5,32.1,0,Clear,14.3,2023-08-15 03:00:00,3
12,23,35,6,32.4,0,Clear,11.1,2023-08-15 04:00:00,4
25,88,113,6,32.6,0,Clear,7.8,2023-08-15 05:00:00,5
82,232,314,6,32.7,0,Clear,5.3,2023-08-15 06:00:00,6
199,545,744,7,32.5,0,Clear,11.7,2023-08-15 07:00:00,7
283,944,1227,7,32.2,0,Clear,10.2,2023-08-15 08:00:00,8
276,550,826,8,30.5,0,Clear,7.4,2023-08-15 09:00:00,9
225,318,543,10,28.9,0,Clear,6.7,2023-08-15 10:00:00,10
242,314,556,12,27.8,0,Clear,5.8,2023-08-15 11:00:00,11
259,379,638,12,26.7,0,Clear,9.1,2023-08-15 12:00:00,12
271,379,650,12,26.0,0,Clear,14.8,2023-08-15 13:00:00,13
183,257,440,13,25.7,0,Clear,20.5,2023-08-15 14:00:00,14
196,323,519,24,23.9,0,Clear,30.9,2023-08-15 15:00:00,15
308,545,853,40,22.4,0,Clear,29.2,2023-08-15 16:00:00,16
492,1132,1624,45,21.3,0,Clear,21.9,2023-08-15 17:00:00,17
544,988,1532,49,20.1,0,Clear,18.2,2023-08-15 18:00:00,18
435,741,1176,61,19.0,0,Clear,19.9,2023-08-15 19:00:00,19
285,508,793,62,18.8,0,Clear,14.4,2023-08-15 20:00:00,20
231,341,572,59,19.3,0,Clear,11.9,2023-08-15 21:00:00,21
183,267,450,55,20.4,0,Clear,12.8,2023-08-15 22:00:00,22
92,123,215,50,21.7,0,Clear,11.1,2023-08-15 23:00:00,23
38,47,85,44,23.3,0,Clear,11.1,2023-08-16 00:00:00,0
13,33,46,39,25.1,0,Clear,11.1,2023-08-16 01:00:00,1
10,11,21,33,26.6,0,Clear,10.7,2023-08-16 02:00:00,2
10,6,16,29,27.9,0,Clear,11.5,2023-08-16 03:00:00,3
6,14,20,26,28.7,0,Clear,10.7,2023-08-16 04:00:00,4
32,85,117,25,29.2,0,Clear,8.6,2023-08-16 05:00:00,5
83,247,330,24,29.6,0,Clear,8.5,2023-08-16 06:00:00,6
206,545,751,24,28.5,0,Clear,10.5,2023-08-16 07:00:00,7
308,934,1242,25,28.0,0,Clear,9.9,2023-08-16 08:00:00,8
281,564,845,25,27.6,0,Clear,8.3,2023-08-16 09:00:00,9
244,327,571,26,27.1,0,Clear,7.5,2023-08-16 10:00:00,10
247,361,608,28,26.2,0,Clear,8.6,2023-08-16 11:00:00,11
290,450,740,30,25.3,0,Clear,6.9,2023-08-16 12:00:00,12
320,363,683,35,24.0,1,Mostly Clear,5.4,2023-08-16 13:00:00,13
323,417,740,36,23.3,1,Mostly Clear,6.6,2023-08-16 14:00:00,14
340,544,884,38,22.5,1,Mostly Clear,6.0,2023-08-16 15:00:00,15
422,711,1133,39,22.0,0,Clear,4.3,2023-08-16 16:00:00,16
680,1251,1931,42,21.0,0,Clear,5.1,2023-08-16 17:00:00,17
662,1047,1709,42,20.6,0,Clear,7.9,2023-08-16 18:00:00,18
579,832,1411,44,20.4,1,Mostly Clear,11.2,2023-08-16 19:00:00,19
339,558,897,44,20.9,1,Mostly Clear,10.2,2023-08-16 20:00:00,20
299,422,721,42,22.4,2,Partly Cloudy,6.5,2023-08-16 21:00:00,21
202,323,525,40,23.7,2,Partly Cloudy,7.2,2023-08-16 22:00:00,22
100,131,231,39,24.3,2,Partly Cloudy,9.3,2023-08-16 23:00:00,23
44,55,99,41,24.2,2,Partly Cloudy,16.9,2023-08-17 00:00:00,0
17,47,64,45,23.5,2,Partly Cloudy,19.6,2023-08-17 01:00:00,1
17,16,33,44,23.9,0,Clear,20.2,2023-08-17 02:00:00,2
7,13,20,40,24.8,0,Clear,18.8,2023-08-17 03:00:00,3
11,18,29,36,26.0,0,Clear,19.2,2023-08-17 04:00:00,4
24,76,100,34,26.6,0,Clear,15.5,2023-08-17 05:00:00,5
80,235,315,34,26.8,0,Clear,15.5,2023-08-17 06:00:00,6
171,520,691,31,27.4,0,Clear,7.5,2023-08-17 07:00:00,7
314,864,1178,31,27.3,0,Clear,3.7,2023-08-17 08:00:00,8
260,535,795,32,26.7,2,Partly Cloudy,5.8,2023-08-17 09:00:00,9
241,341,582,32,26.5,2,Partly Cloudy,12.2,2023-08-17 10:00:00,10
267,354,621,32,26.2,2,Partly Cloudy,10.6,2023-08-17 11:00:00,11
300,448,748,32,25.5,2,Partly Cloudy,11.7,2023-08-17 12:00:00,12
295,392,687,33,24.5,1,Mostly Clear,8.3,2023-08-17 13:00:00,13
324,421,745,34,23.9,0,Clear,8.4,2023-08-17 14:00:00,14
397,528,925,35,23.0,0,Clear,9.7,2023-08-17 15:00:00,15
426,685,1111,37,22.3,0,Clear,11.8,2023-08-17 16:00:00,16
604,1144,1748,41,21.3,0,Clear,10.8,2023-08-17 17:00:00,17
636,1041,1677,44,20.6,0,Clear,13.0,2023-08-17 18:00:00,18
468,775,1243,52,20.2,1,Mostly Clear,12.5,2023-08-17 19:00:00,19
326,522,848,55,20.5,2,Partly Cloudy,14.8,2023-08-17 20:00:00,20
270,424,694,51,22.1,1,Mostly Clear,11.6,2023-08-17 21:00:00,21
194,290,484,42,24.6,2,Partly Cloudy,13.8,2023-08-17 22:00:00,22
121,179,300,35,25.7,1,Mostly Clear,15.0,2023-08-17 23:00:00,23
63,91,154,30,27.1,1,Mostly Clear,13.6,2023-08-18 00:00:00,0
27,37,64,26,28.1,0,Clear,11.3,2023-08-18 01:00:00,1
24,14,38,23,28.8,1,Mostly Clear,11.0,2023-08-18 02:00:00,2
16,13,29,22,29.6,0,Clear,8.0,2023-08-18 03:00:00,3
9,17,26,21,30.6,0,Clear,4.8,2023-08-18 04:00:00,4
29,93,122,20,31.2,0,Clear,3.7,2023-08-18 05:00:00,5
80,214,294,20,31.5,0,Clear,5.9,2023-08-18 06:00:00,6
145,437,582,22,30.5,0,Clear,6.6,2023-08-18 07:00:00,7
225,615,840,22,30.1,0,Clear,8.4,2023-08-18 08:00:00,8
270,410,680,25,29.1,0,Clear,6.7,2023-08-18 09:00:00,9
332,371,703,28,28.1,0,Clear,5.8,2023-08-18 10:00:00,10
379,428,807,35,27.2,0,Clear,3.6,2023-08-18 11:00:00,11
377,522,899,32,27.1,0,Clear,4.7,2023-08-18 12:00:00,12
375,453,828,30,26.2,0,Clear,10.8,2023-08-18 13:00:00,13
441,494,935,32,25.3,0,Clear,13.0,2023-08-18 14:00:00,14
481,612,1093,37,23.8,0,Clear,11.2,2023-08-18 15:00:00,15
509,750,1259,39,22.6,0,Clear,9.8,2023-08-18 16:00:00,16
566,912,1478,39,21.8,0,Clear,10.5,2023-08-18 17:00:00,17
581,821,1402,41,21.0,0,Clear,10.5,2023-08-18 18:00:00,18
488,689,1177,45,19.7,0,Clear,8.9,2023-08-18 19:00:00,19
369,450,819,43,19.9,0,Clear,8.4,2023-08-18 20:00:00,20
289,398,687,39,21.6,0,Clear,5.6,2023-08-18 21:00:00,21
273,338,611,33,24.3,0,Clear,8.9,2023-08-18 22:00:00,22
172,233,405,26,26.7,0,Clear,8.6,2023-08-18 23:00:00,23
157,177,334,23,28.6,0,Clear,7.6,2023-08-19 00:00:00,0
103,123,226,21,30.4,0,Clear,7.4,2023-08-19 01:00:00,1
75,84,159,18,31.9,0,Clear,7.4,2023-08-19 02:00:00,2
39,33,72,16,32.8,0,Clear,8.3,2023-08-19 03:00:00,3
17,18,35,16,33.5,0,Clear,8.6,2023-08-19 04:00:00,4
13,23,36,16,33.7,0,Clear,7.2,2023-08-19 05:00:00,5
53,82,135,17,33.7,0,Clear,4.1,2023-08-19 06:00:00,6
108,204,312,18,32.7,0,Clear,7.3,2023-08-19 07:00:00,7
225,335,560,19,32.3,0,Clear,1.9,2023-08-19 08:00:00,8
358,489,847,22,31.4,0,Clear,4.4,2023-08-19 09:00:00,9
575,549,1124,24,30.2,0,Clear,5.1,2023-08-19 10:00:00,10
628,629,1257,21,30.5,0,Clear,2.5,2023-08-19 11:00:00,11
686,591,1277,22,29.8,1,Mostly Clear,2.3,2023-08-19 12:00:00,12
702,633,1335,23,29.3,0,Clear,2.1,2023-08-19 13:00:00,13
718,660,1378,28,26.8,1,Mostly Clear,6.4,2023-08-19 14:00:00,14
744,667,1411,28,26.3,1,Mostly Clear,12.6,2023-08-19 15:00:00,15
651,573,1224,30,25.3,2,Partly Cloudy,13.4,2023-08-19 16:00:00,16
623,596,1219,32,25.2,2,Partly Cloudy,10.8,2023-08-19 17:00:00,17
604,611,1215,34,24.8,2,Partly Cloudy,6.0,2023-08-19 18:00:00,18
591,563,1154,43,23.9,1,Mostly Clear,8.3,2023-08-19 19:00:00,19
451,426,877,43,24.2,1,Mostly Clear,12.0,2023-08-19 20:00:00,20
265,391,656,39,25.3,2,Partly Cloudy,13.6,2023-08-19 21:00:00,21
240,264,504,33,26.9,2,Partly Cloudy,17.1,2023-08-19 22:00:00,22
209,226,435,22,29.2,1,Mostly Clear,19.2,2023-08-19 23:00:00,23
142,154,296,18,30.6,2,Partly Cloudy,23.6,2023-08-20 00:00:00,0
120,124,244,17,31.4,0,Clear,23.2,2023-08-20 01:00:00,1
70,76,146,16,33.0,0,Clear,19.9,2023-08-20 02:00:00,2
41,41,82,15,34.2,0,Clear,16.3,2023-08-20 03:00:00,3
13,20,33,14,34.9,0,Clear,13.3,2023-08-20 04:00:00,4
25,55,80,13,35.4,0,Clear,13.1,2023-08-20 05:00:00,5
47,83,130,13,35.3,0,Clear,13.9,2023-08-20 06:00:00,6
87,141,228,15,34.0,0,Clear,9.7,2023-08-20 07:00:00,7
189,254,443,16,33.4,0,Clear,6.1,2023-08-20 08:00:00,8
308,388,696,16,32.7,0,Clear,0.8,2023-08-20 09:00:00,9
465,503,968,20,30.7,0,Clear,5.4,2023-08-20 10:00:00,10
535,570,1105,21,29.7,0,Clear,5.0,2023-08-20 11:00:00,11
557,593,1150,23,28.3,0,Clear,6.9,2023-08-20 12:00:00,12
595,616,1211,25,27.3,0,Clear,10.2,2023-08-20 13:00:00,13
583,632,1215,27,25.8,0,Clear,8.1,2023-08-20 14:00:00,14
483,593,1076,29,25.3,0,Clear,13.6,2023-08-20 15:00:00,15
512,600,1112,34,24.5,0,Clear,15.5,2023-08-20 16:00:00,16
539,568,1107,34,23.8,0,Clear,13.7,2023-08-20 17:00:00,17
443,566,1009,33,23.0,0,Clear,14.0,2023-08-20 18:00:00,18
442,427,869,31,22.5,0,Clear,12.7,2023-08-20 19:00:00,19
319,421,740,31,22.5,0,Clear,13.3,2023-08-20 20:00:00,20
169,247,416,29,24.3,0,Clear,13.6,2023-08-20 21:00:00,21
128,195,323,24,26.9,0,Clear,16.9,2023-08-20 22:00:00,22
105,131,236,20,28.5,0,Clear,17.4,2023-08-20 23:00:00,23
54,39,93,17,30.3,0,Clear,14.3,2023-08-21 00:00:00,0
26,29,55,15,32.4,0,Clear,14.6,2023-08-21 01:00:00,1
16,24,40,14,34.0,0,Clear,15.4,2023-08-21 02:00:00,2
7,23,30,13,35.2,0,Clear,16.1,2023-08-21 03:00:00,3
7,21,28,12,36.0,0,Clear,16.1,2023-08-21 04:00:00,4
27,57,84,12,36.5,0,Clear,15.8,2023-08-21 05:00:00,5
65,213,278,11,36.5,0,Clear,15.8,2023-08-21 06:00:00,6
162,485,647,13,35.3,0,Clear,13.1,2023-08-21 07:00:00,7
245,761,1006,13,34.7,0,Clear,9.2,2023-08-21 08:00:00,8
239,457,696,16,32.3,0,Clear,6.0,2023-08-21 09:00:00,9
176,301,477,16,31.4,0,Clear,14.7,2023-08-21 10:00:00,10
228,296,524,20,29.9,0,Clear,14.9,2023-08-21 11:00:00,11
250,426,676,22,28.9,1,Mostly Clear,13.5,2023-08-21 12:00:00,12
243,363,606,23,28.5,0,Clear,12.9,2023-08-21 13:00:00,13
313,440,753,23,28.0,0,Clear,12.6,2023-08-21 14:00:00,14
346,478,824,24,27.4,0,Clear,13.2,2023-08-21 15:00:00,15
383,617,1000,26,26.3,1,Mostly Clear,11.2,2023-08-21 16:00:00,16
547,1046,1593,28,25.7,3,Cloudy,10.7,2023-08-21 17:00:00,17
527,917,1444,28,25.4,2,Partly Cloudy,12.7,2023-08-21 18:00:00,18
428,724,1152,26,24.4,0,Clear,14.4,2023-08-21 19:00:00,19
287,502,789,25,24.3,0,Clear,13.8,2023-08-21 20:00:00,20
234,336,570,23,25.8,0,Clear,10.7,2023-08-21 21:00:00,21
141,209,350,21,27.5,1,Mostly Clear,10.4,2023-08-21 22:00:00,22
69,128,197,20,29.3,1,Mostly Clear,12.0,2023-08-21 23:00:00,23
38,58,96,18,30.8,0,Clear,8.7,2023-08-22 00:00:00,0
11,26,37,17,32.5,0,Clear,10.4,2023-08-22 01:00:00,1
9,15,24,16,33.5,1,Mostly Clear,9.4,2023-08-22 02:00:00,2
8,13,21,15,34.3,0,Clear,10.1,2023-08-22 03:00:00,3
4,19,23,14,35.4,0,Clear,11.8,2023-08-22 04:00:00,4
27,72,99,13,36.0,0,Clear,17.6,2023-08-22 05:00:00,5
82,277,359,13,35.8,0,Clear,20.2,2023-08-22 06:00:00,6
178,614,792,14,34.3,2,Partly Cloudy,18.0,2023-08-22 07:00:00,7
340,959,1299,14,34.3,2,Partly Cloudy,18.2,2023-08-22 08:00:00,8
241,561,802,16,33.2,2,Partly Cloudy,20.3,2023-08-22 09:00:00,9
215,338,553,18,32.2,2,Partly Cloudy,19.4,2023-08-22 10:00:00,10
240,384,624,18,31.5,2,Partly Cloudy,15.6,2023-08-22 11:00:00,11
246,492,738,19,30.8,2,Partly Cloudy,11.9,2023-08-22 12:00:00,12
253,426,679,20,30.2,3,Cloudy,13.5,2023-08-22 13:00:00,13
288,457,745,23,29.7,3,Cloudy,21.9,2023-08-22 14:00:00,14
364,538,902,23,29.2,2,Partly Cloudy,22.5,2023-08-22 15:00:00,15
416,809,1225,25,28.1,2,Partly Cloudy,13.7,2023-08-22 16:00:00,16
636,1249,1885,29,27.2,2,Partly Cloudy,12.3,2023-08-22 17:00:00,17
632,1116,1748,33,26.9,2,Partly Cloudy,15.8,2023-08-22 18:00:00,18
485,758,1243,33,26.0,3,Cloudy,6.6,2023-08-22 19:00:00,19
346,566,912,37,25.7,0,Clear,5.9,2023-08-22 20:00:00,20
238,372,610,39,26.3,3,Cloudy,6.5,2023-08-22 21:00:00,21
152,267,419,37,27.0,2,Partly Cloudy,16.3,2023-08-22 22:00:00,22
99,139,238,30,27.9,1,Mostly Clear,10.5,2023-08-22 23:00:00,23
33,53,86,27,29.1,1,Mostly Clear,5.5,2023-08-23 00:00:00,0
10,28,38,25,29.7,0,Clear,4.3,2023-08-23 01:00:00,1
4,17,21,24,30.5,0,Clear,5.0,2023-08-23 02:00:00,2
6,7,13,23,31.5,0,Clear,10.4,2023-08-23 03:00:00,3
8,18,26,22,31.8,0,Clear,11.4,2023-08-23 04:00:00,4
29,87,116,22,32.3,0,Clear,12.2,2023-08-23 05:00:00,5
95,260,355,21,32.4,1,Mostly Clear,9.6,2023-08-23 06:00:00,6
190,598,788,22,31.0,0,Clear,11.8,2023-08-23 07:00:00,7
291,959,1250,23,29.9,0,Clear,21.3,2023-08-23 08:00:00,8
226,564,790,25,28.8,0,Clear,20.4,2023-08-23 09:00:00,9
229,390,619,28,28.1,0,Clear,21.0,2023-08-23 10:00:00,10
235,363,598,30,27.1,0,Clear,17.5,2023-08-23 11:00:00,11
264,505,769,32,26.3,0,Clear,15.0,2023-08-23 12:00:00,12
336,501,837,34,25.3,0,Clear,13.3,2023-08-23 13:00:00,13
343,450,793,37,24.4,1,Mostly Clear,11.9,2023-08-23 14:00:00,14
355,608,963,39,23.6,1,Mostly Clear,11.9,2023-08-23 15:00:00,15
409,814,1223,41,22.9,1,Mostly Clear,11.9,2023-08-23 16:00:00,16
579,1359,1938,41,22.1,0,Clear,8.6,2023-08-23 17:00:00,17
632,1100,1732,43,21.2,2,Partly Cloudy,10.7,2023-08-23 18:00:00,18
523,774,1297,44,22.0,3,Cloudy,2.6,2023-08-23 19:00:00,19
319,577,896,56,20.1,2,Partly Cloudy,23.4,2023-08-23 20:00:00,20
213,371,584,62,20.5,1,Mostly Clear,15.9,2023-08-23 21:00:00,21
164,261,425,58,21.8,2,Partly Cloudy,13.9,2023-08-23 22:00:00,22
101,151,252,58,22.0,2,Partly Cloudy,22.7,2023-08-23 23:00:00,23
35,79,114,52,23.2,2,Partly Cloudy,18.2,2023-08-24 00:00:00,0
10,19,29,52,23.5,2,Partly Cloudy,19.4,2023-08-24 01:00:00,1
9,17,26,54,23.1,3,Cloudy,14.7,2023-08-24 02:00:00,2
5,9,14,55,22.8,3,Cloudy,12.2,2023-08-24 03:00:00,3
5,14,19,56,22.4,3,Cloudy,6.6,2023-08-24 04:00:00,4
18,70,88,50,23.1,51,Light Drizzle,8.2,2023-08-24 05:00:00,5
87,218,305,43,24.1,2,Partly Cloudy,11.1,2023-08-24 06:00:00,6
187,558,745,29,27.5,2,Partly Cloudy,22.0,2023-08-24 07:00:00,7
302,821,1123,41,25.2,0,Clear,26.8,2023-08-24 08:00:00,8
230,571,801,44,24.3,0,Clear,23.4,2023-08-24 09:00:00,9
203,343,546,46,23.5,1,Mostly Clear,20.0,2023-08-24 10:00:00,10
272,379,651,48,23.2,1,Mostly Clear,19.5,2023-08-24 11:00:00,11
278,441,719,50,22.8,1,Mostly Clear,21.5,2023-08-24 12:00:00,12
259,384,643,51,22.5,0,Clear,19.1,2023-08-24 13:00:00,13
312,424,736,51,22.1,1,Mostly Clear,18.1,2023-08-24 14:00:00,14
287,546,833,50,21.8,0,Clear,18.3,2023-08-24 15:00:00,15
416,776,1192,51,21.4,1,Mostly Clear,16.9,2023-08-24 16:00:00,16
658,1197,1855,54,20.7,0,Clear,11.9,2023-08-24 17:00:00,17
596,1067,1663,59,19.5,0,Clear,7.7,2023-08-24 18:00:00,18
423,744,1167,57,20.6,1,Mostly Clear,18.9,2023-08-24 19:00:00,19
309,564,873,58,19.9,1,Mostly Clear,11.5,2023-08-24 20:00:00,20
247,386,633,52,21.1,1,Mostly Clear,0.8,2023-08-24 21:00:00,21
192,295,487,48,22.3,2,Partly Cloudy,6.1,2023-08-24 22:00:00,22
90,174,264,44,23.5,2,Partly Cloudy,6.2,2023-08-24 23:00:00,23
69,127,196,39,25.1,3,Cloudy,7.2,2023-08-25 00:00:00,0
34,61,95,36,25.9,3,Cloudy,14.3,2023-08-25 01:00:00,1
18,22,40,36,25.5,3,Cloudy,11.6,2023-08-25 02:00:00,2
13,14,27,34,26.3,2,Partly Cloudy,6.5,2023-08-25 03:00:00,3
14,30,44,31,27.5,1,Mostly Clear,8.5,2023-08-25 04:00:00,4
22,69,91,29,28.2,3,Cloudy,9.7,2023-08-25 05:00:00,5
70,198,268,29,28.4,3,Cloudy,9.3,2023-08-25 06:00:00,6
133,411,544,31,27.1,2,Partly Cloudy,7.4,2023-08-25 07:00:00,7
257,645,902,31,26.9,2,Partly Cloudy,12.2,2023-08-25 08:00:00,8
239,498,737,33,25.8,1,Mostly Clear,15.5,2023-08-25 09:00:00,9
236,407,643,36,24.7,2,Partly Cloudy,9.5,2023-08-25 10:00:00,10
285,472,757,47,23.0,2,Partly Cloudy,19.5,2023-08-25 11:00:00,11
295,573,868,55,21.6,0,Clear,23.5,2023-08-25 12:00:00,12
329,543,872,57,21.1,1,Mostly Clear,16.7,2023-08-25 13:00:00,13
364,548,912,63,20.1,2,Partly Cloudy,21.0,2023-08-25 14:00:00,14
345,642,987,69,19.4,51,Light Drizzle,19.1,2023-08-25 15:00:00,15
439,694,1133,70,19.3,3,Cloudy,18.1,2023-08-25 16:00:00,16
409,748,1157,73,18.8,2,Partly Cloudy,20.9,2023-08-25 17:00:00,17
388,783,1171,76,18.3,2,Partly Cloudy,21.1,2023-08-25 18:00:00,18
366,555,921,74,19.3,1,Mostly Clear,18.4,2023-08-25 19:00:00,19
108,218,326,76,19.2,1,Mostly Clear,22.4,2023-08-25 20:00:00,20
108,223,331,72,20.1,1,Mostly Clear,22.2,2023-08-25 21:00:00,21
115,275,390,62,21.6,2,Partly Cloudy,25.0,2023-08-25 22:00:00,22
157,233,390,47,23.2,3,Cloudy,23.7,2023-08-25 23:00:00,23
124,183,307,40,24.6,1,Mostly Clear,21.4,2023-08-26 00:00:00,0
98,116,214,38,25.3,2,Partly Cloudy,23.2,2023-08-26 01:00:00,1
73,76,149,40,25.1,3,Cloudy,25.2,2023-08-26 02:00:00,2
26,36,62,37,25.8,3,Cloudy,25.2,2023-08-26 03:00:00,3
9,26,35,37,25.6,3,Cloudy,30.6,2023-08-26 04:00:00,4
14,33,47,43,24.0,3,Cloudy,32.9,2023-08-26 05:00:00,5
62,83,145,48,22.9,3,Cloudy,34.6,2023-08-26 06:00:00,6
99,192,291,55,22.1,2,Partly Cloudy,38.5,2023-08-26 07:00:00,7
188,312,500,60,21.6,2,Partly Cloudy,36.3,2023-08-26 08:00:00,8
395,515,910,62,21.0,2,Partly Cloudy,35.9,2023-08-26 09:00:00,9
486,614,1100,67,20.4,2,Partly Cloudy,35.8,2023-08-26 10:00:00,10
561,582,1143,66,20.0,3,Cloudy,33.2,2023-08-26 11:00:00,11
607,681,1288,66,19.6,3,Cloudy,32.1,2023-08-26 12:00:00,12
655,666,1321,67,19.1,3,Cloudy,26.3,2023-08-26 13:00:00,13
619,628,1247,68,18.7,2,Partly Cloudy,21.3,2023-08-26 14:00:00,14
598,654,1252,67,18.6,3,Cloudy,14.7,2023-08-26 15:00:00,15
527,550,1077,68,18.4,51,Light Drizzle,16.4,2023-08-26 16:00:00,16
519,601,1120,66,18.4,51,Light Drizzle,16.8,2023-08-26 17:00:00,17
528,596,1124,64,18.4,2,Partly Cloudy,16.7,2023-08-26 18:00:00,18
456,566,1022,63,18.8,3,Cloudy,17.8,2023-08-26 19:00:00,19
403,426,829,62,18.7,2,Partly Cloudy,18.0,2023-08-26 20:00:00,20
320,369,689,60,19.2,3,Cloudy,16.0,2023-08-26 21:00:00,21
276,306,582,53,20.7,2,Partly Cloudy,16.6,2023-08-26 22:00:00,22
202,244,446,45,22.6,1,Mostly Clear,16.1,2023-08-26 23:00:00,23
159,181,340,36,24.5,0,Clear,13.5,2023-08-27 00:00:00,0
135,148,283,30,26.5,0,Clear,9.4,2023-08-27 01:00:00,1
75,90,165,27,27.7,0,Clear,7.1,2023-08-27 02:00:00,2
41,64,105,25,28.7,0,Clear,8.5,2023-08-27 03:00:00,3
22,15,37,23,29.4,0,Clear,10.5,2023-08-27 04:00:00,4
16,36,52,22,29.8,1,Mostly Clear,13.5,2023-08-27 05:00:00,5
34,79,113,22,29.5,0,Clear,13.8,2023-08-27 06:00:00,6
76,167,243,22,28.4,0,Clear,11.3,2023-08-27 07:00:00,7
184,259,443,24,27.5,1,Mostly Clear,16.5,2023-08-27 08:00:00,8
297,382,679,25,26.7,0,Clear,16.5,2023-08-27 09:00:00,9
507,509,1016,28,25.8,0,Clear,4.1,2023-08-27 10:00:00,10
525,643,1168,33,24.7,1,Mostly Clear,16.5,2023-08-27 11:00:00,11
555,671,1226,45,22.9,1,Mostly Clear,20.1,2023-08-27 12:00:00,12
571,582,1153,46,22.1,1,Mostly Clear,20.5,2023-08-27 13:00:00,13
517,589,1106,48,21.4,1,Mostly Clear,26.8,2023-08-27 14:00:00,14
559,662,1221,50,20.9,1,Mostly Clear,24.8,2023-08-27 15:00:00,15
513,685,1198,51,20.4,2,Partly Cloudy,25.6,2023-08-27 16:00:00,16
534,679,1213,54,19.9,2,Partly Cloudy,21.4,2023-08-27 17:00:00,17
474,640,1114,53,19.8,2,Partly Cloudy,20.1,2023-08-27 18:00:00,18
421,530,951,68,17.5,2,Partly Cloudy,9.5,2023-08-27 19:00:00,19
278,417,695,67,17.4,2,Partly Cloudy,3.9,2023-08-27 20:00:00,20
187,265,452,65,17.8,2,Partly Cloudy,7.6,2023-08-27 21:00:00,21
144,182,326,59,19.3,2,Partly Cloudy,7.7,2023-08-27 22:00:00,22
112,119,231,48,21.3,1,Mostly Clear,8.9,2023-08-27 23:00:00,23
33,47,80,39,23.2,1,Mostly Clear,11.3,2023-08-28 00:00:00,0
17,21,38,32,24.6,0,Clear,10.9,2023-08-28 01:00:00,1
20,15,35,28,26.0,0,Clear,9.4,2023-08-28 02:00:00,2
12,13,25,26,26.8,0,Clear,8.7,2023-08-28 03:00:00,3
11,11,22,25,27.3,0,Clear,7.5,2023-08-28 04:00:00,4
36,65,101,25,27.7,0,Clear,6.1,2023-08-28 05:00:00,5
70,218,288,25,27.8,0,Clear,7.3,2023-08-28 06:00:00,6
167,555,722,26,27.3,1,Mostly Clear,20.1,2023-08-28 07:00:00,7
261,868,1129,38,24.3,51,Light Drizzle,35.7,2023-08-28 08:00:00,8
232,509,741,38,23.8,1,Mostly Clear,17.9,2023-08-28 09:00:00,9
134,269,403,39,23.3,0,Clear,13.2,2023-08-28 10:00:00,10
118,242,360,38,22.5,1,Mostly Clear,11.2,2023-08-28 11:00:00,11
166,329,495,40,21.9,1,Mostly Clear,9.1,2023-08-28 12:00:00,12
222,399,621,43,21.3,1,Mostly Clear,8.2,2023-08-28 13:00:00,13
202,380,582,45,20.8,1,Mostly Clear,3.0,2023-08-28 14:00:00,14
292,546,838,49,19.9,1,Mostly Clear,10.8,2023-08-28 15:00:00,15
355,654,1009,56,18.9,1,Mostly Clear,12.3,2023-08-28 16:00:00,16
481,1031,1512,51,18.4,1,Mostly Clear,10.4,2023-08-28 17:00:00,17
455,976,1431,47,17.6,1,Mostly Clear,10.6,2023-08-28 18:00:00,18
337,661,998,69,17.2,1,Mostly Clear,8.4,2023-08-28 19:00:00,19
262,498,760,66,16.9,1,Mostly Clear,8.9,2023-08-28 20:00:00,20
184,344,528,54,17.8,1,Mostly Clear,11.9,2023-08-28 21:00:00,21
116,222,338,41,19.5,1,Mostly Clear,13.3,2023-08-28 22:00:00,22
64,114,178,28,22.0,0,Clear,14.3,2023-08-28 23:00:00,23
33,49,82,19,24.5,0,Clear,13.0,2023-08-29 00:00:00,0
23,22,45,16,25.9,0,Clear,8.3,2023-08-29 01:00:00,1
4,18,22,17,26.7,0,Clear,4.0,2023-08-29 02:00:00,2
5,10,15,17,27.5,0,Clear,0.8,2023-08-29 03:00:00,3
6,20,26,16,28.3,0,Clear,3.6,2023-08-29 04:00:00,4
32,80,112,15,28.9,0,Clear,8.4,2023-08-29 05:00:00,5
60,253,313,16,28.9,0,Clear,12.5,2023-08-29 06:00:00,6
166,636,802,19,27.9,0,Clear,11.0,2023-08-29 07:00:00,7
324,1037,1361,20,27.8,0,Clear,10.7,2023-08-29 08:00:00,8
204,609,813,26,26.3,0,Clear,18.9,2023-08-29 09:00:00,9
165,364,529,27,25.3,0,Clear,13.7,2023-08-29 10:00:00,10
182,359,541,30,24.3,0,Clear,12.8,2023-08-29 11:00:00,11
214,418,632,35,23.1,0,Clear,10.9,2023-08-29 12:00:00,12
211,453,664,40,22.0,0,Clear,10.2,2023-08-29 13:00:00,13
262,440,702,45,20.8,0,Clear,8.7,2023-08-29 14:00:00,14
312,584,896,51,19.5,0,Clear,6.6,2023-08-29 15:00:00,15
374,771,1145,53,18.8,0,Clear,7.3,2023-08-29 16:00:00,16
547,1189,1736,55,18.1,0,Clear,5.5,2023-08-29 17:00:00,17
534,1100,1634,54,18.0,0,Clear,5.1,2023-08-29 18:00:00,18
396,761,1157,62,16.6,0,Clear,7.4,2023-08-29 19:00:00,19
264,570,834,63,16.3,0,Clear,7.6,2023-08-29 20:00:00,20
212,374,586,58,17.5,0,Clear,6.3,2023-08-29 21:00:00,21
155,235,390,47,20.2,0,Clear,6.5,2023-08-29 22:00:00,22
93,136,229,37,23.0,0,Clear,6.9,2023-08-29 23:00:00,23
43,45,88,33,25.1,0,Clear,5.1,2023-08-30 00:00:00,0
27,26,53,31,26.4,0,Clear,3.8,2023-08-30 01:00:00,1
11,16,27,28,27.7,0,Clear,5.5,2023-08-30 02:00:00,2
12,9,21,26,28.7,0,Clear,7.6,2023-08-30 03:00:00,3
13,29,42,25,29.3,0,Clear,8.7,2023-08-30 04:00:00,4
31,80,111,25,29.5,0,Clear,8.3,2023-08-30 05:00:00,5
76,255,331,25,29.5,0,Clear,6.9,2023-08-30 06:00:00,6
192,674,866,25,29.4,0,Clear,5.4,2023-08-30 07:00:00,7
313,1052,1365,25,29.4,0,Clear,5.9,2023-08-30 08:00:00,8
223,644,867,26,28.5,0,Clear,6.9,2023-08-30 09:00:00,9
215,403,618,28,27.2,0,Clear,8.9,2023-08-30 10:00:00,10
258,406,664,31,25.8,0,Clear,5.4,2023-08-30 11:00:00,11
269,499,768,33,25.0,0,Clear,3.8,2023-08-30 12:00:00,12
287,514,801,36,23.8,0,Clear,8.1,2023-08-30 13:00:00,13
285,405,690,40,22.6,0,Clear,7.3,2023-08-30 14:00:00,14
357,634,991,44,21.6,0,Clear,7.1,2023-08-30 15:00:00,15
431,829,1260,47,20.7,0,Clear,7.1,2023-08-30 16:00:00,16
659,1330,1989,49,20.1,0,Clear,12.3,2023-08-30 17:00:00,17
608,1118,1726,51,19.1,0,Clear,9.1,2023-08-30 18:00:00,18
496,860,1356,59,18.5,0,Clear,11.3,2023-08-30 19:00:00,19
331,544,875,60,18.2,0,Clear,11.0,2023-08-30 20:00:00,20
222,391,613,55,19.5,0,Clear,4.6,2023-08-30 21:00:00,21
167,296,463,47,21.7,0,Clear,6.5,2023-08-30 22:00:00,22
82,174,256,38,24.6,0,Clear,7.3,2023-08-30 23:00:00,23
56,56,112,31,27.0,0,Clear,5.5,2023-08-31 00:00:00,0
22,19,41,28,28.6,0,Clear,2.9,2023-08-31 01:00:00,1
15,22,37,25,29.8,0,Clear,0.8,2023-08-31 02:00:00,2
1,8,9,22,31.0,0,Clear,2.0,2023-08-31 03:00:00,3
9,14,23,20,31.8,0,Clear,3.0,2023-08-31 04:00:00,4
20,73,93,19,32.3,0,Clear,4.7,2023-08-31 05:00:00,5
71,218,289,19,32.6,0,Clear,6.0,2023-08-31 06:00:00,6
194,609,803,19,32.4,0,Clear,8.8,2023-08-31 07:00:00,7
337,994,1331,20,31.8,0,Clear,9.5,2023-08-31 08:00:00,8
242,592,834,22,30.6,0,Clear,6.0,2023-08-31 09:00:00,9
211,387,598,23,29.9,1,Mostly Clear,9.3,2023-08-31 10:00:00,10
220,437,657,30,28.6,1,Mostly Clear,15.9,2023-08-31 11:00:00,11
322,466,788,35,27.1,1,Mostly Clear,16.0,2023-08-31 12:00:00,12
301,492,793,36,26.7,0,Clear,13.7,2023-08-31 13:00:00,13
335,478,813,38,25.4,0,Clear,18.0,2023-08-31 14:00:00,14
396,699,1095,41,24.2,0,Clear,15.8,2023-08-31 15:00:00,15
435,832,1267,44,23.1,0,Clear,11.4,2023-08-31 16:00:00,16
644,1269,1913,47,22.0,0,Clear,8.6,2023-08-31 17:00:00,17
612,1111,1723,49,21.3,0,Clear,9.5,2023-08-31 18:00:00,18
543,835,1378,48,20.9,0,Clear,12.3,2023-08-31 19:00:00,19
326,584,910,49,20.5,0,Clear,10.9,2023-08-31 20:00:00,20
257,466,723,45,22.0,0,Clear,9.7,2023-08-31 21:00:00,21
207,337,544,38,24.6,0,Clear,11.6,2023-08-31 22:00:00,22
106,194,300,30,27.8,0,Clear,14.2,2023-08-31 23:00:00,23
68,101,169,26,30.1,0,Clear,13.0,2023-09-01 00:00:00,0
37,65,102,22,31.6,0,Clear,10.5,2023-09-01 01:00:00,1
34,24,58,20,32.9,0,Clear,9.2,2023-09-01 02:00:00,2
11,11,22,18,33.8,0,Clear,8.4,2023-09-01 03:00:00,3
9,21,30,16,34.4,0,Clear,9.0,2023-09-01 04:00:00,4
27,55,82,15,34.7,0,Clear,9.4,2023-09-01 05:00:00,5
60,182,242,15,34.5,0,Clear,9.2,2023-09-01 06:00:00,6
131,448,579,15,34.3,0,Clear,4.7,2023-09-01 07:00:00,7
239,660,899,15,33.8,0,Clear,9.2,2023-09-01 08:00:00,8
262,510,772,17,32.1,0,Clear,12.1,2023-09-01 09:00:00,9
244,413,657,18,31.3,0,Clear,11.2,2023-09-01 10:00:00,10
319,442,761,20,29.8,0,Clear,9.2,2023-09-01 11:00:00,11
358,551,909,21,28.8,0,Clear,16.0,2023-09-01 12:00:00,12
432,576,1008,23,27.4,0,Clear,13.9,2023-09-01 13:00:00,13
515,447,962,27,26.1,0,Clear,12.9,2023-09-01 14:00:00,14
577,708,1285,29,25.1,0,Clear,18.0,2023-09-01 15:00:00,15
561,845,1406,30,24.3,0,Clear,14.3,2023-09-01 16:00:00,16
626,899,1525,34,23.0,0,Clear,13.0,2023-09-01 17:00:00,17
560,825,1385,37,22.1,0,Clear,15.0,2023-09-01 18:00:00,18
467,613,1080,42,21.1,0,Clear,19.2,2023-09-01 19:00:00,19
343,473,816,42,21.2,0,Clear,17.1,2023-09-01 20:00:00,20
277,325,602,39,22.5,0,Clear,12.7,2023-09-01 21:00:00,21
232,320,552,34,24.7,0,Clear,13.3,2023-09-01 22:00:00,22
218,217,435,26,27.7,0,Clear,15.3,2023-09-01 23:00:00,23
148,146,294,20,30.1,0,Clear,15.2,2023-09-02 00:00:00,0
75,98,173,17,31.5,0,Clear,16.5,2023-09-02 01:00:00,1
33,52,85,16,32.4,0,Clear,16.2,2023-09-02 02:00:00,2
32,33,65,15,33.2,0,Clear,15.6,2023-09-02 03:00:00,3
9,20,29,14,33.9,0,Clear,14.7,2023-09-02 04:00:00,4
21,44,65,14,34.0,0,Clear,12.4,2023-09-02 05:00:00,5
57,83,140,13,34.0,0,Clear,11.3,2023-09-02 06:00:00,6
104,177,281,13,33.4,0,Clear,8.9,2023-09-02 07:00:00,7
192,294,486,14,32.6,0,Clear,11.2,2023-09-02 08:00:00,8
390,452,842,15,31.3,0,Clear,11.0,2023-09-02 09:00:00,9
504,600,1104,18,29.4,0,Clear,5.9,2023-09-02 10:00:00,10
615,616,1231,20,27.8,0,Clear,8.0,2023-09-02 11:00:00,11
634,598,1232,23,26.6,0,Clear,10.5,2023-09-02 12:00:00,12
667,545,1212,26,25.8,0,Clear,11.2,2023-09-02 13:00:00,13
742,616,1358,28,24.5,0,Clear,10.2,2023-09-02 14:00:00,14
733,606,1339,31,23.8,0,Clear,16.0,2023-09-02 15:00:00,15
673,576,1249,34,22.6,0,Clear,14.8,2023-09-02 16:00:00,16
660,597,1257,34,22.1,0,Clear,15.1,2023-09-02 17:00:00,17
594,566,1160,35,21.5,1,Mostly Clear,15.8,2023-09-02 18:00:00,18
547,512,1059,37,20.8,1,Mostly Clear,18.5,2023-09-02 19:00:00,19
411,415,826,36,21.1,1,Mostly Clear,16.5,2023-09-02 20:00:00,20
324,332,656,34,22.2,1,Mostly Clear,11.8,2023-09-02 21:00:00,21
265,284,549,31,23.9,1,Mostly Clear,10.9,2023-09-02 22:00:00,22
183,215,398,26,26.6,1,Mostly Clear,8.7,2023-09-02 23:00:00,23
119,159,278,22,28.7,0,Clear,6.8,2023-09-03 00:00:00,0
84,95,179,19,30.1,0,Clear,4.8,2023-09-03 01:00:00,1
69,74,143,17,31.2,0,Clear,3.5,2023-09-03 02:00:00,2
34,38,72,16,31.9,0,Clear,3.7,2023-09-03 03:00:00,3
14,30,44,15,32.5,0,Clear,6.4,2023-09-03 04:00:00,4
21,18,39,15,33.0,0,Clear,9.2,2023-09-03 05:00:00,5
49,61,110,15,33.0,0,Clear,11.8,2023-09-03 06:00:00,6
57,150,207,16,31.9,0,Clear,17.6,2023-09-03 07:00:00,7
191,284,475,17,30.7,0,Clear,18.7,2023-09-03 08:00:00,8
350,359,709,19,29.5,0,Clear,12.9,2023-09-03 09:00:00,9
522,447,969,20,28.5,0,Clear,10.4,2023-09-03 10:00:00,10
590,532,1122,22,27.3,1,Mostly Clear,9.4,2023-09-03 11:00:00,11
628,512,1140,24,26.4,1,Mostly Clear,9.8,2023-09-03 12:00:00,12
646,538,1184,29,24.8,1,Mostly Clear,6.4,2023-09-03 13:00:00,13
574,466,1040,29,24.5,0,Clear,13.7,2023-09-03 14:00:00,14
624,470,1094,29,23.9,0,Clear,17.3,2023-09-03 15:00:00,15
614,538,1152,30,23.3,0,Clear,14.8,2023-09-03 16:00:00,16
538,484,1022,36,21.7,0,Clear,12.2,2023-09-03 17:00:00,17
510,480,990,41,20.2,0,Clear,8.1,2023-09-03 18:00:00,18
503,551,1054,42,20.0,0,Clear,13.7,2023-09-03 19:00:00,19
331,367,698,45,19.6,0,Clear,16.6,2023-09-03 20:00:00,20
300,370,670,41,21.5,0,Clear,18.6,2023-09-03 21:00:00,21
221,229,450,36,23.4,0,Clear,15.4,2023-09-03 22:00:00,22
169,210,379,30,25.9,0,Clear,12.8,2023-09-03 23:00:00,23
111,123,234,24,27.6,0,Clear,9.3,2023-09-04 00:00:00,0
67,68,135,22,28.9,0,Clear,11.1,2023-09-04 01:00:00,1
30,44,74,20,30.0,0,Clear,12.9,2023-09-04 02:00:00,2
15,29,44,19,30.7,0,Clear,12.5,2023-09-04 03:00:00,3
9,17,26,19,31.3,0,Clear,11.4,2023-09-04 04:00:00,4
19,34,53,18,31.6,0,Clear,17.0,2023-09-04 05:00:00,5
39,69,108,20,30.4,1,Mostly Clear,23.8,2023-09-04 06:00:00,6
66,154,220,20,29.5,1,Mostly Clear,17.3,2023-09-04 07:00:00,7
183,254,437,20,28.9,2,Partly Cloudy,21.3,2023-09-04 08:00:00,8
279,368,647,22,27.9,2,Partly Cloudy,14.1,2023-09-04 09:00:00,9
435,480,915,49,21.6,51,Light Drizzle,31.2,2023-09-04 10:00:00,10
470,525,995,48,21.8,3,Cloudy,23.2,2023-09-04 11:00:00,11
447,532,979,57,20.4,2,Partly Cloudy,26.7,2023-09-04 12:00:00,12
471,527,998,57,19.8,51,Light Drizzle,18.4,2023-09-04 13:00:00,13
400,557,957,63,19.3,1,Mostly Clear,18.0,2023-09-04 14:00:00,14
424,534,958,62,19.1,0,Clear,17.4,2023-09-04 15:00:00,15
383,541,924,61,18.8,0,Clear,18.3,2023-09-04 16:00:00,16
438,554,992,54,18.5,0,Clear,16.0,2023-09-04 17:00:00,17
397,569,966,32,18.9,0,Clear,18.7,2023-09-04 18:00:00,18
353,575,928,24,20.2,0,Clear,19.6,2023-09-04 19:00:00,19
265,363,628,29,19.6,0,Clear,17.8,2023-09-04 20:00:00,20
188,276,464,31,21.0,0,Clear,18.7,2023-09-04 21:00:00,21
113,216,329,26,23.3,0,Clear,20.8,2023-09-04 22:00:00,22
68,126,194,21,25.5,0,Clear,21.6,2023-09-04 23:00:00,23
32,49,81,15,27.2,0,Clear,20.7,2023-09-05 00:00:00,0
17,28,45,12,28.5,0,Clear,18.2,2023-09-05 01:00:00,1
5,14,19,12,29.3,0,Clear,15.1,2023-09-05 02:00:00,2
6,8,14,12,29.9,0,Clear,12.0,2023-09-05 03:00:00,3
12,20,32,13,30.1,0,Clear,10.6,2023-09-05 04:00:00,4
30,61,91,13,30.2,0,Clear,10.1,2023-09-05 05:00:00,5
78,259,337,13,30.1,0,Clear,9.6,2023-09-05 06:00:00,6
180,679,859,13,30.0,0,Clear,10.0,2023-09-05 07:00:00,7
276,1030,1306,14,29.3,0,Clear,7.1,2023-09-05 08:00:00,8
208,568,776,16,27.8,0,Clear,9.8,2023-09-05 09:00:00,9
131,329,460,23,26.3,0,Clear,15.6,2023-09-05 10:00:00,10
156,372,528,27,25.2,0,Clear,13.8,2023-09-05 11:00:00,11
184,418,602,30,24.1,0,Clear,10.9,2023-09-05 12:00:00,12
188,391,579,34,22.5,0,Clear,7.9,2023-09-05 13:00:00,13
195,391,586,35,21.9,0,Clear,10.1,2023-09-05 14:00:00,14
232,541,773,28,21.2,0,Clear,5.5,2023-09-05 15:00:00,15
329,725,1054,29,21.0,0,Clear,4.3,2023-09-05 16:00:00,16
471,1205,1676,21,19.5,0,Clear,14.8,2023-09-05 17:00:00,17
439,1069,1508,14,17.9,0,Clear,10.7,2023-09-05 18:00:00,18
357,791,1148,30,17.5,0,Clear,5.9,2023-09-05 19:00:00,19
260,541,801,36,17.2,0,Clear,5.2,2023-09-05 20:00:00,20
199,380,579,35,18.7,0,Clear,2.6,2023-09-05 21:00:00,21
138,288,426,32,21.0,0,Clear,4.7,2023-09-05 22:00:00,22
67,116,183,20,23.3,0,Clear,7.8,2023-09-05 23:00:00,23
19,46,65,16,25.3,0,Clear,7.6,2023-09-06 00:00:00,0
19,23,42,16,27.0,0,Clear,6.4,2023-09-06 01:00:00,1
11,12,23,17,28.5,0,Clear,4.0,2023-09-06 02:00:00,2
13,12,25,17,29.9,0,Clear,8.4,2023-09-06 03:00:00,3
14,20,34,16,30.6,0,Clear,12.6,2023-09-06 04:00:00,4
38,74,112,15,31.1,0,Clear,13.4,2023-09-06 05:00:00,5
91,277,368,13,31.1,0,Clear,15.8,2023-09-06 06:00:00,6
217,737,954,17,30.2,1,Mostly Clear,19.3,2023-09-06 07:00:00,7
353,1131,1484,19,29.1,0,Clear,19.0,2023-09-06 08:00:00,8
230,576,806,20,28.1,1,Mostly Clear,11.2,2023-09-06 09:00:00,9
200,340,540,22,27.2,1,Mostly Clear,12.1,2023-09-06 10:00:00,10
198,346,544,23,26.5,2,Partly Cloudy,8.3,2023-09-06 11:00:00,11
216,427,643,32,24.3,2,Partly Cloudy,20.2,2023-09-06 12:00:00,12
243,416,659,33,23.4,0,Clear,18.7,2023-09-06 13:00:00,13
207,386,593,38,22.4,0,Clear,14.5,2023-09-06 14:00:00,14
275,561,836,40,21.8,0,Clear,13.6,2023-09-06 15:00:00,15
281,756,1037,41,21.1,0,Clear,10.5,2023-09-06 16:00:00,16
511,1251,1762,43,20.1,0,Clear,9.4,2023-09-06 17:00:00,17
533,1098,1631,45,19.5,0,Clear,10.7,2023-09-06 18:00:00,18
427,799,1226,34,19.0,0,Clear,9.7,2023-09-06 19:00:00,19
293,545,838,31,20.0,0,Clear,2.9,2023-09-06 20:00:00,20
194,435,629,31,20.0,0,Clear,4.0,2023-09-06 21:00:00,21
159,308,467,27,22.2,0,Clear,7.9,2023-09-06 22:00:00,22
70,169,239,24,24.2,0,Clear,11.5,2023-09-06 23:00:00,23
40,66,106,20,26.4,0,Clear,13.2,2023-09-07 00:00:00,0
20,36,56,18,28.2,0,Clear,12.0,2023-09-07 01:00:00,1
3,20,23,16,29.6,0,Clear,10.4,2023-09-07 02:00:00,2
7,8,15,15,30.7,0,Clear,10.1,2023-09-07 03:00:00,3
10,14,24,14,31.4,0,Clear,11.4,2023-09-07 04:00:00,4
29,77,106,14,31.7,0,Clear,12.8,2023-09-07 05:00:00,5
85,266,351,15,31.6,0,Clear,14.8,2023-09-07 06:00:00,6
198,655,853,16,30.9,0,Clear,19.6,2023-09-07 07:00:00,7
335,1150,1485,17,29.7,0,Clear,14.0,2023-09-07 08:00:00,8
236,595,831,20,28.5,0,Clear,2.3,2023-09-07 09:00:00,9
187,360,547,20,28.1,1,Mostly Clear,2.2,2023-09-07 10:00:00,10
189,365,554,24,26.4,1,Mostly Clear,8.8,2023-09-07 11:00:00,11
202,461,663,27,25.4,1,Mostly Clear,7.3,2023-09-07 12:00:00,12
197,420,617,26,24.8,0,Clear,9.7,2023-09-07 13:00:00,13
225,405,630,30,23.1,0,Clear,8.1,2023-09-07 14:00:00,14
275,597,872,31,22.6,0,Clear,9.9,2023-09-07 15:00:00,15
348,750,1098,33,21.2,0,Clear,8.9,2023-09-07 16:00:00,16
515,1207,1722,31,20.4,0,Clear,9.8,2023-09-07 17:00:00,17
495,1104,1599,29,19.9,0,Clear,10.9,2023-09-07 18:00:00,18
455,783,1238,33,18.4,0,Clear,12.9,2023-09-07 19:00:00,19
307,566,873,34,18.0,0,Clear,15.9,2023-09-07 20:00:00,20
223,421,644,31,19.6,0,Clear,15.2,2023-09-07 21:00:00,21
149,329,478,27,22.2,0,Clear,14.0,2023-09-07 22:00:00,22
119,205,324,23,24.2,0,Clear,13.8,2023-09-07 23:00:00,23
56,102,158,21,26.0,0,Clear,13.0,2023-09-08 00:00:00,0
32,37,69,18,27.5,0,Clear,14.2,2023-09-08 01:00:00,1
26,29,55,17,28.8,0,Clear,14.3,2023-09-08 02:00:00,2
8,8,16,16,30.1,0,Clear,13.5,2023-09-08 03:00:00,3
7,19,26,15,31.0,0,Clear,13.4,2023-09-08 04:00:00,4
31,60,91,14,31.4,0,Clear,12.9,2023-09-08 05:00:00,5
76,220,296,14,31.5,0,Clear,10.0,2023-09-08 06:00:00,6
185,525,710,14,31.3,0,Clear,5.0,2023-09-08 07:00:00,7
272,808,1080,16,29.9,0,Clear,7.9,2023-09-08 08:00:00,8
238,578,816,18,28.3,0,Clear,10.5,2023-09-08 09:00:00,9
216,420,636,19,27.4,1,Mostly Clear,11.5,2023-09-08 10:00:00,10
263,413,676,20,26.7,2,Partly Cloudy,14.0,2023-09-08 11:00:00,11
261,585,846,22,25.9,2,Partly Cloudy,19.1,2023-09-08 12:00:00,12
299,524,823,24,25.3,2,Partly Cloudy,18.4,2023-09-08 13:00:00,13
316,552,868,26,24.5,1,Mostly Clear,11.2,2023-09-08 14:00:00,14
372,624,996,27,23.4,0,Clear,11.6,2023-09-08 15:00:00,15
397,753,1150,30,22.0,0,Clear,12.0,2023-09-08 16:00:00,16
556,1046,1602,33,21.0,0,Clear,14.1,2023-09-08 17:00:00,17
530,996,1526,33,20.4,0,Clear,13.0,2023-09-08 18:00:00,18
395,691,1086,32,20.2,0,Clear,13.0,2023-09-08 19:00:00,19
301,505,806,33,19.6,0,Clear,11.4,2023-09-08 20:00:00,20
188,349,537,31,20.8,0,Clear,8.2,2023-09-08 21:00:00,21
74,138,212,27,23.2,0,Clear,11.2,2023-09-08 22:00:00,22
147,214,361,22,26.2,0,Clear,13.5,2023-09-08 23:00:00,23
106,194,300,19,28.3,0,Clear,9.7,2023-09-09 00:00:00,0
105,126,231,17,30.0,0,Clear,6.1,2023-09-09 01:00:00,1
39,85,124,15,31.3,0,Clear,3.6,2023-09-09 02:00:00,2
12,22,34,13,32.1,0,Clear,3.7,2023-09-09 03:00:00,3
7,11,18,12,32.7,0,Clear,3.5,2023-09-09 04:00:00,4
25,41,66,12,33.0,0,Clear,2.2,2023-09-09 05:00:00,5
49,103,152,11,33.1,0,Clear,2.6,2023-09-09 06:00:00,6
120,191,311,12,33.4,0,Clear,4.1,2023-09-09 07:00:00,7
204,320,524,13,32.2,0,Clear,0.7,2023-09-09 08:00:00,8
332,500,832,16,29.8,1,Mostly Clear,8.4,2023-09-09 09:00:00,9
478,645,1123,19,28.4,1,Mostly Clear,7.3,2023-09-09 10:00:00,10
637,670,1307,22,27.2,1,Mostly Clear,6.5,2023-09-09 11:00:00,11
654,705,1359,21,26.8,0,Clear,14.1,2023-09-09 12:00:00,12
580,670,1250,21,26.0,0,Clear,14.8,2023-09-09 13:00:00,13
452,563,1015,26,24.5,0,Clear,13.1,2023-09-09 14:00:00,14
257,410,667,29,23.5,0,Clear,15.5,2023-09-09 15:00:00,15
292,415,707,30,22.3,0,Clear,16.9,2023-09-09 16:00:00,16
225,329,554,28,21.4,0,Clear,16.7,2023-09-09 17:00:00,17
75,153,228,27,20.6,0,Clear,15.8,2023-09-09 18:00:00,18
153,299,452,32,19.3,0,Clear,10.9,2023-09-09 19:00:00,19
182,307,489,32,18.8,0,Clear,10.2,2023-09-09 20:00:00,20
198,275,473,29,20.3,0,Clear,9.2,2023-09-09 21:00:00,21
197,349,546,25,22.8,0,Clear,8.4,2023-09-09 22:00:00,22
136,245,381,21,25.6,0,Clear,9.4,2023-09-09 23:00:00,23
114,211,325,19,27.9,0,Clear,8.7,2023-09-10 00:00:00,0
104,152,256,17,29.5,0,Clear,6.5,2023-09-10 01:00:00,1
62,84,146,15,30.7,0,Clear,5.6,2023-09-10 02:00:00,2
22,37,59,14,31.8,0,Clear,5.2,2023-09-10 03:00:00,3
10,15,25,13,32.6,0,Clear,5.6,2023-09-10 04:00:00,4
24,16,40,12,33.0,0,Clear,6.4,2023-09-10 05:00:00,5
30,55,85,12,33.1,0,Clear,7.0,2023-09-10 06:00:00,6
66,143,209,14,32.1,0,Clear,6.2,2023-09-10 07:00:00,7
105,206,311,15,31.0,0,Clear,5.7,2023-09-10 08:00:00,8
216,366,582,15,30.5,0,Clear,2.5,2023-09-10 09:00:00,9
272,414,686,19,27.8,0,Clear,7.1,2023-09-10 10:00:00,10
296,514,810,21,26.8,0,Clear,5.8,2023-09-10 11:00:00,11
419,637,1056,20,26.9,0,Clear,4.3,2023-09-10 12:00:00,12
510,658,1168,22,26.1,0,Clear,4.3,2023-09-10 13:00:00,13
459,634,1093,25,25.3,0,Clear,4.1,2023-09-10 14:00:00,14
334,505,839,29,23.0,1,Mostly Clear,5.2,2023-09-10 15:00:00,15
430,626,1056,30,22.0,0,Clear,5.3,2023-09-10 16:00:00,16
449,626,1075,30,21.1,0,Clear,5.8,2023-09-10 17:00:00,17
390,583,973,30,21.2,0,Clear,4.7,2023-09-10 18:00:00,18
333,558,891,29,22.1,0,Clear,2.5,2023-09-10 19:00:00,19
248,406,654,33,19.6,0,Clear,6.1,2023-09-10 20:00:00,20
131,281,412,30,20.9,0,Clear,0.7,2023-09-10 21:00:00,21
110,221,331,28,22.4,0,Clear,2.2,2023-09-10 22:00:00,22
43,75,118,25,24.7,0,Clear,2.6,2023-09-10 23:00:00,23
28,50,78,22,26.8,0,Clear,1.5,2023-09-11 00:00:00,0
14,31,45,18,28.8,0,Clear,3.1,2023-09-11 01:00:00,1
8,11,19,16,30.6,0,Clear,4.7,2023-09-11 02:00:00,2
10,17,27,14,31.9,0,Clear,6.4,2023-09-11 03:00:00,3
5,12,17,13,32.6,0,Clear,7.3,2023-09-11 04:00:00,4
25,38,63,12,33.0,0,Clear,8.2,2023-09-11 05:00:00,5
54,196,250,13,33.0,0,Clear,9.5,2023-09-11 06:00:00,6
122,484,606,13,32.6,0,Clear,8.7,2023-09-11 07:00:00,7
241,880,1121,15,31.3,0,Clear,8.4,2023-09-11 08:00:00,8
196,510,706,18,29.6,0,Clear,13.5,2023-09-11 09:00:00,9
164,346,510,20,28.2,0,Clear,13.3,2023-09-11 10:00:00,10
231,355,586,22,26.9,0,Clear,11.1,2023-09-11 11:00:00,11
195,401,596,24,25.6,0,Clear,9.7,2023-09-11 12:00:00,12
243,433,676,27,24.2,0,Clear,7.9,2023-09-11 13:00:00,13
313,392,705,32,23.2,0,Clear,9.5,2023-09-11 14:00:00,14
303,613,916,35,21.6,0,Clear,6.3,2023-09-11 15:00:00,15
324,716,1040,30,22.8,0,Clear,1.9,2023-09-11 16:00:00,16
527,1251,1778,32,22.5,0,Clear,2.3,2023-09-11 17:00:00,17
517,1138,1655,34,21.9,0,Clear,3.8,2023-09-11 18:00:00,18
403,843,1246,38,20.3,0,Clear,1.3,2023-09-11 19:00:00,19
260,529,789,42,18.5,0,Clear,5.4,2023-09-11 20:00:00,20
190,378,568,39,19.7,0,Clear,3.2,2023-09-11 21:00:00,21
129,268,397,32,22.4,0,Clear,3.7,2023-09-11 22:00:00,22
72,145,217,25,25.3,0,Clear,3.9,2023-09-11 23:00:00,23
21,56,77,21,27.7,0,Clear,5.2,2023-09-12 00:00:00,0
14,24,38,18,29.7,0,Clear,6.6,2023-09-12 01:00:00,1
9,19,28,15,31.4,0,Clear,7.2,2023-09-12 02:00:00,2
8,13,21,13,32.7,0,Clear,8.6,2023-09-12 03:00:00,3
5,24,29,12,33.3,0,Clear,7.9,2023-09-12 04:00:00,4
41,74,115,11,33.7,0,Clear,6.6,2023-09-12 05:00:00,5
83,271,354,12,33.6,0,Clear,5.4,2023-09-12 06:00:00,6
207,764,971,12,33.7,0,Clear,5.5,2023-09-12 07:00:00,7
343,1173,1516,14,31.7,0,Clear,7.9,2023-09-12 08:00:00,8
187,606,793,16,30.2,0,Clear,11.9,2023-09-12 09:00:00,9
157,400,557,19,28.3,0,Clear,8.2,2023-09-12 10:00:00,10
173,374,547,22,27.0,0,Clear,5.5,2023-09-12 11:00:00,11
240,452,692,25,26.1,0,Clear,5.6,2023-09-12 12:00:00,12
209,445,654,28,24.4,0,Clear,7.4,2023-09-12 13:00:00,13
243,473,716,27,23.7,0,Clear,10.6,2023-09-12 14:00:00,14
315,605,920,26,23.1,0,Clear,14.5,2023-09-12 15:00:00,15
335,826,1161,27,22.6,0,Clear,20.9,2023-09-12 16:00:00,16
623,1371,1994,26,22.7,0,Clear,21.0,2023-09-12 17:00:00,17
572,1225,1797,27,22.1,0,Clear,21.3,2023-09-12 18:00:00,18
420,817,1237,31,21.6,0,Clear,19.1,2023-09-12 19:00:00,19
224,561,785,33,21.5,0,Clear,20.2,2023-09-12 20:00:00,20
192,387,579,30,22.9,0,Clear,17.4,2023-09-12 21:00:00,21
129,275,404,24,25.9,0,Clear,16.3,2023-09-12 22:00:00,22
66,78,144,19,28.6,0,Clear,29.8,2023-09-12 23:00:00,23
30,45,75,14,30.6,0,Clear,33.0,2023-09-13 00:00:00,0
22,14,36,12,31.7,0,Clear,27.2,2023-09-13 01:00:00,1
7,14,21,12,32.5,0,Clear,24.3,2023-09-13 02:00:00,2
7,11,18,12,33.1,0,Clear,21.2,2023-09-13 03:00:00,3
8,18,26,11,33.7,0,Clear,16.1,2023-09-13 04:00:00,4
28,82,110,11,33.8,0,Clear,12.6,2023-09-13 05:00:00,5
65,268,333,11,33.6,0,Clear,11.9,2023-09-13 06:00:00,6
192,699,891,11,32.5,0,Clear,10.8,2023-09-13 07:00:00,7
357,1185,1542,12,30.7,0,Clear,12.3,2023-09-13 08:00:00,8
237,649,886,14,29.2,0,Clear,9.4,2023-09-13 09:00:00,9
191,396,587,15,28.2,0,Clear,13.5,2023-09-13 10:00:00,10
227,413,640,17,27.1,0,Clear,12.8,2023-09-13 11:00:00,11
263,491,754,18,26.1,0,Clear,12.6,2023-09-13 12:00:00,12
277,467,744,19,24.7,0,Clear,15.8,2023-09-13 13:00:00,13
267,499,766,15,24.9,0,Clear,17.3,2023-09-13 14:00:00,14
339,602,941,17,23.6,0,Clear,18.7,2023-09-13 15:00:00,15
421,848,1269,20,22.5,0,Clear,18.5,2023-09-13 16:00:00,16
652,1386,2038,22,21.7,0,Clear,16.9,2023-09-13 17:00:00,17
604,1177,1781,24,20.5,0,Clear,14.0,2023-09-13 18:00:00,18
551,919,1470,27,20.0,0,Clear,6.3,2023-09-13 19:00:00,19
294,588,882,29,19.0,0,Clear,10.9,2023-09-13 20:00:00,20
234,512,746,28,20.0,0,Clear,8.6,2023-09-13 21:00:00,21
177,336,513,23,23.0,0,Clear,5.8,2023-09-13 22:00:00,22
114,186,300,25,25.2,0,Clear,13.7,2023-09-13 23:00:00,23
51,61,112,24,26.9,0,Clear,13.2,2023-09-14 00:00:00,0
12,27,39,21,28.4,0,Clear,11.3,2023-09-14 01:00:00,1
10,14,24,18,30.0,0,Clear,10.1,2023-09-14 02:00:00,2
9,8,17,15,31.2,0,Clear,10.4,2023-09-14 03:00:00,3
9,13,22,13,31.9,0,Clear,11.8,2023-09-14 04:00:00,4
28,83,111,11,32.2,0,Clear,12.0,2023-09-14 05:00:00,5
77,243,320,11,32.2,0,Clear,10.0,2023-09-14 06:00:00,6
207,673,880,13,31.3,0,Clear,11.6,2023-09-14 07:00:00,7
358,1154,1512,15,29.9,0,Clear,10.8,2023-09-14 08:00:00,8
209,650,859,17,28.4,0,Clear,10.0,2023-09-14 09:00:00,9
220,355,575,19,27.0,0,Clear,10.8,2023-09-14 10:00:00,10
197,423,620,21,25.3,0,Clear,8.4,2023-09-14 11:00:00,11
284,491,775,24,24.1,0,Clear,6.4,2023-09-14 12:00:00,12
306,486,792,25,23.3,0,Clear,8.4,2023-09-14 13:00:00,13
314,420,734,27,22.5,0,Clear,9.7,2023-09-14 14:00:00,14
350,665,1015,29,21.3,0,Clear,13.2,2023-09-14 15:00:00,15
430,896,1326,27,20.2,0,Clear,7.9,2023-09-14 16:00:00,16
710,1373,2083,27,20.2,0,Clear,12.4,2023-09-14 17:00:00,17
612,1207,1819,26,19.5,0,Clear,12.5,2023-09-14 18:00:00,18
496,877,1373,35,17.5,0,Clear,8.1,2023-09-14 19:00:00,19
334,592,926,34,17.3,0,Clear,11.2,2023-09-14 20:00:00,20
240,446,686,32,18.3,0,Clear,9.7,2023-09-14 21:00:00,21
210,349,559,28,21.2,0,Clear,7.4,2023-09-14 22:00:00,22
140,230,370,24,24.4,0,Clear,8.0,2023-09-14 23:00:00,23
62,109,171,20,26.7,0,Clear,7.4,2023-09-15 00:00:00,0
42,55,97,17,28.6,0,Clear,7.1,2023-09-15 01:00:00,1
16,20,36,15,30.2,0,Clear,6.2,2023-09-15 02:00:00,2
10,10,20,13,31.1,0,Clear,4.2,2023-09-15 03:00:00,3
7,22,29,12,31.6,0,Clear,0.8,2023-09-15 04:00:00,4
29,71,100,11,32.0,0,Clear,3.0,2023-09-15 05:00:00,5
59,214,273,11,32.2,0,Clear,6.4,2023-09-15 06:00:00,6
169,531,700,13,31.5,0,Clear,9.1,2023-09-15 07:00:00,7
244,819,1063,14,29.9,0,Clear,7.6,2023-09-15 08:00:00,8
220,560,780,15,28.6,0,Clear,7.9,2023-09-15 09:00:00,9
250,460,710,17,27.7,0,Clear,5.1,2023-09-15 10:00:00,10
253,465,718,15,28.1,0,Clear,2.1,2023-09-15 11:00:00,11
286,567,853,20,25.0,0,Clear,9.0,2023-09-15 12:00:00,12
294,579,873,21,24.2,0,Clear,9.7,2023-09-15 13:00:00,13
373,593,966,21,23.9,0,Clear,18.4,2023-09-15 14:00:00,14
436,701,1137,22,23.4,0,Clear,18.4,2023-09-15 15:00:00,15
503,840,1343,23,23.3,0,Clear,21.4,2023-09-15 16:00:00,16
608,1062,1670,24,22.7,0,Clear,22.2,2023-09-15 17:00:00,17
614,1061,1675,24,22.2,0,Clear,23.2,2023-09-15 18:00:00,18
467,721,1188,28,21.8,0,Clear,14.6,2023-09-15 19:00:00,19
324,512,836,31,20.0,0,Clear,16.1,2023-09-15 20:00:00,20
255,381,636,32,20.7,0,Clear,5.2,2023-09-15 21:00:00,21
230,344,574,32,21.8,0,Clear,10.1,2023-09-15 22:00:00,22
204,263,467,29,23.3,0,Clear,11.3,2023-09-15 23:00:00,23
156,188,344,25,25.4,0,Clear,10.0,2023-09-16 00:00:00,0
143,149,292,22,27.5,0,Clear,10.0,2023-09-16 01:00:00,1
68,72,140,18,29.5,0,Clear,9.5,2023-09-16 02:00:00,2
28,42,70,16,30.7,0,Clear,7.5,2023-09-16 03:00:00,3
12,23,35,15,31.3,0,Clear,3.7,2023-09-16 04:00:00,4
19,28,47,15,31.5,0,Clear,3.1,2023-09-16 05:00:00,5
42,70,112,14,31.7,0,Clear,6.6,2023-09-16 06:00:00,6
93,188,281,15,31.0,0,Clear,9.4,2023-09-16 07:00:00,7
199,308,507,17,29.6,0,Clear,12.4,2023-09-16 08:00:00,8
390,482,872,20,27.9,0,Clear,15.4,2023-09-16 09:00:00,9
507,604,1111,22,26.6,2,Partly Cloudy,14.8,2023-09-16 10:00:00,10
552,660,1212,23,26.1,2,Partly Cloudy,15.5,2023-09-16 11:00:00,11
721,731,1452,24,25.3,2,Partly Cloudy,14.8,2023-09-16 12:00:00,12
810,717,1527,25,24.5,0,Clear,11.3,2023-09-16 13:00:00,13
745,747,1492,28,23.2,0,Clear,6.8,2023-09-16 14:00:00,14
702,690,1392,29,22.4,1,Mostly Clear,10.3,2023-09-16 15:00:00,15
694,714,1408,29,22.0,0,Clear,14.0,2023-09-16 16:00:00,16
667,707,1374,31,21.0,0,Clear,15.8,2023-09-16 17:00:00,17
631,665,1296,33,20.0,0,Clear,9.0,2023-09-16 18:00:00,18
471,620,1091,39,19.0,0,Clear,4.7,2023-09-16 19:00:00,19
342,454,796,39,18.9,0,Clear,4.0,2023-09-16 20:00:00,20
265,408,673,37,19.7,0,Clear,7.2,2023-09-16 21:00:00,21
277,339,616,33,21.3,0,Clear,7.4,2023-09-16 22:00:00,22
188,274,462,30,22.7,1,Mostly Clear,16.1,2023-09-16 23:00:00,23
138,181,319,26,24.7,0,Clear,16.3,2023-09-17 00:00:00,0
86,128,214,23,26.8,0,Clear,15.3,2023-09-17 01:00:00,1
92,83,175,21,28.2,0,Clear,12.4,2023-09-17 02:00:00,2
25,38,63,19,29.2,0,Clear,10.9,2023-09-17 03:00:00,3
11,24,35,17,29.9,0,Clear,10.6,2023-09-17 04:00:00,4
66,57,123,17,30.3,0,Clear,9.2,2023-09-17 05:00:00,5
144,141,285,17,30.2,0,Clear,7.9,2023-09-17 06:00:00,6
118,159,277,18,29.4,0,Clear,9.2,2023-09-17 07:00:00,7
210,249,459,19,28.4,0,Clear,12.4,2023-09-17 08:00:00,8
353,469,822,22,26.9,1,Mostly Clear,18.4,2023-09-17 09:00:00,9
331,479,810,23,26.1,2,Partly Cloudy,17.1,2023-09-17 10:00:00,10
373,515,888,23,25.9,3,Cloudy,14.0,2023-09-17 11:00:00,11
500,585,1085,27,24.7,3,Cloudy,3.7,2023-09-17 12:00:00,12
487,622,1109,29,23.8,2,Partly Cloudy,3.8,2023-09-17 13:00:00,13
461,598,1059,35,22.8,51,Light Drizzle,5.6,2023-09-17 14:00:00,14
441,588,1029,36,22.4,1,Mostly Clear,12.5,2023-09-17 15:00:00,15
437,605,1042,41,21.2,1,Mostly Clear,5.5,2023-09-17 16:00:00,16
190,382,572,41,20.8,1,Mostly Clear,5.7,2023-09-17 17:00:00,17
105,238,343,43,20.1,2,Partly Cloudy,10.5,2023-09-17 18:00:00,18
114,245,359,47,19.7,0,Clear,9.3,2023-09-17 19:00:00,19
87,237,324,50,18.8,0,Clear,6.2,2023-09-17 20:00:00,20
92,185,277,48,19.7,0,Clear,7.7,2023-09-17 21:00:00,21
72,144,216,38,21.8,0,Clear,10.5,2023-09-17 22:00:00,22
39,84,123,28,23.7,0,Clear,10.8,2023-09-17 23:00:00,23
34,56,90,24,25.3,0,Clear,11.2,2023-09-18 00:00:00,0
10,26,36,22,26.6,0,Clear,13.5,2023-09-18 01:00:00,1
6,12,18,20,27.7,0,Clear,14.0,2023-09-18 02:00:00,2
10,10,20,20,28.3,0,Clear,13.5,2023-09-18 03:00:00,3
12,17,29,19,28.7,0,Clear,13.2,2023-09-18 04:00:00,4
37,64,101,19,28.9,0,Clear,12.3,2023-09-18 05:00:00,5
46,172,218,19,28.8,0,Clear,11.5,2023-09-18 06:00:00,6
105,481,586,20,28.0,0,Clear,9.0,2023-09-18 07:00:00,7
217,789,1006,21,27.0,0,Clear,10.8,2023-09-18 08:00:00,8
192,440,632,24,25.8,0,Clear,15.4,2023-09-18 09:00:00,9
187,318,505,26,24.9,1,Mostly Clear,16.8,2023-09-18 10:00:00,10
195,349,544,28,23.9,2,Partly Cloudy,16.4,2023-09-18 11:00:00,11
272,438,710,28,23.6,3,Cloudy,14.6,2023-09-18 12:00:00,12
264,455,719,29,22.8,1,Mostly Clear,13.7,2023-09-18 13:00:00,13
299,423,722,31,21.4,2,Partly Cloudy,6.4,2023-09-18 14:00:00,14
332,573,905,34,20.5,1,Mostly Clear,6.9,2023-09-18 15:00:00,15
370,728,1098,35,20.0,0,Clear,9.3,2023-09-18 16:00:00,16
538,1194,1732,37,19.4,0,Clear,10.2,2023-09-18 17:00:00,17
565,1120,1685,38,18.3,0,Clear,10.8,2023-09-18 18:00:00,18
408,845,1253,46,17.2,0,Clear,11.7,2023-09-18 19:00:00,19
268,520,788,45,16.7,0,Clear,10.7,2023-09-18 20:00:00,20
165,430,595,42,17.9,0,Clear,9.7,2023-09-18 21:00:00,21
121,243,364,38,19.5,0,Clear,10.0,2023-09-18 22:00:00,22
68,139,207,34,21.0,0,Clear,8.1,2023-09-18 23:00:00,23
27,42,69,31,22.5,0,Clear,6.6,2023-09-19 00:00:00,0
3,11,14,27,24.2,0,Clear,7.8,2023-09-19 01:00:00,1
8,4,12,25,25.9,0,Clear,9.5,2023-09-19 02:00:00,2
6,10,16,22,27.1,0,Clear,11.5,2023-09-19 03:00:00,3
4,20,24,21,27.8,0,Clear,12.4,2023-09-19 04:00:00,4
33,84,117,20,28.0,0,Clear,12.3,2023-09-19 05:00:00,5
89,257,346,20,27.9,0,Clear,13.7,2023-09-19 06:00:00,6
199,709,908,21,27.2,0,Clear,15.5,2023-09-19 07:00:00,7
301,1128,1429,22,26.1,0,Clear,13.3,2023-09-19 08:00:00,8
194,578,772,23,25.1,0,Clear,13.0,2023-09-19 09:00:00,9
220,300,520,23,24.8,1,Mostly Clear,14.0,2023-09-19 10:00:00,10
222,385,607,25,24.0,0,Clear,12.6,2023-09-19 11:00:00,11
235,445,680,28,22.7,1,Mostly Clear,10.7,2023-09-19 12:00:00,12
269,467,736,31,21.4,1,Mostly Clear,5.4,2023-09-19 13:00:00,13
282,408,690,31,20.9,0,Clear,7.1,2023-09-19 14:00:00,14
326,614,940,32,20.0,0,Clear,10.5,2023-09-19 15:00:00,15
426,834,1260,35,18.9,0,Clear,8.2,2023-09-19 16:00:00,16
626,1356,1982,37,18.1,0,Clear,8.7,2023-09-19 17:00:00,17
576,1209,1785,40,17.1,0,Clear,8.6,2023-09-19 18:00:00,18
407,785,1192,45,16.5,0,Clear,11.9,2023-09-19 19:00:00,19
264,555,819,47,15.8,0,Clear,9.8,2023-09-19 20:00:00,20
169,419,588,44,17.2,0,Clear,8.0,2023-09-19 21:00:00,21
140,301,441,38,19.6,0,Clear,7.2,2023-09-19 22:00:00,22
60,153,213,34,21.4,0,Clear,8.8,2023-09-19 23:00:00,23
22,47,69,29,23.5,0,Clear,10.0,2023-09-20 00:00:00,0
9,16,25,24,25.4,0,Clear,12.9,2023-09-20 01:00:00,1
6,9,15,21,26.7,0,Clear,17.2,2023-09-20 02:00:00,2
5,7,12,20,27.5,0,Clear,19.8,2023-09-20 03:00:00,3
8,9,17,19,28.1,0,Clear,19.0,2023-09-20 04:00:00,4
35,75,110,19,27.9,0,Clear,20.6,2023-09-20 05:00:00,5
71,249,320,20,27.4,1,Mostly Clear,21.7,2023-09-20 06:00:00,6
179,640,819,19,27.5,1,Mostly Clear,20.9,2023-09-20 07:00:00,7
260,1112,1372,21,26.7,2,Partly Cloudy,19.8,2023-09-20 08:00:00,8
224,625,849,25,25.8,51,Light Drizzle,26.2,2023-09-20 09:00:00,9
166,329,495,41,21.4,3,Cloudy,22.2,2023-09-20 10:00:00,10
220,426,646,41,21.5,2,Partly Cloudy,21.4,2023-09-20 11:00:00,11
234,471,705,41,21.5,1,Mostly Clear,17.1,2023-09-20 12:00:00,12
242,474,716,47,20.6,51,Light Drizzle,16.3,2023-09-20 13:00:00,13
252,451,703,52,20.1,51,Light Drizzle,12.6,2023-09-20 14:00:00,14
350,618,968,52,19.1,51,Light Drizzle,18.3,2023-09-20 15:00:00,15
368,871,1239,46,18.6,51,Light Drizzle,10.9,2023-09-20 16:00:00,16
618,1342,1960,45,18.5,1,Mostly Clear,10.6,2023-09-20 17:00:00,17
554,1213,1767,45,17.5,1,Mostly Clear,14.5,2023-09-20 18:00:00,18
387,870,1257,39,18.4,1,Mostly Clear,7.6,2023-09-20 19:00:00,19
234,567,801,44,17.4,53,Heavy Drizzle,12.7,2023-09-20 20:00:00,20
222,507,729,43,18.6,2,Partly Cloudy,8.0,2023-09-20 21:00:00,21
192,329,521,41,20.2,1,Mostly Clear,4.0,2023-09-20 22:00:00,22
66,181,247,34,22.1,1,Mostly Clear,12.6,2023-09-20 23:00:00,23
35,78,113,24,23.6,0,Clear,10.8,2023-09-21 00:00:00,0
7,24,31,20,24.5,0,Clear,6.9,2023-09-21 01:00:00,1
7,10,17,17,25.1,0,Clear,3.1,2023-09-21 02:00:00,2
4,10,14,17,25.5,0,Clear,0.8,2023-09-21 03:00:00,3
6,16,22,16,25.7,0,Clear,3.2,2023-09-21 04:00:00,4
28,73,101,16,25.8,0,Clear,6.9,2023-09-21 05:00:00,5
88,272,360,16,25.6,0,Clear,5.4,2023-09-21 06:00:00,6
159,622,781,21,25.2,0,Clear,5.2,2023-09-21 07:00:00,7
287,990,1277,23,24.7,2,Partly Cloudy,9.4,2023-09-21 08:00:00,8
184,493,677,29,23.5,2,Partly Cloudy,20.9,2023-09-21 09:00:00,9
190,316,506,29,23.4,3,Cloudy,18.6,2023-09-21 10:00:00,10
163,382,545,32,22.8,2,Partly Cloudy,23.8,2023-09-21 11:00:00,11
313,453,766,35,21.9,2,Partly Cloudy,20.3,2023-09-21 12:00:00,12
254,443,697,38,21.1,2,Partly Cloudy,18.1,2023-09-21 13:00:00,13
276,451,727,41,20.3,1,Mostly Clear,13.0,2023-09-21 14:00:00,14
341,620,961,45,18.9,0,Clear,12.3,2023-09-21 15:00:00,15
423,879,1302,49,18.0,0,Clear,9.5,2023-09-21 16:00:00,16
676,1312,1988,52,17.4,1,Mostly Clear,9.4,2023-09-21 17:00:00,17
630,1254,1884,60,16.4,1,Mostly Clear,11.2,2023-09-21 18:00:00,18
448,874,1322,59,16.4,0,Clear,14.7,2023-09-21 19:00:00,19
300,606,906,62,15.9,0,Clear,12.5,2023-09-21 20:00:00,20
244,462,706,58,16.8,0,Clear,11.3,2023-09-21 21:00:00,21
214,389,603,51,18.5,0,Clear,11.5,2023-09-21 22:00:00,22
141,216,357,43,20.7,0,Clear,9.0,2023-09-21 23:00:00,23
75,112,187,37,22.1,0,Clear,9.0,2023-09-22 00:00:00,0
29,60,89,35,22.4,1,Mostly Clear,13.1,2023-09-22 01:00:00,1
16,22,38,39,22.0,51,Light Drizzle,17.8,2023-09-22 02:00:00,2
10,21,31,41,21.6,51,Light Drizzle,18.0,2023-09-22 03:00:00,3
6,12,18,44,20.9,53,Heavy Drizzle,18.2,2023-09-22 04:00:00,4
44,76,120,57,18.7,55,Heavy Drizzle,21.5,2023-09-22 05:00:00,5
60,244,304,63,17.4,51,Light Drizzle,24.4,2023-09-22 06:00:00,6
174,513,687,71,15.9,61,Light Rain,22.6,2023-09-22 07:00:00,7
230,788,1018,68,16.3,53,Heavy Drizzle,19.4,2023-09-22 08:00:00,8
284,534,818,72,16.2,53,Heavy Drizzle,7.8,2023-09-22 09:00:00,9
288,379,667,73,16.0,51,Light Drizzle,10.0,2023-09-22 10:00:00,10
321,431,752,72,15.8,51,Light Drizzle,11.9,2023-09-22 11:00:00,11
341,561,902,71,15.5,2,Partly Cloudy,13.0,2023-09-22 12:00:00,12
360,521,881,67,15.6,2,Partly Cloudy,17.1,2023-09-22 13:00:00,13
418,604,1022,62,15.5,3,Cloudy,14.1,2023-09-22 14:00:00,14
427,758,1185,46,15.3,2,Partly Cloudy,15.2,2023-09-22 15:00:00,15
489,860,1349,41,13.9,0,Clear,15.4,2023-09-22 16:00:00,16
629,1104,1733,36,12.7,0,Clear,18.4,2023-09-22 17:00:00,17
506,948,1454,35,12.1,0,Clear,20.5,2023-09-22 18:00:00,18
349,692,1041,42,11.6,0,Clear,16.6,2023-09-22 19:00:00,19
228,421,649,43,11.0,0,Clear,17.4,2023-09-22 20:00:00,20
201,377,578,40,12.3,0,Clear,19.9,2023-09-22 21:00:00,21
120,234,354,34,14.8,0,Clear,23.1,2023-09-22 22:00:00,22
61,132,193,28,17.1,0,Clear,29.5,2023-09-22 23:00:00,23
72,122,194,28,18.6,0,Clear,20.3,2023-09-23 00:00:00,0
83,103,186,27,19.7,0,Clear,11.2,2023-09-23 01:00:00,1
47,61,108,27,20.1,0,Clear,8.3,2023-09-23 02:00:00,2
23,33,56,29,20.5,0,Clear,9.4,2023-09-23 03:00:00,3
8,25,33,30,20.7,0,Clear,9.2,2023-09-23 04:00:00,4
4,12,16,30,20.7,0,Clear,7.3,2023-09-23 05:00:00,5
5,15,20,30,20.5,0,Clear,7.5,2023-09-23 06:00:00,6
10,46,56,43,19.7,0,Clear,8.0,2023-09-23 07:00:00,7
35,80,115,46,18.3,0,Clear,4.7,2023-09-23 08:00:00,8
49,139,188,61,16.1,0,Clear,7.2,2023-09-23 09:00:00,9
48,207,255,60,15.3,0,Clear,15.0,2023-09-23 10:00:00,10
66,211,277,65,14.3,0,Clear,13.0,2023-09-23 11:00:00,11
78,207,285,72,13.1,0,Clear,10.0,2023-09-23 12:00:00,12
65,176,241,75,12.2,0,Clear,9.2,2023-09-23 13:00:00,13
38,133,171,79,11.3,1,Mostly Clear,7.5,2023-09-23 14:00:00,14
87,256,343,81,10.6,1,Mostly Clear,6.1,2023-09-23 15:00:00,15
80,205,285,79,10.4,0,Clear,4.9,2023-09-23 16:00:00,16
42,132,174,78,10.4,0,Clear,3.4,2023-09-23 17:00:00,17
35,107,142,89,8.7,0,Clear,5.8,2023-09-23 18:00:00,18
73,139,212,88,8.6,0,Clear,7.2,2023-09-23 19:00:00,19
44,116,160,88,8.3,0,Clear,4.7,2023-09-23 20:00:00,20
37,77,114,86,9.4,0,Clear,4.0,2023-09-23 21:00:00,21
46,123,169,81,12.0,0,Clear,3.1,2023-09-23 22:00:00,22
70,97,167,73,14.5,0,Clear,1.8,2023-09-23 23:00:00,23
31,81,112,61,16.4,0,Clear,6.2,2023-09-24 00:00:00,0
36,49,85,52,18.2,0,Clear,3.5,2023-09-24 01:00:00,1
31,48,79,42,19.7,0,Clear,4.3,2023-09-24 02:00:00,2
10,9,19,33,20.8,0,Clear,5.6,2023-09-24 03:00:00,3
3,10,13,28,21.4,0,Clear,6.4,2023-09-24 04:00:00,4
5,10,15,26,21.7,0,Clear,7.8,2023-09-24 05:00:00,5
10,18,28,27,21.5,0,Clear,7.8,2023-09-24 06:00:00,6
20,69,89,42,20.2,0,Clear,7.8,2023-09-24 07:00:00,7
44,121,165,50,18.0,0,Clear,9.3,2023-09-24 08:00:00,8
78,234,312,47,17.2,0,Clear,15.2,2023-09-24 09:00:00,9
165,313,478,49,16.0,0,Clear,14.1,2023-09-24 10:00:00,10
187,414,601,53,15.1,0,Clear,13.4,2023-09-24 11:00:00,11
251,531,782,58,14.1,1,Mostly Clear,13.1,2023-09-24 12:00:00,12
280,502,782,65,13.0,1,Mostly Clear,10.6,2023-09-24 13:00:00,13
307,490,797,73,12.0,1,Mostly Clear,6.2,2023-09-24 14:00:00,14
238,441,679,76,11.4,1,Mostly Clear,6.5,2023-09-24 15:00:00,15
284,542,826,74,11.2,1,Mostly Clear,5.6,2023-09-24 16:00:00,16
286,528,814,72,11.3,1,Mostly Clear,5.0,2023-09-24 17:00:00,17
248,468,716,80,9.9,1,Mostly Clear,6.9,2023-09-24 18:00:00,18
190,386,576,74,11.1,1,Mostly Clear,3.5,2023-09-24 19:00:00,19
126,279,405,78,10.1,1,Mostly Clear,2.8,2023-09-24 20:00:00,20
115,254,369,84,10.0,1,Mostly Clear,5.4,2023-09-24 21:00:00,21
101,172,273,78,12.0,1,Mostly Clear,2.6,2023-09-24 22:00:00,22
52,118,170,66,14.5,1,Mostly Clear,2.9,2023-09-24 23:00:00,23
21,59,80,55,16.3,1,Mostly Clear,3.6,2023-09-25 00:00:00,0
21,19,40,43,18.2,2,Partly Cloudy,4.7,2023-09-25 01:00:00,1
9,17,26,33,19.8,3,Cloudy,5.9,2023-09-25 02:00:00,2
6,14,20,30,20.5,3,Cloudy,6.6,2023-09-25 03:00:00,3
13,18,31,29,21.0,3,Cloudy,8.3,2023-09-25 04:00:00,4
31,55,86,28,21.3,3,Cloudy,9.6,2023-09-25 05:00:00,5
52,206,258,27,21.2,3,Cloudy,10.5,2023-09-25 06:00:00,6
145,540,685,40,20.2,2,Partly Cloudy,8.6,2023-09-25 07:00:00,7
205,947,1152,43,18.6,2,Partly Cloudy,12.5,2023-09-25 08:00:00,8
153,475,628,46,17.6,2,Partly Cloudy,13.5,2023-09-25 09:00:00,9
159,318,477,53,16.4,3,Cloudy,11.8,2023-09-25 10:00:00,10
230,381,611,62,15.0,3,Cloudy,9.7,2023-09-25 11:00:00,11
250,478,728,69,14.0,1,Mostly Clear,8.4,2023-09-25 12:00:00,12
210,411,621,73,12.8,1,Mostly Clear,8.2,2023-09-25 13:00:00,13
229,426,655,77,11.8,0,Clear,7.7,2023-09-25 14:00:00,14
315,577,892,76,11.6,0,Clear,6.4,2023-09-25 15:00:00,15
341,754,1095,68,12.9,0,Clear,3.1,2023-09-25 16:00:00,16
375,1022,1397,71,12.3,0,Clear,0.8,2023-09-25 17:00:00,17
265,799,1064,74,11.4,0,Clear,2.2,2023-09-25 18:00:00,18
162,541,703,68,11.1,0,Clear,3.3,2023-09-25 19:00:00,19
127,367,494,81,8.6,1,Mostly Clear,6.1,2023-09-25 20:00:00,20
88,310,398,84,9.4,1,Mostly Clear,6.3,2023-09-25 21:00:00,21
90,221,311,73,12.1,1,Mostly Clear,2.1,2023-09-25 22:00:00,22
48,124,172,65,14.4,1,Mostly Clear,3.5,2023-09-25 23:00:00,23
23,40,63,52,16.9,1,Mostly Clear,2.9,2023-09-26 00:00:00,0
10,16,26,41,19.0,0,Clear,1.1,2023-09-26 01:00:00,1
9,12,21,32,20.6,1,Mostly Clear,2.4,2023-09-26 02:00:00,2
6,11,17,26,21.5,0,Clear,5.0,2023-09-26 03:00:00,3
5,19,24,23,22.0,0,Clear,4.7,2023-09-26 04:00:00,4
32,84,116,22,22.1,0,Clear,4.7,2023-09-26 05:00:00,5
50,207,257,20,22.1,0,Clear,6.0,2023-09-26 06:00:00,6
129,505,634,46,20.9,0,Clear,4.1,2023-09-26 07:00:00,7
207,916,1123,19,21.2,0,Clear,1.0,2023-09-26 08:00:00,8
95,352,447,21,20.7,0,Clear,1.4,2023-09-26 09:00:00,9
102,236,338,45,17.3,0,Clear,6.5,2023-09-26 10:00:00,10
84,272,356,49,15.7,0,Clear,10.4,2023-09-26 11:00:00,11
124,372,496,56,14.8,0,Clear,9.8,2023-09-26 12:00:00,12
171,437,608,63,13.9,1,Mostly Clear,9.7,2023-09-26 13:00:00,13
179,388,567,64,13.1,1,Mostly Clear,9.3,2023-09-26 14:00:00,14
216,550,766,58,12.5,0,Clear,9.5,2023-09-26 15:00:00,15
258,748,1006,60,11.7,0,Clear,9.0,2023-09-26 16:00:00,16
490,1055,1545,60,11.4,0,Clear,10.7,2023-09-26 17:00:00,17
342,1038,1380,65,10.7,0,Clear,10.4,2023-09-26 18:00:00,18
261,657,918,73,9.5,0,Clear,8.7,2023-09-26 19:00:00,19
203,498,701,66,9.9,0,Clear,5.2,2023-09-26 20:00:00,20
143,372,515,57,11.1,0,Clear,1.3,2023-09-26 21:00:00,21
119,247,366,58,13.1,0,Clear,1.8,2023-09-26 22:00:00,22
78,194,272,44,16.4,0,Clear,0.8,2023-09-26 23:00:00,23
29,84,113,36,19.1,0,Clear,2.3,2023-09-27 00:00:00,0
7,25,32,31,21.1,0,Clear,4.3,2023-09-27 01:00:00,1
16,4,20,25,22.8,0,Clear,8.4,2023-09-27 02:00:00,2
8,4,12,22,23.8,0,Clear,9.2,2023-09-27 03:00:00,3
9,12,21,21,24.4,0,Clear,9.3,2023-09-27 04:00:00,4
23,78,101,20,24.6,0,Clear,9.5,2023-09-27 05:00:00,5
72,242,314,20,24.6,0,Clear,9.7,2023-09-27 06:00:00,6
182,663,845,26,23.7,1,Mostly Clear,9.2,2023-09-27 07:00:00,7
354,1205,1559,29,21.7,0,Clear,14.2,2023-09-27 08:00:00,8
210,628,838,32,20.0,0,Clear,14.7,2023-09-27 09:00:00,9
161,379,540,36,18.8,1,Mostly Clear,12.9,2023-09-27 10:00:00,10
194,463,657,37,18.2,1,Mostly Clear,13.2,2023-09-27 11:00:00,11
229,527,756,39,17.5,3,Cloudy,12.7,2023-09-27 12:00:00,12
252,516,768,44,16.5,2,Partly Cloudy,10.5,2023-09-27 13:00:00,13
255,512,767,57,15.3,1,Mostly Clear,6.6,2023-09-27 14:00:00,14
366,642,1008,56,14.1,1,Mostly Clear,9.4,2023-09-27 15:00:00,15
430,885,1315,65,13.0,1,Mostly Clear,6.4,2023-09-27 16:00:00,16
634,1352,1986,67,12.3,1,Mostly Clear,8.2,2023-09-27 17:00:00,17
629,1259,1888,63,12.1,1,Mostly Clear,10.2,2023-09-27 18:00:00,18
427,897,1324,68,11.2,0,Clear,9.8,2023-09-27 19:00:00,19
281,573,854,68,11.1,1,Mostly Clear,11.2,2023-09-27 20:00:00,20
200,444,644,63,12.5,1,Mostly Clear,11.5,2023-09-27 21:00:00,21
163,320,483,55,14.9,1,Mostly Clear,9.6,2023-09-27 22:00:00,22
95,189,284,50,16.8,1,Mostly Clear,3.4,2023-09-27 23:00:00,23
42,69,111,44,18.0,2,Partly Cloudy,4.0,2023-09-28 00:00:00,0
9,32,41,35,20.2,1,Mostly Clear,10.1,2023-09-28 01:00:00,1
10,11,21,26,22.1,0,Clear,12.5,2023-09-28 02:00:00,2
11,11,22,23,23.5,0,Clear,15.5,2023-09-28 03:00:00,3
8,16,24,20,24.2,0,Clear,16.2,2023-09-28 04:00:00,4
19,74,93,18,24.4,1,Mostly Clear,18.7,2023-09-28 05:00:00,5
72,225,297,20,23.6,1,Mostly Clear,20.4,2023-09-28 06:00:00,6
150,590,740,20,24.0,1,Mostly Clear,18.8,2023-09-28 07:00:00,7
307,1092,1399,24,22.3,1,Mostly Clear,16.3,2023-09-28 08:00:00,8
251,652,903,27,21.3,1,Mostly Clear,18.2,2023-09-28 09:00:00,9
201,368,569,32,20.1,1,Mostly Clear,18.5,2023-09-28 10:00:00,10
219,397,616,35,19.2,1,Mostly Clear,15.7,2023-09-28 11:00:00,11
246,484,730,38,18.6,1,Mostly Clear,16.8,2023-09-28 12:00:00,12
308,517,825,57,16.6,51,Light Drizzle,5.2,2023-09-28 13:00:00,13
338,491,829,54,15.5,51,Light Drizzle,10.5,2023-09-28 14:00:00,14
374,659,1033,50,16.4,1,Mostly Clear,1.6,2023-09-28 15:00:00,15
443,863,1306,60,15.2,3,Cloudy,4.3,2023-09-28 16:00:00,16
657,1337,1994,60,14.7,2,Partly Cloudy,7.9,2023-09-28 17:00:00,17
580,1175,1755,58,14.1,1,Mostly Clear,9.7,2023-09-28 18:00:00,18
426,784,1210,65,13.6,3,Cloudy,7.2,2023-09-28 19:00:00,19
280,564,844,69,13.4,3,Cloudy,5.2,2023-09-28 20:00:00,20
244,414,658,60,14.6,3,Cloudy,1.1,2023-09-28 21:00:00,21
198,342,540,58,15.6,3,Cloudy,3.7,2023-09-28 22:00:00,22
114,243,357,53,16.8,3,Cloudy,5.4,2023-09-28 23:00:00,23
71,110,181,46,18.0,2,Partly Cloudy,4.0,2023-09-29 00:00:00,0
35,48,83,39,19.3,1,Mostly Clear,4.4,2023-09-29 01:00:00,1
15,34,49,34,20.8,1,Mostly Clear,4.6,2023-09-29 02:00:00,2
4,15,19,29,21.9,1,Mostly Clear,3.4,2023-09-29 03:00:00,3
8,19,27,22,23.5,1,Mostly Clear,10.8,2023-09-29 04:00:00,4
30,71,101,19,23.6,1,Mostly Clear,22.1,2023-09-29 05:00:00,5
63,186,249,19,23.1,1,Mostly Clear,22.0,2023-09-29 06:00:00,6
166,515,681,18,23.3,2,Partly Cloudy,22.7,2023-09-29 07:00:00,7
267,817,1084,20,22.2,2,Partly Cloudy,18.8,2023-09-29 08:00:00,8
245,523,768,31,21.1,3,Cloudy,2.5,2023-09-29 09:00:00,9
249,366,615,45,17.3,1,Mostly Clear,31.0,2023-09-29 10:00:00,10
228,504,732,44,17.3,2,Partly Cloudy,25.3,2023-09-29 11:00:00,11
335,558,893,45,16.9,2,Partly Cloudy,23.0,2023-09-29 12:00:00,12
319,598,917,44,16.7,3,Cloudy,20.0,2023-09-29 13:00:00,13
397,532,929,45,16.3,3,Cloudy,20.5,2023-09-29 14:00:00,14
472,684,1156,46,15.8,3,Cloudy,20.7,2023-09-29 15:00:00,15
514,848,1362,46,15.4,2,Partly Cloudy,19.8,2023-09-29 16:00:00,16
597,1060,1657,46,14.9,2,Partly Cloudy,20.3,2023-09-29 17:00:00,17
534,951,1485,49,14.4,2,Partly Cloudy,16.9,2023-09-29 18:00:00,18
448,658,1106,48,14.5,1,Mostly Clear,18.2,2023-09-29 19:00:00,19
317,478,795,51,14.1,2,Partly Cloudy,17.0,2023-09-29 20:00:00,20
263,396,659,51,15.0,2,Partly Cloudy,13.7,2023-09-29 21:00:00,21
240,322,562,49,16.3,2,Partly Cloudy,15.5,2023-09-29 22:00:00,22
210,310,520,47,17.5,2,Partly Cloudy,24.0,2023-09-29 23:00:00,23
154,207,361,40,19.3,1,Mostly Clear,23.2,2023-09-30 00:00:00,0
112,149,261,35,20.2,1,Mostly Clear,23.0,2023-09-30 01:00:00,1
65,81,146,29,21.2,0,Clear,26.3,2023-09-30 02:00:00,2
30,40,70,28,20.9,0,Clear,24.8,2023-09-30 03:00:00,3
7,18,25,26,21.0,1,Mostly Clear,18.8,2023-09-30 04:00:00,4
24,26,50,25,21.3,1,Mostly Clear,11.8,2023-09-30 05:00:00,5
47,84,131,24,21.0,1,Mostly Clear,6.9,2023-09-30 06:00:00,6
121,189,310,23,21.7,2,Partly Cloudy,3.3,2023-09-30 07:00:00,7
179,304,483,39,18.8,51,Light Drizzle,20.9,2023-09-30 08:00:00,8
353,493,846,46,17.3,51,Light Drizzle,8.9,2023-09-30 09:00:00,9
451,605,1056,50,17.3,51,Light Drizzle,19.3,2023-09-30 10:00:00,10
535,665,1200,47,17.0,1,Mostly Clear,20.6,2023-09-30 11:00:00,11
651,702,1353,51,15.7,2,Partly Cloudy,11.7,2023-09-30 12:00:00,12
679,653,1332,61,14.8,0,Clear,5.4,2023-09-30 13:00:00,13
695,752,1447,66,14.0,0,Clear,3.7,2023-09-30 14:00:00,14
681,766,1447,65,13.8,0,Clear,4.1,2023-09-30 15:00:00,15
667,792,1459,60,14.0,0,Clear,3.1,2023-09-30 16:00:00,16
650,750,1400,72,11.9,0,Clear,5.2,2023-09-30 17:00:00,17
655,789,1444,75,10.9,0,Clear,10.3,2023-09-30 18:00:00,18
460,645,1105,77,10.6,0,Clear,10.4,2023-09-30 19:00:00,19
318,475,793,77,10.2,0,Clear,11.9,2023-09-30 20:00:00,20
347,448,795,69,11.3,0,Clear,10.8,2023-09-30 21:00:00,21
305,329,634,58,13.8,0,Clear,8.8,2023-09-30 22:00:00,22
258,302,560,46,16.6,0,Clear,9.7,2023-09-30 23:00:00,23
172,272,444,34,19.2,0,Clear,9.9,2023-10-01 00:00:00,0
134,186,320,30,20.8,0,Clear,7.6,2023-10-01 01:00:00,1
105,96,201,27,21.7,0,Clear,4.4,2023-10-01 02:00:00,2
32,46,78,26,22.3,0,Clear,3.6,2023-10-01 03:00:00,3
25,30,55,25,22.7,0,Clear,4.0,2023-10-01 04:00:00,4
21,26,47,25,22.8,0,Clear,5.4,2023-10-01 05:00:00,5
34,49,83,25,22.6,0,Clear,6.9,2023-10-01 06:00:00,6
63,161,224,28,22.1,0,Clear,8.0,2023-10-01 07:00:00,7
169,280,449,51,20.0,0,Clear,5.4,2023-10-01 08:00:00,8
328,492,820,43,19.4,0,Clear,7.9,2023-10-01 09:00:00,9
520,643,1163,40,18.3,0,Clear,12.6,2023-10-01 10:00:00,10
626,725,1351,46,17.1,0,Clear,10.7,2023-10-01 11:00:00,11
689,791,1480,62,15.6,0,Clear,6.4,2023-10-01 12:00:00,12
705,745,1450,49,16.8,0,Clear,2.3,2023-10-01 13:00:00,13
748,740,1488,51,16.0,0,Clear,3.4,2023-10-01 14:00:00,14
622,737,1359,66,13.4,0,Clear,6.2,2023-10-01 15:00:00,15
697,797,1494,68,12.6,0,Clear,7.6,2023-10-01 16:00:00,16
556,747,1303,67,12.0,0,Clear,9.2,2023-10-01 17:00:00,17
528,741,1269,71,11.3,0,Clear,5.8,2023-10-01 18:00:00,18
331,522,853,73,11.1,0,Clear,9.7,2023-10-01 19:00:00,19
238,341,579,75,10.8,1,Mostly Clear,6.8,2023-10-01 20:00:00,20
204,280,484,68,12.3,3,Cloudy,7.0,2023-10-01 21:00:00,21
128,235,363,61,14.1,1,Mostly Clear,4.7,2023-10-01 22:00:00,22
87,133,220,48,17.0,1,Mostly Clear,5.1,2023-10-01 23:00:00,23
36,59,95,39,19.5,0,Clear,7.2,2023-10-02 00:00:00,0
12,29,41,33,21.2,1,Mostly Clear,11.9,2023-10-02 01:00:00,1
7,12,19,29,22.4,1,Mostly Clear,14.4,2023-10-02 02:00:00,2
7,12,19,25,23.2,1,Mostly Clear,16.6,2023-10-02 03:00:00,3
10,21,31,22,23.6,0,Clear,18.7,2023-10-02 04:00:00,4
33,73,106,22,23.5,1,Mostly Clear,17.1,2023-10-02 05:00:00,5
78,256,334,23,23.0,1,Mostly Clear,15.1,2023-10-02 06:00:00,6
162,549,711,20,23.9,0,Clear,1.4,2023-10-02 07:00:00,7
237,960,1197,33,20.7,0,Clear,8.5,2023-10-02 08:00:00,8
226,506,732,32,19.7,0,Clear,12.6,2023-10-02 09:00:00,9
212,341,553,37,18.4,0,Clear,13.4,2023-10-02 10:00:00,10
233,387,620,40,17.5,1,Mostly Clear,13.0,2023-10-02 11:00:00,11
252,483,735,40,17.0,2,Partly Cloudy,12.5,2023-10-02 12:00:00,12
324,498,822,44,16.5,0,Clear,17.6,2023-10-02 13:00:00,13
314,486,800,53,15.3,0,Clear,18.6,2023-10-02 14:00:00,14
378,628,1006,52,15.2,0,Clear,22.4,2023-10-02 15:00:00,15
471,777,1248,57,14.2,0,Clear,17.1,2023-10-02 16:00:00,16
610,1295,1905,62,13.1,0,Clear,14.8,2023-10-02 17:00:00,17
530,1167,1697,65,12.2,0,Clear,15.5,2023-10-02 18:00:00,18
331,771,1102,72,11.6,0,Clear,12.9,2023-10-02 19:00:00,19
204,550,754,73,11.2,0,Clear,15.8,2023-10-02 20:00:00,20
163,402,565,66,12.5,0,Clear,15.5,2023-10-02 21:00:00,21
123,273,396,57,14.9,0,Clear,12.0,2023-10-02 22:00:00,22
64,130,194,46,17.9,0,Clear,14.4,2023-10-02 23:00:00,23
27,45,72,31,20.0,0,Clear,12.8,2023-10-03 00:00:00,0
15,29,44,24,21.5,0,Clear,11.2,2023-10-03 01:00:00,1
4,10,14,21,22.7,0,Clear,12.3,2023-10-03 02:00:00,2
6,9,15,20,23.4,0,Clear,12.9,2023-10-03 03:00:00,3
13,23,36,20,23.9,0,Clear,11.9,2023-10-03 04:00:00,4
36,87,123,20,24.4,0,Clear,10.8,2023-10-03 05:00:00,5
72,282,354,19,24.4,0,Clear,10.6,2023-10-03 06:00:00,6
207,754,961,19,23.8,0,Clear,12.7,2023-10-03 07:00:00,7
312,1218,1530,23,21.7,0,Clear,11.6,2023-10-03 08:00:00,8
204,637,841,27,20.3,0,Clear,10.9,2023-10-03 09:00:00,9
209,347,556,36,18.6,0,Clear,7.6,2023-10-03 10:00:00,10
221,393,614,39,18.0,0,Clear,5.4,2023-10-03 11:00:00,11
298,472,770,40,17.2,0,Clear,5.2,2023-10-03 12:00:00,12
254,502,756,40,16.0,0,Clear,10.8,2023-10-03 13:00:00,13
308,472,780,42,15.3,1,Mostly Clear,13.0,2023-10-03 14:00:00,14
356,656,1012,46,14.5,1,Mostly Clear,10.1,2023-10-03 15:00:00,15
385,831,1216,50,13.5,1,Mostly Clear,8.9,2023-10-03 16:00:00,16
678,1507,2185,50,13.2,1,Mostly Clear,10.8,2023-10-03 17:00:00,17
632,1267,1899,52,12.5,1,Mostly Clear,10.0,2023-10-03 18:00:00,18
423,819,1242,55,12.0,1,Mostly Clear,10.4,2023-10-03 19:00:00,19
251,533,784,56,11.8,1,Mostly Clear,10.2,2023-10-03 20:00:00,20
191,418,609,55,12.4,1,Mostly Clear,7.0,2023-10-03 21:00:00,21
124,276,400,50,14.0,1,Mostly Clear,9.4,2023-10-03 22:00:00,22
72,133,205,41,16.5,1,Mostly Clear,9.9,2023-10-03 23:00:00,23
25,63,88,33,19.4,1,Mostly Clear,9.2,2023-10-04 00:00:00,0
5,33,38,28,21.5,0,Clear,7.9,2023-10-04 01:00:00,1
5,8,13,27,22.9,0,Clear,7.6,2023-10-04 02:00:00,2
4,11,15,25,23.4,0,Clear,6.6,2023-10-04 03:00:00,3
12,32,44,23,23.8,0,Clear,5.4,2023-10-04 04:00:00,4
34,89,123,23,24.0,0,Clear,2.3,2023-10-04 05:00:00,5
69,259,328,22,24.0,0,Clear,1.9,2023-10-04 06:00:00,6
192,714,906,33,22.9,0,Clear,3.1,2023-10-04 07:00:00,7
347,1218,1565,30,21.2,0,Clear,4.5,2023-10-04 08:00:00,8
218,637,855,29,20.0,0,Clear,10.5,2023-10-04 09:00:00,9
184,363,547,33,18.6,0,Clear,13.0,2023-10-04 10:00:00,10
197,391,588,40,17.7,0,Clear,13.7,2023-10-04 11:00:00,11
259,486,745,44,16.8,0,Clear,13.3,2023-10-04 12:00:00,12
280,529,809,44,15.8,1,Mostly Clear,12.2,2023-10-04 13:00:00,13
302,503,805,43,15.2,1,Mostly Clear,11.0,2023-10-04 14:00:00,14
321,652,973,47,14.5,1,Mostly Clear,9.7,2023-10-04 15:00:00,15
436,889,1325,51,13.8,1,Mostly Clear,9.8,2023-10-04 16:00:00,16
647,1528,2175,54,13.3,1,Mostly Clear,12.5,2023-10-04 17:00:00,17
559,1253,1812,56,12.9,1,Mostly Clear,10.7,2023-10-04 18:00:00,18
405,854,1259,60,12.6,1,Mostly Clear,9.1,2023-10-04 19:00:00,19
257,607,864,62,11.9,0,Clear,9.2,2023-10-04 20:00:00,20
223,475,698,57,13.0,0,Clear,6.8,2023-10-04 21:00:00,21
154,286,440,49,15.2,0,Clear,3.4,2023-10-04 22:00:00,22
72,175,247,40,18.0,0,Clear,3.8,2023-10-04 23:00:00,23
44,54,98,31,20.6,0,Clear,5.4,2023-10-05 00:00:00,0
18,29,47,24,22.7,0,Clear,8.0,2023-10-05 01:00:00,1
5,20,25,20,23.9,0,Clear,6.9,2023-10-05 02:00:00,2
6,14,20,18,24.6,0,Clear,4.0,2023-10-05 03:00:00,3
7,16,23,16,25.0,0,Clear,1.5,2023-10-05 04:00:00,4
31,82,113,16,25.1,0,Clear,2.0,2023-10-05 05:00:00,5
76,251,327,16,25.0,0,Clear,4.1,2023-10-05 06:00:00,6
205,638,843,14,24.8,0,Clear,1.1,2023-10-05 07:00:00,7
289,1121,1410,15,24.1,0,Clear,2.9,2023-10-05 08:00:00,8
252,637,889,20,21.2,0,Clear,7.7,2023-10-05 09:00:00,9
238,386,624,21,20.2,1,Mostly Clear,10.1,2023-10-05 10:00:00,10
195,378,573,27,18.7,1,Mostly Clear,11.3,2023-10-05 11:00:00,11
295,485,780,34,17.9,1,Mostly Clear,11.9,2023-10-05 12:00:00,12
285,483,768,37,17.2,1,Mostly Clear,11.8,2023-10-05 13:00:00,13
302,489,791,39,16.0,1,Mostly Clear,10.2,2023-10-05 14:00:00,14
341,650,991,40,15.2,1,Mostly Clear,8.5,2023-10-05 15:00:00,15
444,837,1281,44,14.5,1,Mostly Clear,9.7,2023-10-05 16:00:00,16
693,1380,2073,46,14.3,1,Mostly Clear,9.8,2023-10-05 17:00:00,17
550,1155,1705,47,13.7,1,Mostly Clear,10.8,2023-10-05 18:00:00,18
412,819,1231,50,12.1,2,Partly Cloudy,10.3,2023-10-05 19:00:00,19
253,521,774,53,11.1,1,Mostly Clear,9.3,2023-10-05 20:00:00,20
207,411,618,49,12.2,0,Clear,4.7,2023-10-05 21:00:00,21
165,321,486,43,14.3,0,Clear,2.2,2023-10-05 22:00:00,22
99,219,318,36,16.8,0,Clear,4.4,2023-10-05 23:00:00,23
73,136,209,30,19.0,0,Clear,3.6,2023-10-06 00:00:00,0
26,54,80,26,20.9,1,Mostly Clear,3.0,2023-10-06 01:00:00,1
10,32,42,23,22.7,1,Mostly Clear,5.4,2023-10-06 02:00:00,2
11,14,25,21,23.7,1,Mostly Clear,6.0,2023-10-06 03:00:00,3
9,25,34,20,24.2,1,Mostly Clear,7.1,2023-10-06 04:00:00,4
29,66,95,19,24.4,1,Mostly Clear,7.4,2023-10-06 05:00:00,5
70,202,272,19,24.2,1,Mostly Clear,11.8,2023-10-06 06:00:00,6
132,491,623,19,23.7,1,Mostly Clear,14.8,2023-10-06 07:00:00,7
237,698,935,21,22.2,2,Partly Cloudy,18.5,2023-10-06 08:00:00,8
249,532,781,22,21.5,2,Partly Cloudy,13.4,2023-10-06 09:00:00,9
216,390,606,24,21.0,3,Cloudy,10.9,2023-10-06 10:00:00,10
261,444,705,26,20.5,3,Cloudy,10.5,2023-10-06 11:00:00,11
341,531,872,28,19.7,3,Cloudy,11.6,2023-10-06 12:00:00,12
423,562,985,30,19.1,1,Mostly Clear,19.7,2023-10-06 13:00:00,13
423,573,996,35,18.0,2,Partly Cloudy,19.9,2023-10-06 14:00:00,14
443,768,1211,41,16.5,1,Mostly Clear,19.2,2023-10-06 15:00:00,15
479,873,1352,45,15.6,2,Partly Cloudy,14.0,2023-10-06 16:00:00,16
612,985,1597,46,15.4,2,Partly Cloudy,14.2,2023-10-06 17:00:00,17
574,896,1470,48,15.6,2,Partly Cloudy,14.6,2023-10-06 18:00:00,18
392,680,1072,46,16.5,2,Partly Cloudy,15.8,2023-10-06 19:00:00,19
331,494,825,50,16.1,1,Mostly Clear,18.7,2023-10-06 20:00:00,20
273,349,622,52,15.8,0,Clear,17.1,2023-10-06 21:00:00,21
203,341,544,50,17.0,1,Mostly Clear,14.7,2023-10-06 22:00:00,22
167,290,457,43,18.4,1,Mostly Clear,15.8,2023-10-06 23:00:00,23
160,217,377,37,19.7,0,Clear,13.9,2023-10-07 00:00:00,0
120,136,256,32,20.9,0,Clear,10.9,2023-10-07 01:00:00,1
81,98,179,29,22.0,0,Clear,10.1,2023-10-07 02:00:00,2
39,31,70,26,22.7,0,Clear,10.0,2023-10-07 03:00:00,3
18,24,42,24,23.2,0,Clear,7.8,2023-10-07 04:00:00,4
14,29,43,23,23.4,0,Clear,4.0,2023-10-07 05:00:00,5
45,106,151,22,23.4,0,Clear,5.5,2023-10-07 06:00:00,6
100,162,262,21,23.4,0,Clear,5.7,2023-10-07 07:00:00,7
109,232,341,24,21.9,0,Clear,7.9,2023-10-07 08:00:00,8
127,287,414,26,20.8,1,Mostly Clear,10.1,2023-10-07 09:00:00,9
181,327,508,28,19.6,0,Clear,9.5,2023-10-07 10:00:00,10
163,276,439,30,18.6,0,Clear,10.0,2023-10-07 11:00:00,11
352,493,845,33,17.3,0,Clear,11.0,2023-10-07 12:00:00,12
461,669,1130,36,16.3,0,Clear,11.7,2023-10-07 13:00:00,13
655,637,1292,40,15.2,0,Clear,10.3,2023-10-07 14:00:00,14
645,815,1460,43,14.3,0,Clear,9.8,2023-10-07 15:00:00,15
742,746,1488,49,12.9,0,Clear,6.1,2023-10-07 16:00:00,16
609,745,1354,44,14.3,0,Clear,3.3,2023-10-07 17:00:00,17
498,628,1126,51,12.4,0,Clear,6.2,2023-10-07 18:00:00,18
339,470,809,54,12.0,0,Clear,14.1,2023-10-07 19:00:00,19
240,324,564,56,11.6,0,Clear,12.5,2023-10-07 20:00:00,20
222,282,504,52,12.7,0,Clear,9.5,2023-10-07 21:00:00,21
181,283,464,45,15.1,0,Clear,5.0,2023-10-07 22:00:00,22
175,236,411,39,17.3,0,Clear,2.6,2023-10-07 23:00:00,23
104,161,265,35,18.8,0,Clear,3.8,2023-10-08 00:00:00,0
79,111,190,31,20.2,0,Clear,4.4,2023-10-08 01:00:00,1
65,76,141,27,21.6,0,Clear,6.2,2023-10-08 02:00:00,2
29,31,60,24,22.7,0,Clear,8.5,2023-10-08 03:00:00,3
11,21,32,22,23.4,0,Clear,8.9,2023-10-08 04:00:00,4
17,27,44,22,23.6,0,Clear,7.1,2023-10-08 05:00:00,5
42,64,106,22,23.5,0,Clear,5.7,2023-10-08 06:00:00,6
59,119,178,22,23.5,0,Clear,1.0,2023-10-08 07:00:00,7
149,230,379,25,22.3,0,Clear,2.3,2023-10-08 08:00:00,8
300,382,682,27,20.5,0,Clear,9.1,2023-10-08 09:00:00,9
510,472,982,31,19.0,0,Clear,7.2,2023-10-08 10:00:00,10
554,604,1158,33,18.1,0,Clear,6.1,2023-10-08 11:00:00,11
543,633,1176,35,17.4,0,Clear,6.6,2023-10-08 12:00:00,12
563,691,1254,33,17.7,0,Clear,4.7,2023-10-08 13:00:00,13
616,602,1218,39,15.4,1,Mostly Clear,7.6,2023-10-08 14:00:00,14
633,681,1314,42,14.8,1,Mostly Clear,14.4,2023-10-08 15:00:00,15
559,592,1151,45,14.4,2,Partly Cloudy,14.2,2023-10-08 16:00:00,16
434,560,994,52,14.0,1,Mostly Clear,13.0,2023-10-08 17:00:00,17
377,455,832,56,13.3,1,Mostly Clear,10.4,2023-10-08 18:00:00,18
238,377,615,59,13.4,1,Mostly Clear,14.6,2023-10-08 19:00:00,19
156,249,405,59,13.0,2,Partly Cloudy,10.9,2023-10-08 20:00:00,20
120,219,339,57,13.6,2,Partly Cloudy,8.4,2023-10-08 21:00:00,21
115,214,329,52,15.0,3,Cloudy,7.4,2023-10-08 22:00:00,22
66,123,189,46,16.8,3,Cloudy,9.4,2023-10-08 23:00:00,23
36,74,110,41,18.5,3,Cloudy,9.0,2023-10-09 00:00:00,0
21,30,51,37,19.4,3,Cloudy,8.3,2023-10-09 01:00:00,1
9,15,24,33,20.4,3,Cloudy,9.9,2023-10-09 02:00:00,2
9,15,24,30,20.9,3,Cloudy,9.2,2023-10-09 03:00:00,3
7,12,19,29,21.1,2,Partly Cloudy,8.3,2023-10-09 04:00:00,4
16,47,63,28,21.4,2,Partly Cloudy,9.4,2023-10-09 05:00:00,5
46,137,183,28,21.3,2,Partly Cloudy,13.7,2023-10-09 06:00:00,6
87,249,336,25,21.5,2,Partly Cloudy,11.2,2023-10-09 07:00:00,7
149,407,556,29,19.9,3,Cloudy,6.8,2023-10-09 08:00:00,8
188,383,571,31,19.2,3,Cloudy,5.6,2023-10-09 09:00:00,9
244,413,657,38,18.4,3,Cloudy,14.9,2023-10-09 10:00:00,10
301,473,774,42,17.7,3,Cloudy,17.4,2023-10-09 11:00:00,11
329,575,904,46,16.9,3,Cloudy,22.4,2023-10-09 12:00:00,12
393,596,989,52,16.0,2,Partly Cloudy,26.0,2023-10-09 13:00:00,13
411,597,1008,54,15.5,2,Partly Cloudy,23.1,2023-10-09 14:00:00,14
411,657,1068,58,14.6,1,Mostly Clear,20.1,2023-10-09 15:00:00,15
415,695,1110,64,13.9,3,Cloudy,19.8,2023-10-09 16:00:00,16
504,826,1330,67,13.3,2,Partly Cloudy,19.5,2023-10-09 17:00:00,17
313,750,1063,67,13.1,3,Cloudy,18.5,2023-10-09 18:00:00,18
212,472,684,65,14.0,3,Cloudy,18.1,2023-10-09 19:00:00,19
162,360,522,65,13.8,2,Partly Cloudy,20.0,2023-10-09 20:00:00,20
102,297,399,62,14.2,3,Cloudy,22.7,2023-10-09 21:00:00,21
84,174,258,58,15.1,3,Cloudy,19.4,2023-10-09 22:00:00,22
58,130,188,52,16.3,3,Cloudy,19.1,2023-10-09 23:00:00,23
23,54,77,45,17.7,3,Cloudy,19.5,2023-10-10 00:00:00,0
12,24,36,40,18.6,3,Cloudy,17.1,2023-10-10 01:00:00,1
2,16,18,34,19.7,3,Cloudy,9.0,2023-10-10 02:00:00,2
2,8,10,32,20.1,1,Mostly Clear,4.1,2023-10-10 03:00:00,3
7,16,23,31,20.4,1,Mostly Clear,3.7,2023-10-10 04:00:00,4
29,84,113,30,20.7,0,Clear,3.2,2023-10-10 05:00:00,5
79,276,355,29,20.8,0,Clear,3.3,2023-10-10 06:00:00,6
184,643,827,26,21.3,0,Clear,5.7,2023-10-10 07:00:00,7
309,1137,1446,29,19.7,0,Clear,8.1,2023-10-10 08:00:00,8
226,596,822,33,18.4,0,Clear,7.6,2023-10-10 09:00:00,9
168,330,498,34,17.6,0,Clear,10.5,2023-10-10 10:00:00,10
178,387,565,36,16.8,0,Clear,11.5,2023-10-10 11:00:00,11
223,429,652,39,16.0,0,Clear,10.8,2023-10-10 12:00:00,12
237,438,675,43,14.7,0,Clear,10.1,2023-10-10 13:00:00,13
239,457,696,48,13.4,0,Clear,8.6,2023-10-10 14:00:00,14
320,652,972,52,12.4,0,Clear,7.2,2023-10-10 15:00:00,15
386,873,1259,47,13.7,0,Clear,2.9,2023-10-10 16:00:00,16
569,1427,1996,53,12.2,0,Clear,5.0,2023-10-10 17:00:00,17
516,1140,1656,60,10.5,0,Clear,6.6,2023-10-10 18:00:00,18
321,753,1074,56,12.1,0,Clear,4.1,2023-10-10 19:00:00,19
216,539,755,61,11.2,0,Clear,3.3,2023-10-10 20:00:00,20
179,392,571,70,9.8,0,Clear,3.8,2023-10-10 21:00:00,21
135,266,401,60,12.0,0,Clear,2.5,2023-10-10 22:00:00,22
77,136,213,49,15.1,0,Clear,6.8,2023-10-10 23:00:00,23
39,62,101,41,17.6,0,Clear,6.0,2023-10-11 00:00:00,0
19,23,42,34,19.7,0,Clear,4.5,2023-10-11 01:00:00,1
6,9,15,29,21.7,0,Clear,7.1,2023-10-11 02:00:00,2
8,6,14,25,22.8,0,Clear,7.0,2023-10-11 03:00:00,3
8,14,22,23,23.6,1,Mostly Clear,7.9,2023-10-11 04:00:00,4
30,77,107,22,24.0,1,Mostly Clear,9.1,2023-10-11 05:00:00,5
70,238,308,23,23.7,1,Mostly Clear,13.6,2023-10-11 06:00:00,6
167,661,828,25,22.7,0,Clear,17.1,2023-10-11 07:00:00,7
291,1136,1427,27,21.0,0,Clear,16.5,2023-10-11 08:00:00,8
241,623,864,29,19.8,0,Clear,14.4,2023-10-11 09:00:00,9
181,386,567,31,18.7,0,Clear,11.2,2023-10-11 10:00:00,10
221,418,639,34,17.4,0,Clear,9.7,2023-10-11 11:00:00,11
266,528,794,37,16.2,0,Clear,10.1,2023-10-11 12:00:00,12
249,475,724,42,14.9,0,Clear,8.2,2023-10-11 13:00:00,13
313,467,780,44,14.3,0,Clear,4.8,2023-10-11 14:00:00,14
361,680,1041,42,14.8,0,Clear,2.4,2023-10-11 15:00:00,15
420,925,1345,44,14.1,0,Clear,2.1,2023-10-11 16:00:00,16
633,1432,2065,54,11.3,0,Clear,6.7,2023-10-11 17:00:00,17
540,1221,1761,57,10.2,0,Clear,7.3,2023-10-11 18:00:00,18
343,809,1152,58,10.7,0,Clear,6.5,2023-10-11 19:00:00,19
238,509,747,60,10.0,0,Clear,6.3,2023-10-11 20:00:00,20
213,414,627,59,10.4,0,Clear,7.4,2023-10-11 21:00:00,21
158,314,472,53,12.5,0,Clear,7.1,2023-10-11 22:00:00,22
78,182,260,43,15.8,0,Clear,7.4,2023-10-11 23:00:00,23
46,57,103,33,18.7,0,Clear,8.5,2023-10-12 00:00:00,0
23,31,54,27,20.9,0,Clear,8.0,2023-10-12 01:00:00,1
6,12,18,23,22.3,0,Clear,8.0,2023-10-12 02:00:00,2
6,15,21,20,23.2,0,Clear,7.7,2023-10-12 03:00:00,3
4,18,22,19,23.7,0,Clear,7.8,2023-10-12 04:00:00,4
32,87,119,19,23.8,0,Clear,7.5,2023-10-12 05:00:00,5
67,245,312,19,23.6,0,Clear,5.8,2023-10-12 06:00:00,6
150,589,739,21,22.5,0,Clear,5.4,2023-10-12 07:00:00,7
336,1071,1407,23,20.7,0,Clear,7.6,2023-10-12 08:00:00,8
292,644,936,26,19.7,0,Clear,11.4,2023-10-12 09:00:00,9
224,435,659,29,18.2,0,Clear,9.4,2023-10-12 10:00:00,10
234,359,593,33,17.0,0,Clear,8.6,2023-10-12 11:00:00,11
311,460,771,37,15.8,0,Clear,6.9,2023-10-12 12:00:00,12
306,473,779,39,15.9,0,Clear,4.3,2023-10-12 13:00:00,13
357,493,850,45,13.9,0,Clear,6.0,2023-10-12 14:00:00,14
431,653,1084,45,13.2,0,Clear,5.6,2023-10-12 15:00:00,15
503,866,1369,47,12.3,0,Clear,6.0,2023-10-12 16:00:00,16
689,1398,2087,48,12.0,0,Clear,4.3,2023-10-12 17:00:00,17
624,1176,1800,47,12.2,0,Clear,3.1,2023-10-12 18:00:00,18
436,814,1250,62,9.3,0,Clear,8.1,2023-10-12 19:00:00,19
295,547,842,67,8.2,0,Clear,7.5,2023-10-12 20:00:00,20
241,393,634,60,9.5,0,Clear,6.1,2023-10-12 21:00:00,21
184,321,505,49,12.1,1,Mostly Clear,5.1,2023-10-12 22:00:00,22
145,238,383,39,15.1,1,Mostly Clear,7.8,2023-10-12 23:00:00,23
81,108,189,32,17.4,1,Mostly Clear,7.2,2023-10-13 00:00:00,0
32,57,89,27,19.5,0,Clear,5.4,2023-10-13 01:00:00,1
13,38,51,24,21.2,0,Clear,5.4,2023-10-13 02:00:00,2
12,18,30,21,22.6,0,Clear,6.5,2023-10-13 03:00:00,3
8,28,36,19,23.5,0,Clear,7.9,2023-10-13 04:00:00,4
33,57,90,17,23.9,1,Mostly Clear,10.5,2023-10-13 05:00:00,5
75,202,277,16,23.6,1,Mostly Clear,14.1,2023-10-13 06:00:00,6
134,472,606,15,22.4,1,Mostly Clear,15.5,2023-10-13 07:00:00,7
243,772,1015,17,20.8,0,Clear,13.7,2023-10-13 08:00:00,8
259,547,806,19,19.7,1,Mostly Clear,14.5,2023-10-13 09:00:00,9
316,430,746,21,18.6,1,Mostly Clear,16.7,2023-10-13 10:00:00,10
345,506,851,22,18.1,1,Mostly Clear,13.6,2023-10-13 11:00:00,11
380,550,930,24,17.1,1,Mostly Clear,14.1,2023-10-13 12:00:00,12
469,544,1013,25,17.5,1,Mostly Clear,26.1,2023-10-13 13:00:00,13
462,554,1016,26,16.9,1,Mostly Clear,12.0,2023-10-13 14:00:00,14
579,778,1357,33,14.0,1,Mostly Clear,7.2,2023-10-13 15:00:00,15
560,866,1426,34,13.0,1,Mostly Clear,6.9,2023-10-13 16:00:00,16
707,1096,1803,35,12.5,1,Mostly Clear,7.0,2023-10-13 17:00:00,17
605,941,1546,38,12.3,1,Mostly Clear,10.4,2023-10-13 18:00:00,18
501,726,1227,49,12.1,1,Mostly Clear,12.4,2023-10-13 19:00:00,19
336,464,800,52,11.7,1,Mostly Clear,12.6,2023-10-13 20:00:00,20
228,356,584,48,12.2,1,Mostly Clear,14.5,2023-10-13 21:00:00,21
244,354,598,41,13.8,1,Mostly Clear,12.5,2023-10-13 22:00:00,22
178,281,459,34,16.1,0,Clear,14.3,2023-10-13 23:00:00,23
148,202,350,27,18.5,0,Clear,10.4,2023-10-14 00:00:00,0
109,142,251,25,19.7,0,Clear,6.0,2023-10-14 01:00:00,1
76,80,156,22,20.9,0,Clear,6.6,2023-10-14 02:00:00,2
37,37,74,20,21.7,0,Clear,6.5,2023-10-14 03:00:00,3
15,28,43,19,22.2,0,Clear,6.3,2023-10-14 04:00:00,4
9,31,40,19,22.2,0,Clear,5.6,2023-10-14 05:00:00,5
28,67,95,19,21.9,0,Clear,4.8,2023-10-14 06:00:00,6
69,126,195,19,21.5,0,Clear,6.2,2023-10-14 07:00:00,7
90,154,244,22,20.2,0,Clear,5.6,2023-10-14 08:00:00,8
123,263,386,22,19.1,0,Clear,11.2,2023-10-14 09:00:00,9
180,334,514,27,17.6,0,Clear,13.2,2023-10-14 10:00:00,10
173,320,493,32,16.0,0,Clear,11.0,2023-10-14 11:00:00,11
129,222,351,35,14.8,0,Clear,9.4,2023-10-14 12:00:00,12
115,245,360,36,13.7,0,Clear,7.7,2023-10-14 13:00:00,13
158,302,460,36,13.5,0,Clear,11.0,2023-10-14 14:00:00,14
174,344,518,39,12.0,0,Clear,9.0,2023-10-14 15:00:00,15
304,437,741,42,10.7,0,Clear,7.9,2023-10-14 16:00:00,16
276,459,735,30,10.3,0,Clear,10.7,2023-10-14 17:00:00,17
238,430,668,24,9.8,0,Clear,11.4,2023-10-14 18:00:00,18
200,351,551,34,9.8,0,Clear,13.2,2023-10-14 19:00:00,19
101,184,285,35,9.3,0,Clear,14.0,2023-10-14 20:00:00,20
39,111,150,32,10.0,0,Clear,11.2,2023-10-14 21:00:00,21
72,146,218,27,12.3,0,Clear,8.7,2023-10-14 22:00:00,22
84,168,252,23,15.1,0,Clear,10.0,2023-10-14 23:00:00,23
62,108,170,19,17.9,0,Clear,10.2,2023-10-15 00:00:00,0
72,82,154,19,19.7,0,Clear,8.6,2023-10-15 01:00:00,1
35,67,102,18,21.0,0,Clear,6.9,2023-10-15 02:00:00,2
18,26,44,17,21.9,0,Clear,6.6,2023-10-15 03:00:00,3
12,18,30,15,22.6,0,Clear,5.7,2023-10-15 04:00:00,4
7,19,26,15,22.7,1,Mostly Clear,4.6,2023-10-15 05:00:00,5
19,52,71,15,22.4,1,Mostly Clear,3.1,2023-10-15 06:00:00,6
66,122,188,14,22.1,0,Clear,3.4,2023-10-15 07:00:00,7
116,265,381,17,19.4,0,Clear,8.4,2023-10-15 08:00:00,8
246,406,652,17,18.8,1,Mostly Clear,12.6,2023-10-15 09:00:00,9
370,552,922,24,17.4,0,Clear,14.2,2023-10-15 10:00:00,10
471,628,1099,30,15.6,1,Mostly Clear,9.7,2023-10-15 11:00:00,11
578,643,1221,35,14.1,1,Mostly Clear,7.8,2023-10-15 12:00:00,12
544,690,1234,36,13.4,1,Mostly Clear,9.4,2023-10-15 13:00:00,13
554,676,1230,37,13.0,1,Mostly Clear,11.4,2023-10-15 14:00:00,14
527,675,1202,39,12.5,1,Mostly Clear,15.7,2023-10-15 15:00:00,15
527,668,1195,41,12.3,1,Mostly Clear,13.7,2023-10-15 16:00:00,16
443,581,1024,45,11.2,1,Mostly Clear,7.6,2023-10-15 17:00:00,17
349,540,889,42,12.3,1,Mostly Clear,3.0,2023-10-15 18:00:00,18
243,471,714,50,10.5,1,Mostly Clear,6.8,2023-10-15 19:00:00,19
154,278,432,47,11.6,2,Partly Cloudy,4.1,2023-10-15 20:00:00,20
101,229,330,51,10.7,2,Partly Cloudy,3.3,2023-10-15 21:00:00,21
120,160,280,45,12.6,3,Cloudy,7.4,2023-10-15 22:00:00,22
52,112,164,41,14.1,3,Cloudy,9.3,2023-10-15 23:00:00,23
30,60,90,37,15.6,3,Cloudy,10.9,2023-10-16 00:00:00,0
8,16,24,33,17.6,2,Partly Cloudy,12.7,2023-10-16 01:00:00,1
10,10,20,30,19.2,1,Mostly Clear,14.6,2023-10-16 02:00:00,2
7,11,18,26,20.6,1,Mostly Clear,15.8,2023-10-16 03:00:00,3
5,22,27,23,21.2,2,Partly Cloudy,15.9,2023-10-16 04:00:00,4
25,53,78,22,21.3,1,Mostly Clear,16.0,2023-10-16 05:00:00,5
64,204,268,22,21.0,1,Mostly Clear,16.6,2023-10-16 06:00:00,6
144,526,670,23,20.2,1,Mostly Clear,14.4,2023-10-16 07:00:00,7
237,949,1186,26,18.6,1,Mostly Clear,13.0,2023-10-16 08:00:00,8
187,524,711,28,17.4,1,Mostly Clear,12.0,2023-10-16 09:00:00,9
157,327,484,29,16.8,2,Partly Cloudy,12.8,2023-10-16 10:00:00,10
193,386,579,31,15.8,3,Cloudy,11.9,2023-10-16 11:00:00,11
249,479,728,33,14.9,3,Cloudy,11.9,2023-10-16 12:00:00,12
286,447,733,35,14.3,1,Mostly Clear,10.7,2023-10-16 13:00:00,13
237,445,682,36,14.3,2,Partly Cloudy,2.9,2023-10-16 14:00:00,14
341,595,936,40,12.9,3,Cloudy,4.3,2023-10-16 15:00:00,15
391,720,1111,40,12.5,3,Cloudy,9.0,2023-10-16 16:00:00,16
478,1205,1683,41,12.3,3,Cloudy,8.4,2023-10-16 17:00:00,17
437,951,1388,41,12.5,3,Cloudy,12.0,2023-10-16 18:00:00,18
269,640,909,43,12.6,3,Cloudy,12.2,2023-10-16 19:00:00,19
172,440,612,44,12.4,3,Cloudy,14.5,2023-10-16 20:00:00,20
132,327,459,44,12.3,3,Cloudy,9.0,2023-10-16 21:00:00,21
114,240,354,41,13.2,3,Cloudy,11.1,2023-10-16 22:00:00,22
43,89,132,38,14.2,3,Cloudy,12.5,2023-10-16 23:00:00,23
22,47,69,34,15.6,3,Cloudy,14.7,2023-10-17 00:00:00,0
7,19,26,31,16.9,3,Cloudy,15.1,2023-10-17 01:00:00,1
5,15,20,29,18.3,3,Cloudy,13.7,2023-10-17 02:00:00,2
6,2,8,27,18.7,3,Cloudy,13.8,2023-10-17 03:00:00,3
2,20,22,27,18.8,3,Cloudy,14.1,2023-10-17 04:00:00,4
21,63,84,25,19.5,2,Partly Cloudy,16.3,2023-10-17 05:00:00,5
83,238,321,24,19.4,3,Cloudy,20.8,2023-10-17 06:00:00,6
172,628,800,26,19.2,2,Partly Cloudy,18.8,2023-10-17 07:00:00,7
310,1224,1534,29,17.9,1,Mostly Clear,17.1,2023-10-17 08:00:00,8
223,674,897,31,17.1,2,Partly Cloudy,19.5,2023-10-17 09:00:00,9
179,378,557,33,16.5,1,Mostly Clear,17.5,2023-10-17 10:00:00,10
205,348,553,36,15.1,1,Mostly Clear,12.4,2023-10-17 11:00:00,11
221,438,659,39,14.1,2,Partly Cloudy,9.2,2023-10-17 12:00:00,12
226,413,639,38,14.5,2,Partly Cloudy,12.3,2023-10-17 13:00:00,13
268,440,708,37,14.1,2,Partly Cloudy,13.7,2023-10-17 14:00:00,14
319,649,968,36,13.3,1,Mostly Clear,12.6,2023-10-17 15:00:00,15
374,859,1233,38,12.5,1,Mostly Clear,12.8,2023-10-17 16:00:00,16
532,1351,1883,40,11.9,0,Clear,13.6,2023-10-17 17:00:00,17
540,1146,1686,44,10.4,1,Mostly Clear,13.3,2023-10-17 18:00:00,18
347,728,1075,41,10.8,3,Cloudy,13.7,2023-10-17 19:00:00,19
219,500,719,43,10.3,1,Mostly Clear,16.7,2023-10-17 20:00:00,20
160,367,527,45,10.2,2,Partly Cloudy,15.9,2023-10-17 21:00:00,21
156,278,434,42,11.7,3,Cloudy,11.2,2023-10-17 22:00:00,22
72,150,222,36,14.0,3,Cloudy,13.0,2023-10-17 23:00:00,23
32,68,100,28,16.0,3,Cloudy,14.9,2023-10-18 00:00:00,0
21,20,41,24,17.6,2,Partly Cloudy,15.0,2023-10-18 01:00:00,1
12,14,26,21,18.8,1,Mostly Clear,15.2,2023-10-18 02:00:00,2
3,15,18,19,19.5,1,Mostly Clear,15.1,2023-10-18 03:00:00,3
4,13,17,17,19.8,1,Mostly Clear,16.1,2023-10-18 04:00:00,4
24,72,96,17,19.8,0,Clear,18.0,2023-10-18 05:00:00,5
64,234,298,18,19.2,0,Clear,19.5,2023-10-18 06:00:00,6
169,618,787,20,18.3,0,Clear,19.0,2023-10-18 07:00:00,7
322,1211,1533,22,16.8,0,Clear,18.7,2023-10-18 08:00:00,8
233,645,878,24,15.6,0,Clear,18.2,2023-10-18 09:00:00,9
188,357,545,26,14.5,0,Clear,15.2,2023-10-18 10:00:00,10
174,440,614,28,13.6,0,Clear,12.9,2023-10-18 11:00:00,11
264,544,808,30,12.6,0,Clear,11.7,2023-10-18 12:00:00,12
273,496,769,35,11.2,0,Clear,10.5,2023-10-18 13:00:00,13
311,507,818,38,9.9,0,Clear,9.1,2023-10-18 14:00:00,14
330,657,987,41,9.1,0,Clear,9.5,2023-10-18 15:00:00,15
433,923,1356,43,8.4,0,Clear,9.7,2023-10-18 16:00:00,16
606,1310,1916,45,7.8,0,Clear,9.5,2023-10-18 17:00:00,17
514,1079,1593,49,6.9,0,Clear,9.2,2023-10-18 18:00:00,18
357,780,1137,55,5.9,0,Clear,8.3,2023-10-18 19:00:00,19
195,542,737,49,7.4,0,Clear,3.0,2023-10-18 20:00:00,20
181,439,620,52,6.6,1,Mostly Clear,4.3,2023-10-18 21:00:00,21
150,333,483,45,9.0,1,Mostly Clear,4.6,2023-10-18 22:00:00,22
85,151,236,36,11.6,0,Clear,3.6,2023-10-18 23:00:00,23
37,70,107,30,13.7,0,Clear,3.6,2023-10-19 00:00:00,0
12,26,38,25,15.9,0,Clear,3.6,2023-10-19 01:00:00,1
4,14,18,19,18.0,1,Mostly Clear,6.0,2023-10-19 02:00:00,2
6,7,13,16,19.2,1,Mostly Clear,8.2,2023-10-19 03:00:00,3
6,19,25,15,19.9,1,Mostly Clear,10.5,2023-10-19 04:00:00,4
28,70,98,15,20.0,1,Mostly Clear,14.6,2023-10-19 05:00:00,5
74,248,322,16,19.2,1,Mostly Clear,18.5,2023-10-19 06:00:00,6
168,552,720,16,18.5,1,Mostly Clear,16.4,2023-10-19 07:00:00,7
321,1109,1430,17,17.3,1,Mostly Clear,15.0,2023-10-19 08:00:00,8
226,613,839,18,16.1,1,Mostly Clear,15.0,2023-10-19 09:00:00,9
210,407,617,20,15.0,1,Mostly Clear,14.3,2023-10-19 10:00:00,10
255,393,648,21,14.1,1,Mostly Clear,14.6,2023-10-19 11:00:00,11
293,488,781,23,13.0,0,Clear,13.2,2023-10-19 12:00:00,12
343,508,851,24,11.5,0,Clear,11.0,2023-10-19 13:00:00,13
366,520,886,25,10.1,0,Clear,10.4,2023-10-19 14:00:00,14
408,701,1109,27,9.3,1,Mostly Clear,9.8,2023-10-19 15:00:00,15
482,826,1308,29,8.4,1,Mostly Clear,9.0,2023-10-19 16:00:00,16
709,1359,2068,33,7.8,0,Clear,8.2,2023-10-19 17:00:00,17
580,1203,1783,35,7.4,0,Clear,5.8,2023-10-19 18:00:00,18
406,784,1190,36,7.9,2,Partly Cloudy,6.4,2023-10-19 19:00:00,19
238,565,803,35,7.3,2,Partly Cloudy,7.3,2023-10-19 20:00:00,20
205,407,612,31,8.1,2,Partly Cloudy,9.4,2023-10-19 21:00:00,21
166,335,501,26,9.7,1,Mostly Clear,8.4,2023-10-19 22:00:00,22
146,242,388,23,11.5,2,Partly Cloudy,5.5,2023-10-19 23:00:00,23
48,93,141,19,13.4,1,Mostly Clear,4.0,2023-10-20 00:00:00,0
31,55,86,16,15.4,0,Clear,2.8,2023-10-20 01:00:00,1
18,20,38,13,17.1,0,Clear,4.1,2023-10-20 02:00:00,2
10,17,27,13,18.3,0,Clear,6.2,2023-10-20 03:00:00,3
5,23,28,14,18.9,0,Clear,6.3,2023-10-20 04:00:00,4
36,68,104,15,19.2,0,Clear,8.4,2023-10-20 05:00:00,5
67,201,268,16,18.8,0,Clear,12.6,2023-10-20 06:00:00,6
136,445,581,19,17.6,0,Clear,14.8,2023-10-20 07:00:00,7
239,710,949,21,16.3,0,Clear,15.3,2023-10-20 08:00:00,8
239,582,821,24,15.0,1,Mostly Clear,13.4,2023-10-20 09:00:00,9
232,417,649,26,13.8,1,Mostly Clear,12.4,2023-10-20 10:00:00,10
346,470,816,30,12.7,1,Mostly Clear,11.8,2023-10-20 11:00:00,11
365,594,959,34,11.6,0,Clear,10.5,2023-10-20 12:00:00,12
420,614,1034,39,10.4,0,Clear,10.2,2023-10-20 13:00:00,13
338,569,907,40,9.4,0,Clear,9.1,2023-10-20 14:00:00,14
217,404,621,40,8.7,0,Clear,9.4,2023-10-20 15:00:00,15
299,617,916,43,7.8,0,Clear,9.4,2023-10-20 16:00:00,16
428,824,1252,45,7.0,0,Clear,9.4,2023-10-20 17:00:00,17
332,580,912,46,6.1,0,Clear,9.2,2023-10-20 18:00:00,18
242,437,679,54,4.8,0,Clear,7.9,2023-10-20 19:00:00,19
170,293,463,57,4.0,0,Clear,7.6,2023-10-20 20:00:00,20
176,281,457,54,5.1,0,Clear,7.2,2023-10-20 21:00:00,21
140,273,413,48,7.4,0,Clear,4.8,2023-10-20 22:00:00,22
162,215,377,39,10.7,0,Clear,4.0,2023-10-20 23:00:00,23
129,179,308,31,13.4,0,Clear,3.3,2023-10-21 00:00:00,0
124,122,246,25,15.6,0,Clear,2.1,2023-10-21 01:00:00,1
95,100,195,21,17.4,0,Clear,1.5,2023-10-21 02:00:00,2
33,48,81,18,18.6,0,Clear,3.4,2023-10-21 03:00:00,3
8,27,35,16,19.4,0,Clear,6.9,2023-10-21 04:00:00,4
14,33,47,16,19.5,0,Clear,8.4,2023-10-21 05:00:00,5
51,74,125,17,19.2,0,Clear,7.6,2023-10-21 06:00:00,6
87,176,263,20,17.9,0,Clear,7.1,2023-10-21 07:00:00,7
191,291,482,21,17.2,0,Clear,15.6,2023-10-21 08:00:00,8
314,483,797,23,15.8,1,Mostly Clear,13.8,2023-10-21 09:00:00,9
476,545,1021,25,14.7,1,Mostly Clear,12.1,2023-10-21 10:00:00,10
565,702,1267,27,13.6,1,Mostly Clear,12.7,2023-10-21 11:00:00,11
704,701,1405,29,12.5,0,Clear,12.1,2023-10-21 12:00:00,12
661,632,1293,31,11.4,0,Clear,11.5,2023-10-21 13:00:00,13
659,692,1351,36,10.0,0,Clear,9.0,2023-10-21 14:00:00,14
767,743,1510,40,9.1,0,Clear,8.8,2023-10-21 15:00:00,15
665,694,1359,44,8.2,0,Clear,7.5,2023-10-21 16:00:00,16
652,744,1396,41,9.3,0,Clear,4.5,2023-10-21 17:00:00,17
508,600,1108,42,9.1,1,Mostly Clear,1.1,2023-10-21 18:00:00,18
383,485,868,47,7.5,0,Clear,3.6,2023-10-21 19:00:00,19
285,406,691,48,7.1,0,Clear,3.9,2023-10-21 20:00:00,20
226,299,525,53,5.3,0,Clear,6.4,2023-10-21 21:00:00,21
228,252,480,43,7.7,1,Mostly Clear,3.9,2023-10-21 22:00:00,22
206,290,496,33,10.7,1,Mostly Clear,0.5,2023-10-21 23:00:00,23
213,253,466,28,12.7,1,Mostly Clear,2.3,2023-10-22 00:00:00,0
151,167,318,22,15.0,1,Mostly Clear,4.7,2023-10-22 01:00:00,1
92,109,201,17,17.0,0,Clear,5.8,2023-10-22 02:00:00,2
45,47,92,15,18.4,0,Clear,6.7,2023-10-22 03:00:00,3
14,23,37,14,19.1,0,Clear,7.5,2023-10-22 04:00:00,4
15,26,41,14,19.3,1,Mostly Clear,6.5,2023-10-22 05:00:00,5
25,56,81,15,19.0,0,Clear,5.2,2023-10-22 06:00:00,6
34,93,127,17,17.5,2,Partly Cloudy,5.6,2023-10-22 07:00:00,7
113,216,329,17,17.0,2,Partly Cloudy,11.2,2023-10-22 08:00:00,8
221,359,580,20,15.7,1,Mostly Clear,12.3,2023-10-22 09:00:00,9
401,574,975,25,13.9,0,Clear,5.7,2023-10-22 10:00:00,10
465,577,1042,27,13.1,0,Clear,5.0,2023-10-22 11:00:00,11
525,659,1184,29,12.5,0,Clear,4.5,2023-10-22 12:00:00,12
572,730,1302,33,11.2,0,Clear,5.1,2023-10-22 13:00:00,13
525,696,1221,34,10.0,0,Clear,5.9,2023-10-22 14:00:00,14
554,713,1267,35,9.5,0,Clear,5.6,2023-10-22 15:00:00,15
586,615,1201,37,7.8,0,Clear,7.7,2023-10-22 16:00:00,16
541,649,1190,39,7.1,0,Clear,8.1,2023-10-22 17:00:00,17
360,647,1007,42,6.4,0,Clear,9.2,2023-10-22 18:00:00,18
196,439,635,43,6.5,0,Clear,5.2,2023-10-22 19:00:00,19
164,270,434,45,5.6,0,Clear,6.2,2023-10-22 20:00:00,20
125,245,370,52,5.5,0,Clear,7.3,2023-10-22 21:00:00,21
99,185,284,50,7.6,0,Clear,5.0,2023-10-22 22:00:00,22
82,126,208,41,10.9,0,Clear,5.4,2023-10-22 23:00:00,23
47,48,95,29,14.0,0,Clear,3.7,2023-10-23 00:00:00,0
11,20,31,23,16.5,0,Clear,3.5,2023-10-23 01:00:00,1
14,12,26,19,18.4,0,Clear,3.9,2023-10-23 02:00:00,2
7,10,17,17,19.6,0,Clear,3.3,2023-10-23 03:00:00,3
7,15,22,16,20.2,0,Clear,3.7,2023-10-23 04:00:00,4
20,61,81,16,20.3,0,Clear,6.5,2023-10-23 05:00:00,5
58,192,250,16,20.0,1,Mostly Clear,7.4,2023-10-23 06:00:00,6
128,570,698,20,18.1,1,Mostly Clear,5.6,2023-10-23 07:00:00,7
247,975,1222,19,18.4,1,Mostly Clear,3.1,2023-10-23 08:00:00,8
207,518,725,19,18.0,1,Mostly Clear,1.1,2023-10-23 09:00:00,9
161,303,464,20,17.6,2,Partly Cloudy,2.5,2023-10-23 10:00:00,10
169,387,556,26,14.9,2,Partly Cloudy,5.6,2023-10-23 11:00:00,11
202,469,671,29,14.3,2,Partly Cloudy,8.1,2023-10-23 12:00:00,12
223,518,741,31,12.7,3,Cloudy,6.8,2023-10-23 13:00:00,13
263,415,678,30,12.3,1,Mostly Clear,10.1,2023-10-23 14:00:00,14
330,619,949,35,11.8,1,Mostly Clear,10.2,2023-10-23 15:00:00,15
389,784,1173,39,11.0,0,Clear,11.8,2023-10-23 16:00:00,16
536,1306,1842,48,10.3,1,Mostly Clear,14.1,2023-10-23 17:00:00,17
434,1005,1439,51,10.0,1,Mostly Clear,12.8,2023-10-23 18:00:00,18
280,664,944,57,8.9,0,Clear,12.9,2023-10-23 19:00:00,19
185,446,631,56,9.3,0,Clear,14.5,2023-10-23 20:00:00,20
177,372,549,51,10.2,0,Clear,16.2,2023-10-23 21:00:00,21
109,223,332,42,12.6,0,Clear,13.3,2023-10-23 22:00:00,22
61,168,229,38,14.6,0,Clear,8.7,2023-10-23 23:00:00,23
21,44,65,35,16.3,0,Clear,9.0,2023-10-24 00:00:00,0
18,13,31,30,17.9,0,Clear,8.8,2023-10-24 01:00:00,1
12,14,26,26,19.1,0,Clear,8.4,2023-10-24 02:00:00,2
6,10,16,23,20.2,0,Clear,7.1,2023-10-24 03:00:00,3
3,16,19,22,20.8,0,Clear,6.9,2023-10-24 04:00:00,4
27,63,90,22,21.0,0,Clear,7.9,2023-10-24 05:00:00,5
71,234,305,21,20.8,0,Clear,7.4,2023-10-24 06:00:00,6
181,678,859,25,18.8,0,Clear,5.1,2023-10-24 07:00:00,7
319,1240,1559,23,18.2,0,Clear,13.4,2023-10-24 08:00:00,8
258,606,864,26,16.7,0,Clear,13.9,2023-10-24 09:00:00,9
169,360,529,29,15.3,0,Clear,11.8,2023-10-24 10:00:00,10
182,450,632,34,13.9,0,Clear,10.6,2023-10-24 11:00:00,11
254,507,761,38,12.5,0,Clear,9.7,2023-10-24 12:00:00,12
251,477,728,42,11.2,0,Clear,8.2,2023-10-24 13:00:00,13
277,488,765,45,10.2,0,Clear,8.4,2023-10-24 14:00:00,14
321,667,988,45,9.9,0,Clear,11.0,2023-10-24 15:00:00,15
415,935,1350,45,9.0,0,Clear,13.8,2023-10-24 16:00:00,16
695,1490,2185,49,8.2,0,Clear,11.8,2023-10-24 17:00:00,17
533,1237,1770,56,6.9,0,Clear,6.6,2023-10-24 18:00:00,18
365,792,1157,54,7.0,0,Clear,5.0,2023-10-24 19:00:00,19
238,599,837,55,6.8,0,Clear,5.1,2023-10-24 20:00:00,20
213,456,669,59,6.0,0,Clear,8.6,2023-10-24 21:00:00,21
172,349,521,51,8.4,0,Clear,6.9,2023-10-24 22:00:00,22
84,173,257,40,11.3,0,Clear,7.0,2023-10-24 23:00:00,23
47,77,124,32,13.6,0,Clear,6.4,2023-10-25 00:00:00,0
21,35,56,27,15.5,0,Clear,5.6,2023-10-25 01:00:00,1
10,9,19,23,17.1,0,Clear,6.2,2023-10-25 02:00:00,2
3,3,6,21,18.4,0,Clear,7.1,2023-10-25 03:00:00,3
8,15,23,20,19.4,0,Clear,7.6,2023-10-25 04:00:00,4
36,63,99,19,19.8,0,Clear,7.1,2023-10-25 05:00:00,5
57,269,326,19,19.5,0,Clear,6.6,2023-10-25 06:00:00,6
173,674,847,23,17.0,0,Clear,6.5,2023-10-25 07:00:00,7
326,1328,1654,23,16.8,0,Clear,11.5,2023-10-25 08:00:00,8
234,692,926,27,15.5,0,Clear,11.8,2023-10-25 09:00:00,9
198,397,595,32,13.7,0,Clear,8.4,2023-10-25 10:00:00,10
258,486,744,37,12.7,0,Clear,5.9,2023-10-25 11:00:00,11
265,580,845,36,13.3,0,Clear,3.1,2023-10-25 12:00:00,12
276,576,852,38,12.6,0,Clear,2.3,2023-10-25 13:00:00,13
296,550,846,38,12.3,0,Clear,3.8,2023-10-25 14:00:00,14
333,748,1081,44,9.1,0,Clear,7.6,2023-10-25 15:00:00,15
441,935,1376,47,7.5,0,Clear,7.5,2023-10-25 16:00:00,16
728,1534,2262,45,8.5,0,Clear,1.5,2023-10-25 17:00:00,17
598,1281,1879,55,5.5,1,Mostly Clear,6.9,2023-10-25 18:00:00,18
380,830,1210,57,4.9,1,Mostly Clear,8.6,2023-10-25 19:00:00,19
224,550,774,61,4.0,0,Clear,9.3,2023-10-25 20:00:00,20
212,468,680,60,4.3,0,Clear,8.6,2023-10-25 21:00:00,21
179,320,499,51,6.8,0,Clear,6.5,2023-10-25 22:00:00,22
100,160,260,39,10.4,0,Clear,5.7,2023-10-25 23:00:00,23
42,65,107,31,13.7,0,Clear,4.4,2023-10-26 00:00:00,0
20,33,53,26,16.0,0,Clear,4.0,2023-10-26 01:00:00,1
10,30,40,22,17.6,1,Mostly Clear,3.9,2023-10-26 02:00:00,2
1,11,12,19,18.6,1,Mostly Clear,5.0,2023-10-26 03:00:00,3
4,27,31,18,19.3,1,Mostly Clear,7.9,2023-10-26 04:00:00,4
16,64,80,18,19.3,1,Mostly Clear,4.6,2023-10-26 05:00:00,5
63,270,333,18,19.1,1,Mostly Clear,3.3,2023-10-26 06:00:00,6
156,660,816,19,18.4,1,Mostly Clear,1.8,2023-10-26 07:00:00,7
323,1153,1476,23,16.8,1,Mostly Clear,4.1,2023-10-26 08:00:00,8
240,662,902,26,14.8,2,Partly Cloudy,8.2,2023-10-26 09:00:00,9
219,413,632,27,14.4,1,Mostly Clear,5.4,2023-10-26 10:00:00,10
220,433,653,25,15.4,1,Mostly Clear,3.2,2023-10-26 11:00:00,11
237,515,752,33,11.8,1,Mostly Clear,8.6,2023-10-26 12:00:00,12
291,511,802,38,10.3,0,Clear,6.8,2023-10-26 13:00:00,13
310,512,822,41,9.5,0,Clear,9.5,2023-10-26 14:00:00,14
422,756,1178,44,8.8,0,Clear,8.7,2023-10-26 15:00:00,15
519,957,1476,47,8.2,0,Clear,8.2,2023-10-26 16:00:00,16
747,1495,2242,47,8.3,0,Clear,5.4,2023-10-26 17:00:00,17
665,1212,1877,47,8.3,0,Clear,5.0,2023-10-26 18:00:00,18
381,804,1185,56,6.2,0,Clear,9.0,2023-10-26 19:00:00,19
304,606,910,63,5.6,0,Clear,10.5,2023-10-26 20:00:00,20
253,497,750,60,6.3,0,Clear,11.3,2023-10-26 21:00:00,21
175,370,545,47,9.1,0,Clear,8.6,2023-10-26 22:00:00,22
132,218,350,37,12.6,0,Clear,6.8,2023-10-26 23:00:00,23
70,117,187,30,15.4,1,Mostly Clear,8.1,2023-10-27 00:00:00,0
56,58,114,25,17.6,1,Mostly Clear,6.9,2023-10-27 01:00:00,1
24,37,61,22,19.4,1,Mostly Clear,7.0,2023-10-27 02:00:00,2
11,22,33,19,20.8,1,Mostly Clear,8.7,2023-10-27 03:00:00,3
6,30,36,19,21.4,1,Mostly Clear,7.4,2023-10-27 04:00:00,4
31,61,92,19,21.4,1,Mostly Clear,2.6,2023-10-27 05:00:00,5
71,219,290,19,21.0,1,Mostly Clear,3.1,2023-10-27 06:00:00,6
138,522,660,23,18.7,1,Mostly Clear,7.7,2023-10-27 07:00:00,7
259,830,1089,25,17.8,1,Mostly Clear,9.0,2023-10-27 08:00:00,8
273,548,821,28,17.0,1,Mostly Clear,11.2,2023-10-27 09:00:00,9
271,471,742,28,16.5,1,Mostly Clear,11.6,2023-10-27 10:00:00,10
344,495,839,28,15.5,1,Mostly Clear,10.6,2023-10-27 11:00:00,11
415,607,1022,31,14.5,1,Mostly Clear,8.7,2023-10-27 12:00:00,12
459,603,1062,32,13.6,0,Clear,5.5,2023-10-27 13:00:00,13
480,591,1071,32,13.3,0,Clear,4.3,2023-10-27 14:00:00,14
560,792,1352,36,11.6,0,Clear,6.1,2023-10-27 15:00:00,15
632,929,1561,40,10.6,0,Clear,12.3,2023-10-27 16:00:00,16
733,1265,1998,47,9.7,0,Clear,13.2,2023-10-27 17:00:00,17
558,1023,1581,49,9.2,0,Clear,13.7,2023-10-27 18:00:00,18
416,755,1171,48,8.8,0,Clear,15.0,2023-10-27 19:00:00,19
316,525,841,50,8.1,1,Mostly Clear,12.7,2023-10-27 20:00:00,20
277,441,718,51,8.1,0,Clear,10.8,2023-10-27 21:00:00,21
270,414,684,44,10.3,1,Mostly Clear,9.4,2023-10-27 22:00:00,22
224,334,558,36,12.9,1,Mostly Clear,9.3,2023-10-27 23:00:00,23
179,275,454,31,15.6,1,Mostly Clear,9.1,2023-10-28 00:00:00,0
148,185,333,27,17.7,2,Partly Cloudy,7.7,2023-10-28 01:00:00,1
109,144,253,24,19.3,1,Mostly Clear,6.6,2023-10-28 02:00:00,2
58,49,107,22,20.5,0,Clear,6.5,2023-10-28 03:00:00,3
11,28,39,21,21.1,0,Clear,4.7,2023-10-28 04:00:00,4
18,47,65,20,21.3,0,Clear,3.9,2023-10-28 05:00:00,5
47,111,158,20,21.0,0,Clear,5.2,2023-10-28 06:00:00,6
87,194,281,24,18.6,0,Clear,5.8,2023-10-28 07:00:00,7
223,310,533,23,19.3,0,Clear,4.0,2023-10-28 08:00:00,8
396,517,913,27,16.9,0,Clear,10.9,2023-10-28 09:00:00,9
527,606,1133,31,15.8,0,Clear,11.5,2023-10-28 10:00:00,10
791,683,1474,35,14.5,1,Mostly Clear,11.0,2023-10-28 11:00:00,11
783,729,1512,39,13.0,1,Mostly Clear,9.0,2023-10-28 12:00:00,12
860,754,1614,37,13.6,0,Clear,4.3,2023-10-28 13:00:00,13
800,750,1550,46,11.3,0,Clear,11.5,2023-10-28 14:00:00,14
881,845,1726,50,10.1,1,Mostly Clear,11.1,2023-10-28 15:00:00,15
753,773,1526,52,9.5,0,Clear,11.3,2023-10-28 16:00:00,16
755,801,1556,55,8.7,1,Mostly Clear,11.3,2023-10-28 17:00:00,17
519,694,1213,56,8.8,1,Mostly Clear,3.6,2023-10-28 18:00:00,18
380,576,956,66,6.6,1,Mostly Clear,6.7,2023-10-28 19:00:00,19
344,444,788,73,5.7,1,Mostly Clear,5.6,2023-10-28 20:00:00,20
296,439,735,70,6.2,1,Mostly Clear,4.2,2023-10-28 21:00:00,21
294,387,681,60,8.2,1,Mostly Clear,4.3,2023-10-28 22:00:00,22
246,328,574,49,10.9,1,Mostly Clear,6.0,2023-10-28 23:00:00,23
262,276,538,39,13.7,1,Mostly Clear,6.6,2023-10-29 00:00:00,0
277,258,535,33,16.2,1,Mostly Clear,6.1,2023-10-29 01:00:00,1
186,189,375,28,18.0,1,Mostly Clear,5.2,2023-10-29 02:00:00,2
89,94,183,26,19.1,1,Mostly Clear,3.8,2023-10-29 03:00:00,3
21,38,59,25,19.9,0,Clear,4.5,2023-10-29 04:00:00,4
29,25,54,24,20.1,0,Clear,3.6,2023-10-29 05:00:00,5
68,81,149,24,20.0,0,Clear,5.2,2023-10-29 06:00:00,6
158,169,327,29,17.2,0,Clear,6.6,2023-10-29 07:00:00,7
334,312,646,29,16.9,0,Clear,10.0,2023-10-29 08:00:00,8
477,437,914,33,15.4,0,Clear,8.4,2023-10-29 09:00:00,9
599,581,1180,38,14.1,0,Clear,9.2,2023-10-29 10:00:00,10
561,644,1205,40,13.2,0,Clear,10.7,2023-10-29 11:00:00,11
668,673,1341,43,12.3,0,Clear,10.8,2023-10-29 12:00:00,12
617,728,1345,44,11.5,0,Clear,10.6,2023-10-29 13:00:00,13
670,710,1380,49,10.4,0,Clear,8.9,2023-10-29 14:00:00,14
659,735,1394,54,9.5,0,Clear,9.4,2023-10-29 15:00:00,15
662,801,1463,55,8.6,0,Clear,9.8,2023-10-29 16:00:00,16
573,691,1264,56,7.8,0,Clear,10.2,2023-10-29 17:00:00,17
395,609,1004,58,7.3,0,Clear,10.5,2023-10-29 18:00:00,18
265,396,661,60,6.9,0,Clear,9.5,2023-10-29 19:00:00,19
124,231,355,68,5.8,0,Clear,9.7,2023-10-29 20:00:00,20
116,179,295,67,6.1,0,Clear,10.0,2023-10-29 21:00:00,21
101,206,307,58,8.5,0,Clear,4.2,2023-10-29 22:00:00,22
54,136,190,47,11.5,0,Clear,2.9,2023-10-29 23:00:00,23
37,66,103,38,14.7,0,Clear,3.6,2023-10-30 00:00:00,0
14,23,37,32,17.2,0,Clear,4.2,2023-10-30 01:00:00,1
8,17,25,27,19.2,0,Clear,2.6,2023-10-30 02:00:00,2
10,16,26,23,20.6,0,Clear,1.8,2023-10-30 03:00:00,3
5,18,23,20,21.5,0,Clear,2.6,2023-10-30 04:00:00,4
22,61,83,19,22.0,0,Clear,3.7,2023-10-30 05:00:00,5
60,227,287,20,21.5,0,Clear,5.1,2023-10-30 06:00:00,6
140,555,695,24,18.7,0,Clear,9.2,2023-10-30 07:00:00,7
271,1031,1302,28,17.7,0,Clear,10.7,2023-10-30 08:00:00,8
228,550,778,30,17.0,0,Clear,13.5,2023-10-30 09:00:00,9
211,315,526,33,15.6,0,Clear,13.3,2023-10-30 10:00:00,10
266,378,644,35,14.3,0,Clear,11.6,2023-10-30 11:00:00,11
306,492,798,41,12.6,0,Clear,8.2,2023-10-30 12:00:00,12
285,543,828,45,12.0,0,Clear,12.6,2023-10-30 13:00:00,13
328,489,817,44,11.3,0,Clear,12.5,2023-10-30 14:00:00,14
367,622,989,44,10.6,0,Clear,12.4,2023-10-30 15:00:00,15
420,877,1297,47,9.6,0,Clear,9.7,2023-10-30 16:00:00,16
324,897,1221,46,10.1,0,Clear,4.3,2023-10-30 17:00:00,17
200,644,844,55,7.7,1,Mostly Clear,9.1,2023-10-30 18:00:00,18
113,341,454,59,7.1,1,Mostly Clear,10.6,2023-10-30 19:00:00,19
88,336,424,66,5.9,1,Mostly Clear,10.6,2023-10-30 20:00:00,20
143,342,485,69,5.8,1,Mostly Clear,10.7,2023-10-30 21:00:00,21
102,226,328,60,8.1,0,Clear,7.7,2023-10-30 22:00:00,22
57,114,171,48,11.2,0,Clear,5.4,2023-10-30 23:00:00,23
32,31,63,38,13.9,0,Clear,6.2,2023-10-31 00:00:00,0
8,21,29,31,16.2,0,Clear,6.5,2023-10-31 01:00:00,1
7,16,23,26,18.1,0,Clear,5.4,2023-10-31 02:00:00,2
6,8,14,23,19.5,0,Clear,4.1,2023-10-31 03:00:00,3
1,20,21,21,20.5,0,Clear,5.7,2023-10-31 04:00:00,4
29,70,99,21,20.8,1,Mostly Clear,5.9,2023-10-31 05:00:00,5
60,223,283,22,20.2,1,Mostly Clear,3.4,2023-10-31 06:00:00,6
164,651,815,24,18.2,1,Mostly Clear,4.7,2023-10-31 07:00:00,7
269,1171,1440,27,16.8,1,Mostly Clear,8.7,2023-10-31 08:00:00,8
192,654,846,28,16.6,1,Mostly Clear,5.3,2023-10-31 09:00:00,9
139,290,429,32,14.8,1,Mostly Clear,8.4,2023-10-31 10:00:00,10
150,376,526,32,15.5,2,Partly Cloudy,15.3,2023-10-31 11:00:00,11
211,483,694,24,17.4,1,Mostly Clear,32.7,2023-10-31 12:00:00,12
227,499,726,24,15.8,1,Mostly Clear,38.3,2023-10-31 13:00:00,13
255,473,728,18,15.4,1,Mostly Clear,40.1,2023-10-31 14:00:00,14
285,660,945,15,15.6,2,Partly Cloudy,38.0,2023-10-31 15:00:00,15
379,900,1279,14,15.5,1,Mostly Clear,34.6,2023-10-31 16:00:00,16
494,1297,1791,13,15.2,1,Mostly Clear,32.3,2023-10-31 17:00:00,17
392,949,1341,12,15.2,1,Mostly Clear,28.0,2023-10-31 18:00:00,18
241,594,835,12,14.8,1,Mostly Clear,25.3,2023-10-31 19:00:00,19
171,450,621,12,14.7,1,Mostly Clear,23.9,2023-10-31 20:00:00,20
176,402,578,13,13.9,1,Mostly Clear,18.4,2023-10-31 21:00:00,21
106,257,363,12,14.8,1,Mostly Clear,16.9,2023-10-31 22:00:00,22
78,135,213,12,16.2,1,Mostly Clear,20.8,2023-10-31 23:00:00,23
31,63,94,11,18.0,0,Clear,24.8,2023-11-01 00:00:00,0
19,38,57,10,19.7,0,Clear,20.6,2023-11-01 01:00:00,1
10,19,29,9,20.6,0,Clear,16.1,2023-11-01 02:00:00,2
5,7,12,9,20.9,0,Clear,13.4,2023-11-01 03:00:00,3
4,14,18,8,21.1,0,Clear,12.0,2023-11-01 04:00:00,4
20,59,79,9,20.9,0,Clear,12.0,2023-11-01 05:00:00,5
58,214,272,9,20.0,0,Clear,9.4,2023-11-01 06:00:00,6
153,576,729,12,17.2,0,Clear,10.8,2023-11-01 07:00:00,7
270,1110,1380,13,15.6,0,Clear,9.4,2023-11-01 08:00:00,8
151,534,685,15,14.4,0,Clear,9.4,2023-11-01 09:00:00,9
120,337,457,17,13.3,0,Clear,7.6,2023-11-01 10:00:00,10
142,302,444,18,13.5,0,Clear,5.4,2023-11-01 11:00:00,11
159,421,580,22,11.1,0,Clear,10.8,2023-11-01 12:00:00,12
140,396,536,24,10.9,1,Mostly Clear,6.9,2023-11-01 13:00:00,13
162,426,588,22,9.9,2,Partly Cloudy,14.6,2023-11-01 14:00:00,14
241,570,811,22,10.0,2,Partly Cloudy,12.7,2023-11-01 15:00:00,15
247,752,999,21,9.9,2,Partly Cloudy,15.2,2023-11-01 16:00:00,16
366,1081,1447,16,10.9,2,Partly Cloudy,17.6,2023-11-01 17:00:00,17
298,912,1210,15,11.0,2,Partly Cloudy,16.2,2023-11-01 18:00:00,18
207,618,825,15,11.4,2,Partly Cloudy,19.2,2023-11-01 19:00:00,19
128,402,530,15,13.0,2,Partly Cloudy,26.4,2023-11-01 20:00:00,20
107,339,446,15,12.8,2,Partly Cloudy,24.4,2023-11-01 21:00:00,21
94,219,313,14,14.3,3,Cloudy,28.1,2023-11-01 22:00:00,22
47,124,171,14,15.2,2,Partly Cloudy,23.0,2023-11-01 23:00:00,23
18,51,69,13,17.1,0,Clear,20.0,2023-11-02 00:00:00,0
9,15,24,11,18.6,0,Clear,22.2,2023-11-02 01:00:00,1
2,7,9,11,18.9,2,Partly Cloudy,21.8,2023-11-02 02:00:00,2
4,8,12,12,18.7,2,Partly Cloudy,18.0,2023-11-02 03:00:00,3
2,20,22,12,18.6,0,Clear,13.5,2023-11-02 04:00:00,4
15,54,69,12,18.6,0,Clear,11.0,2023-11-02 05:00:00,5
60,203,263,14,18.0,0,Clear,10.0,2023-11-02 06:00:00,6
117,538,655,22,15.5,0,Clear,16.2,2023-11-02 07:00:00,7
254,936,1190,25,14.1,0,Clear,14.4,2023-11-02 08:00:00,8
179,582,761,31,12.7,0,Clear,11.9,2023-11-02 09:00:00,9
120,294,414,36,11.1,0,Clear,10.5,2023-11-02 10:00:00,10
154,325,479,41,9.5,0,Clear,9.1,2023-11-02 11:00:00,11
171,382,553,46,8.1,0,Clear,8.2,2023-11-02 12:00:00,12
196,460,656,48,7.1,0,Clear,7.4,2023-11-02 13:00:00,13
214,425,639,50,6.5,0,Clear,5.7,2023-11-02 14:00:00,14
306,626,932,50,5.9,0,Clear,10.1,2023-11-02 15:00:00,15
301,741,1042,51,4.7,0,Clear,8.0,2023-11-02 16:00:00,16
467,1130,1597,52,3.9,0,Clear,8.4,2023-11-02 17:00:00,17
385,955,1340,57,3.1,0,Clear,9.5,2023-11-02 18:00:00,18
224,633,857,61,2.3,0,Clear,10.1,2023-11-02 19:00:00,19
157,407,564,63,1.8,0,Clear,11.0,2023-11-02 20:00:00,20
154,387,541,58,1.8,0,Clear,9.2,2023-11-02 21:00:00,21
108,285,393,48,3.8,0,Clear,5.9,2023-11-02 22:00:00,22
70,173,243,37,7.3,0,Clear,5.7,2023-11-02 23:00:00,23
40,63,103,29,11.1,0,Clear,6.1,2023-11-03 00:00:00,0
18,36,54,25,13.5,0,Clear,5.1,2023-11-03 01:00:00,1
10,13,23,21,15.1,0,Clear,4.4,2023-11-03 02:00:00,2
6,9,15,18,16.1,0,Clear,3.5,2023-11-03 03:00:00,3
4,11,15,17,16.6,0,Clear,1.1,2023-11-03 04:00:00,4
24,57,81,17,16.7,0,Clear,2.9,2023-11-03 05:00:00,5
41,176,217,17,16.2,0,Clear,6.5,2023-11-03 06:00:00,6
126,411,537,21,13.7,0,Clear,10.5,2023-11-03 07:00:00,7
185,648,833,21,12.2,0,Clear,7.9,2023-11-03 08:00:00,8
204,462,666,22,11.8,0,Clear,6.8,2023-11-03 09:00:00,9
214,314,528,27,9.9,0,Clear,8.4,2023-11-03 10:00:00,10
237,433,670,38,8.4,0,Clear,7.6,2023-11-03 11:00:00,11
258,503,761,46,7.5,0,Clear,6.6,2023-11-03 12:00:00,12
369,538,907,45,7.3,0,Clear,5.6,2023-11-03 13:00:00,13
356,552,908,43,6.7,0,Clear,5.5,2023-11-03 14:00:00,14
422,676,1098,42,5.6,0,Clear,5.9,2023-11-03 15:00:00,15
432,839,1271,45,4.2,0,Clear,7.5,2023-11-03 16:00:00,16
502,966,1468,46,3.5,0,Clear,7.4,2023-11-03 17:00:00,17
451,835,1286,44,3.7,0,Clear,6.1,2023-11-03 18:00:00,18
306,605,911,47,2.7,0,Clear,6.6,2023-11-03 19:00:00,19
207,415,622,51,2.6,0,Clear,5.9,2023-11-03 20:00:00,20
156,312,468,57,1.4,0,Clear,6.2,2023-11-03 21:00:00,21
160,229,389,49,3.6,0,Clear,5.1,2023-11-03 22:00:00,22
151,253,404,39,7.0,0,Clear,3.3,2023-11-03 23:00:00,23
129,159,288,31,10.4,0,Clear,2.3,2023-11-04 00:00:00,0
102,111,213,24,12.9,0,Clear,2.9,2023-11-04 01:00:00,1
33,84,117,21,14.7,0,Clear,3.4,2023-11-04 02:00:00,2
24,39,63,18,16.1,0,Clear,5.0,2023-11-04 03:00:00,3
11,18,29,17,17.0,0,Clear,6.6,2023-11-04 04:00:00,4
10,26,36,17,17.5,0,Clear,7.8,2023-11-04 05:00:00,5
33,60,93,19,16.6,0,Clear,7.9,2023-11-04 06:00:00,6
64,143,207,24,14.0,0,Clear,11.1,2023-11-04 07:00:00,7
113,292,405,24,13.3,0,Clear,13.3,2023-11-04 08:00:00,8
252,441,693,26,11.6,0,Clear,10.2,2023-11-04 09:00:00,9
366,527,893,30,10.0,0,Clear,8.8,2023-11-04 10:00:00,10
551,633,1184,33,8.9,0,Clear,9.2,2023-11-04 11:00:00,11
667,761,1428,36,7.8,0,Clear,9.4,2023-11-04 12:00:00,12
851,839,1690,39,6.8,0,Clear,6.4,2023-11-04 13:00:00,13
800,818,1618,35,8.0,0,Clear,1.5,2023-11-04 14:00:00,14
819,819,1638,37,7.1,0,Clear,3.3,2023-11-04 15:00:00,15
796,821,1617,44,4.1,0,Clear,9.7,2023-11-04 16:00:00,16
700,811,1511,44,3.9,0,Clear,11.5,2023-11-04 17:00:00,17
619,744,1363,45,3.4,0,Clear,12.0,2023-11-04 18:00:00,18
434,585,1019,46,3.1,0,Clear,13.2,2023-11-04 19:00:00,19
322,392,714,47,2.8,0,Clear,16.6,2023-11-04 20:00:00,20
218,302,520,44,3.2,0,Clear,16.9,2023-11-04 21:00:00,21
232,323,555,47,4.7,0,Clear,14.1,2023-11-04 22:00:00,22
162,264,426,49,6.4,0,Clear,8.9,2023-11-04 23:00:00,23
147,218,365,46,8.1,0,Clear,4.2,2023-11-05 00:00:00,0
152,189,341,41,9.6,0,Clear,3.8,2023-11-05 01:00:00,1
27,42,69,37,11.0,0,Clear,4.5,2023-11-05 02:00:00,2
11,20,31,35,11.9,0,Clear,3.7,2023-11-05 03:00:00,3
8,12,20,32,12.4,0,Clear,1.9,2023-11-05 04:00:00,4
15,19,34,31,12.5,0,Clear,1.0,2023-11-05 05:00:00,5
25,61,86,31,12.2,0,Clear,3.2,2023-11-05 06:00:00,6
57,113,170,36,10.4,0,Clear,6.1,2023-11-05 07:00:00,7
160,284,444,34,11.2,0,Clear,4.9,2023-11-05 08:00:00,8
347,444,791,33,11.5,0,Clear,4.0,2023-11-05 09:00:00,9
495,580,1075,42,8.6,0,Clear,5.9,2023-11-05 10:00:00,10
577,697,1274,54,6.8,0,Clear,6.6,2023-11-05 11:00:00,11
640,724,1364,58,6.1,0,Clear,5.0,2023-11-05 12:00:00,12
687,756,1443,54,6.7,0,Clear,3.6,2023-11-05 13:00:00,13
675,755,1430,55,6.2,0,Clear,3.2,2023-11-05 14:00:00,14
693,760,1453,55,5.5,0,Clear,3.7,2023-11-05 15:00:00,15
678,734,1412,57,4.7,0,Clear,4.0,2023-11-05 16:00:00,16
465,664,1129,61,3.8,0,Clear,3.3,2023-11-05 17:00:00,17
287,472,759,64,3.1,0,Clear,2.1,2023-11-05 18:00:00,18
192,325,517,64,2.6,0,Clear,2.3,2023-11-05 19:00:00,19
155,271,426,71,1.1,1,Mostly Clear,3.1,2023-11-05 20:00:00,20
124,230,354,74,0.8,0,Clear,3.1,2023-11-05 21:00:00,21
106,173,279,75,0.8,1,Mostly Clear,1.6,2023-11-05 22:00:00,22
68,113,181,60,3.7,1,Mostly Clear,3.3,2023-11-05 23:00:00,23
29,49,78,48,6.9,1,Mostly Clear,3.4,2023-11-06 00:00:00,0
6,16,22,39,9.5,1,Mostly Clear,3.6,2023-11-06 01:00:00,1
9,11,20,34,11.2,1,Mostly Clear,2.7,2023-11-06 02:00:00,2
8,10,18,31,12.3,1,Mostly Clear,1.8,2023-11-06 03:00:00,3
6,13,19,29,13.1,1,Mostly Clear,1.8,2023-11-06 04:00:00,4
21,64,85,27,13.4,1,Mostly Clear,3.2,2023-11-06 05:00:00,5
61,245,306,26,13.3,1,Mostly Clear,4.2,2023-11-06 06:00:00,6
139,587,726,27,12.4,1,Mostly Clear,3.3,2023-11-06 07:00:00,7
240,989,1229,30,11.1,1,Mostly Clear,5.4,2023-11-06 08:00:00,8
227,497,724,36,10.0,1,Mostly Clear,10.9,2023-11-06 09:00:00,9
189,302,491,38,8.4,1,Mostly Clear,8.0,2023-11-06 10:00:00,10
223,366,589,37,8.3,1,Mostly Clear,4.1,2023-11-06 11:00:00,11
277,484,761,40,8.0,1,Mostly Clear,4.0,2023-11-06 12:00:00,12
250,508,758,44,7.8,1,Mostly Clear,3.3,2023-11-06 13:00:00,13
295,432,727,47,7.2,0,Clear,0.7,2023-11-06 14:00:00,14
343,596,939,48,6.8,0,Clear,1.8,2023-11-06 15:00:00,15
359,812,1171,51,6.2,0,Clear,2.1,2023-11-06 16:00:00,16
421,1147,1568,54,5.5,0,Clear,2.3,2023-11-06 17:00:00,17
322,885,1207,60,4.0,0,Clear,4.4,2023-11-06 18:00:00,18
214,622,836,62,3.4,0,Clear,4.1,2023-11-06 19:00:00,19
176,408,584,70,2.0,0,Clear,5.7,2023-11-06 20:00:00,20
112,356,468,77,0.7,0,Clear,6.5,2023-11-06 21:00:00,21
108,235,343,67,2.7,1,Mostly Clear,6.0,2023-11-06 22:00:00,22
60,115,175,55,5.5,0,Clear,5.6,2023-11-06 23:00:00,23
13,54,67,43,8.2,0,Clear,4.8,2023-11-07 00:00:00,0
11,20,31,36,10.3,0,Clear,5.2,2023-11-07 01:00:00,1
4,21,25,30,12.0,0,Clear,5.5,2023-11-07 02:00:00,2
6,12,18,27,13.0,0,Clear,4.9,2023-11-07 03:00:00,3
6,21,27,25,13.7,1,Mostly Clear,3.9,2023-11-07 04:00:00,4
27,62,89,23,13.9,1,Mostly Clear,3.3,2023-11-07 05:00:00,5
85,284,369,25,13.4,1,Mostly Clear,2.0,2023-11-07 06:00:00,6
196,737,933,31,11.1,1,Mostly Clear,7.9,2023-11-07 07:00:00,7
306,1232,1538,33,11.3,1,Mostly Clear,11.4,2023-11-07 08:00:00,8
229,590,819,39,9.8,1,Mostly Clear,9.7,2023-11-07 09:00:00,9
166,334,500,43,8.2,0,Clear,6.9,2023-11-07 10:00:00,10
182,377,559,41,8.2,1,Mostly Clear,4.7,2023-11-07 11:00:00,11
211,527,738,39,8.6,1,Mostly Clear,3.5,2023-11-07 12:00:00,12
218,452,670,43,8.1,1,Mostly Clear,2.6,2023-11-07 13:00:00,13
264,469,733,45,7.5,0,Clear,2.8,2023-11-07 14:00:00,14
332,684,1016,52,5.1,0,Clear,5.8,2023-11-07 15:00:00,15
415,956,1371,57,3.5,1,Mostly Clear,7.5,2023-11-07 16:00:00,16
532,1380,1912,60,2.6,1,Mostly Clear,8.7,2023-11-07 17:00:00,17
408,1102,1510,63,1.9,1,Mostly Clear,8.0,2023-11-07 18:00:00,18
267,629,896,66,1.3,1,Mostly Clear,8.1,2023-11-07 19:00:00,19
173,473,646,76,-0.0,1,Mostly Clear,6.5,2023-11-07 20:00:00,20
197,456,653,76,0.1,0,Clear,5.6,2023-11-07 21:00:00,21
141,280,421,67,2.3,0,Clear,3.0,2023-11-07 22:00:00,22
68,129,197,54,5.4,1,Mostly Clear,3.8,2023-11-07 23:00:00,23
28,50,78,43,8.3,1,Mostly Clear,4.7,2023-11-08 00:00:00,0
15,34,49,34,11.0,0,Clear,6.6,2023-11-08 01:00:00,1
8,13,21,29,12.8,0,Clear,5.4,2023-11-08 02:00:00,2
2,5,7,26,13.9,0,Clear,4.1,2023-11-08 03:00:00,3
4,19,23,24,14.4,0,Clear,3.6,2023-11-08 04:00:00,4
26,67,93,23,14.5,1,Mostly Clear,5.5,2023-11-08 05:00:00,5
82,275,357,24,13.9,1,Mostly Clear,7.4,2023-11-08 06:00:00,6
210,708,918,29,11.3,1,Mostly Clear,6.5,2023-11-08 07:00:00,7
332,1220,1552,24,13.5,1,Mostly Clear,3.4,2023-11-08 08:00:00,8
225,614,839,32,9.9,1,Mostly Clear,8.3,2023-11-08 09:00:00,9
164,354,518,36,8.6,1,Mostly Clear,8.9,2023-11-08 10:00:00,10
157,401,558,42,7.3,0,Clear,7.4,2023-11-08 11:00:00,11
191,485,676,41,8.1,0,Clear,4.6,2023-11-08 12:00:00,12
205,493,698,44,7.3,0,Clear,4.4,2023-11-08 13:00:00,13
249,502,751,43,7.4,0,Clear,0.8,2023-11-08 14:00:00,14
315,701,1016,44,7.0,0,Clear,2.3,2023-11-08 15:00:00,15
372,915,1287,46,6.4,0,Clear,1.1,2023-11-08 16:00:00,16
465,1292,1757,48,5.8,0,Clear,1.8,2023-11-08 17:00:00,17
376,1024,1400,51,5.1,0,Clear,2.6,2023-11-08 18:00:00,18
250,680,930,54,4.3,0,Clear,3.7,2023-11-08 19:00:00,19
195,468,663,63,2.4,0,Clear,1.8,2023-11-08 20:00:00,20
137,363,500,70,0.9,1,Mostly Clear,4.3,2023-11-08 21:00:00,21
146,283,429,67,1.7,1,Mostly Clear,3.3,2023-11-08 22:00:00,22
82,146,228,55,4.5,1,Mostly Clear,4.1,2023-11-08 23:00:00,23
36,61,97,42,7.1,1,Mostly Clear,5.1,2023-11-09 00:00:00,0
12,24,36,31,9.5,1,Mostly Clear,7.1,2023-11-09 01:00:00,1
8,9,17,25,11.3,0,Clear,7.7,2023-11-09 02:00:00,2
5,11,16,21,12.7,0,Clear,7.3,2023-11-09 03:00:00,3
5,15,20,20,13.4,0,Clear,6.4,2023-11-09 04:00:00,4
22,61,83,19,13.6,1,Mostly Clear,5.5,2023-11-09 05:00:00,5
62,261,323,23,12.7,1,Mostly Clear,3.4,2023-11-09 06:00:00,6
167,653,820,24,11.2,1,Mostly Clear,7.0,2023-11-09 07:00:00,7
304,1172,1476,24,10.6,1,Mostly Clear,9.1,2023-11-09 08:00:00,8
250,653,903,24,9.8,1,Mostly Clear,10.6,2023-11-09 09:00:00,9
147,262,409,25,8.5,2,Partly Cloudy,9.4,2023-11-09 10:00:00,10
236,403,639,29,7.3,51,Light Drizzle,7.7,2023-11-09 11:00:00,11
306,480,786,32,6.9,1,Mostly Clear,8.3,2023-11-09 12:00:00,12
283,544,827,40,6.2,1,Mostly Clear,9.2,2023-11-09 13:00:00,13
344,572,916,43,5.7,1,Mostly Clear,11.1,2023-11-09 14:00:00,14
444,752,1196,47,5.5,51,Light Drizzle,12.3,2023-11-09 15:00:00,15
253,623,876,56,4.7,1,Mostly Clear,8.8,2023-11-09 16:00:00,16
361,1004,1365,63,3.9,1,Mostly Clear,9.2,2023-11-09 17:00:00,17
292,878,1170,69,3.4,2,Partly Cloudy,6.7,2023-11-09 18:00:00,18
250,632,882,70,3.7,3,Cloudy,5.4,2023-11-09 19:00:00,19
228,484,712,53,3.4,3,Cloudy,8.1,2023-11-09 20:00:00,20
182,396,578,50,3.4,3,Cloudy,7.2,2023-11-09 21:00:00,21
163,317,480,44,4.4,3,Cloudy,5.8,2023-11-09 22:00:00,22
111,211,322,39,5.6,3,Cloudy,8.1,2023-11-09 23:00:00,23
66,113,179,36,6.9,3,Cloudy,14.9,2023-11-10 00:00:00,0
51,57,108,29,9.4,2,Partly Cloudy,19.1,2023-11-10 01:00:00,1
26,41,67,27,10.3,1,Mostly Clear,22.8,2023-11-10 02:00:00,2
11,14,25,25,11.3,0,Clear,13.7,2023-11-10 03:00:00,3
9,17,26,24,11.6,0,Clear,4.7,2023-11-10 04:00:00,4
27,49,76,24,11.6,0,Clear,1.4,2023-11-10 05:00:00,5
58,150,208,25,11.2,0,Clear,1.8,2023-11-10 06:00:00,6
86,214,300,29,8.5,0,Clear,10.3,2023-11-10 07:00:00,7
83,242,325,33,8.0,0,Clear,11.0,2023-11-10 08:00:00,8
64,184,248,38,7.0,0,Clear,10.6,2023-11-10 09:00:00,9
72,180,252,44,5.9,0,Clear,11.0,2023-11-10 10:00:00,10
120,266,386,45,5.0,0,Clear,11.0,2023-11-10 11:00:00,11
97,312,409,46,4.2,0,Clear,10.4,2023-11-10 12:00:00,12
74,222,296,50,3.2,0,Clear,9.4,2023-11-10 13:00:00,13
130,277,407,58,2.3,0,Clear,8.7,2023-11-10 14:00:00,14
180,412,592,58,3.3,0,Clear,4.0,2023-11-10 15:00:00,15
259,567,826,69,1.1,0,Clear,5.9,2023-11-10 16:00:00,16
272,631,903,73,-0.3,0,Clear,7.2,2023-11-10 17:00:00,17
234,539,773,74,-0.2,0,Clear,5.3,2023-11-10 18:00:00,18
175,430,605,76,-0.4,0,Clear,2.6,2023-11-10 19:00:00,19
149,283,432,94,-3.1,0,Clear,5.0,2023-11-10 20:00:00,20
111,246,357,98,-3.5,3,Cloudy,2.8,2023-11-10 21:00:00,21
133,230,363,92,-1.8,1,Mostly Clear,2.1,2023-11-10 22:00:00,22
113,214,327,77,0.7,0,Clear,1.8,2023-11-10 23:00:00,23
73,138,211,61,3.8,0,Clear,2.9,2023-11-11 00:00:00,0
68,111,179,51,6.7,0,Clear,3.9,2023-11-11 01:00:00,1
56,66,122,42,9.0,0,Clear,6.0,2023-11-11 02:00:00,2
24,24,48,34,10.8,0,Clear,7.9,2023-11-11 03:00:00,3
11,15,26,30,11.9,0,Clear,7.9,2023-11-11 04:00:00,4
14,28,42,28,12.3,0,Clear,8.7,2023-11-11 05:00:00,5
28,68,96,29,11.5,0,Clear,9.0,2023-11-11 06:00:00,6
55,129,184,34,9.4,0,Clear,13.8,2023-11-11 07:00:00,7
154,250,404,35,8.5,0,Clear,14.5,2023-11-11 08:00:00,8
266,387,653,39,7.3,1,Mostly Clear,12.6,2023-11-11 09:00:00,9
405,455,860,41,6.2,1,Mostly Clear,11.3,2023-11-11 10:00:00,10
470,600,1070,43,5.4,1,Mostly Clear,10.9,2023-11-11 11:00:00,11
678,690,1368,46,4.4,1,Mostly Clear,9.7,2023-11-11 12:00:00,12
722,695,1417,51,3.3,0,Clear,7.1,2023-11-11 13:00:00,13
698,704,1402,50,3.5,0,Clear,3.7,2023-11-11 14:00:00,14
751,732,1483,55,2.4,1,Mostly Clear,4.5,2023-11-11 15:00:00,15
663,646,1309,62,0.8,1,Mostly Clear,8.7,2023-11-11 16:00:00,16
430,598,1028,66,-0.1,0,Clear,7.9,2023-11-11 17:00:00,17
288,515,803,72,-0.8,1,Mostly Clear,7.0,2023-11-11 18:00:00,18
255,382,637,66,0.5,1,Mostly Clear,2.9,2023-11-11 19:00:00,19
145,327,472,81,-2.2,0,Clear,7.7,2023-11-11 20:00:00,20
182,250,432,83,-2.5,0,Clear,6.9,2023-11-11 21:00:00,21
158,251,409,73,-0.7,0,Clear,4.5,2023-11-11 22:00:00,22
125,234,359,60,2.1,0,Clear,1.8,2023-11-11 23:00:00,23
95,150,245,49,4.9,0,Clear,1.9,2023-11-12 00:00:00,0
88,110,198,42,7.0,0,Clear,3.7,2023-11-12 01:00:00,1
55,66,121,37,8.6,0,Clear,3.4,2023-11-12 02:00:00,2
32,41,73,34,9.7,0,Clear,3.9,2023-11-12 03:00:00,3
13,24,37,31,10.4,0,Clear,5.4,2023-11-12 04:00:00,4
8,20,28,29,10.6,0,Clear,7.3,2023-11-12 05:00:00,5
29,65,94,29,10.1,0,Clear,8.4,2023-11-12 06:00:00,6
45,93,138,35,7.8,0,Clear,6.5,2023-11-12 07:00:00,7
113,217,330,35,7.8,0,Clear,7.1,2023-11-12 08:00:00,8
180,336,516,39,6.8,0,Clear,10.3,2023-11-12 09:00:00,9
312,461,773,44,5.4,0,Clear,9.1,2023-11-12 10:00:00,10
314,475,789,49,4.3,0,Clear,7.5,2023-11-12 11:00:00,11
410,514,924,58,3.5,0,Clear,6.6,2023-11-12 12:00:00,12
490,620,1110,65,2.7,0,Clear,7.2,2023-11-12 13:00:00,13
492,621,1113,69,1.8,0,Clear,7.6,2023-11-12 14:00:00,14
441,614,1055,66,1.8,0,Clear,5.5,2023-11-12 15:00:00,15
426,646,1072,63,2.5,0,Clear,3.4,2023-11-12 16:00:00,16
265,494,759,67,1.9,0,Clear,2.6,2023-11-12 17:00:00,17
192,402,594,69,1.3,0,Clear,3.7,2023-11-12 18:00:00,18
151,289,440,69,0.8,0,Clear,4.0,2023-11-12 19:00:00,19
103,207,310,70,0.1,0,Clear,4.2,2023-11-12 20:00:00,20
76,190,266,83,-2.2,0,Clear,8.3,2023-11-12 21:00:00,21
74,162,236,79,-1.1,0,Clear,3.6,2023-11-12 22:00:00,22
38,94,132,67,1.4,0,Clear,2.6,2023-11-12 23:00:00,23
30,32,62,53,4.2,0,Clear,5.0,2023-11-13 00:00:00,0
5,15,20,42,6.8,0,Clear,6.4,2023-11-13 01:00:00,1
4,13,17,35,8.8,0,Clear,6.9,2023-11-13 02:00:00,2
7,12,19,30,10.4,0,Clear,7.9,2023-11-13 03:00:00,3
9,20,29,29,11.5,0,Clear,9.0,2023-11-13 04:00:00,4
20,45,65,28,11.8,0,Clear,11.7,2023-11-13 05:00:00,5
49,186,235,29,10.9,0,Clear,10.8,2023-11-13 06:00:00,6
121,488,609,36,8.3,0,Clear,8.0,2023-11-13 07:00:00,7
229,867,1096,31,8.9,0,Clear,5.9,2023-11-13 08:00:00,8
195,512,707,35,7.7,0,Clear,11.2,2023-11-13 09:00:00,9
142,295,437,38,6.5,0,Clear,12.1,2023-11-13 10:00:00,10
180,352,532,41,5.4,1,Mostly Clear,12.5,2023-11-13 11:00:00,11
189,430,619,44,4.8,1,Mostly Clear,12.9,2023-11-13 12:00:00,12
239,438,677,47,3.8,1,Mostly Clear,5.4,2023-11-13 13:00:00,13
228,480,708,48,3.0,1,Mostly Clear,7.9,2023-11-13 14:00:00,14
264,676,940,51,2.2,1,Mostly Clear,9.7,2023-11-13 15:00:00,15
292,715,1007,53,1.7,1,Mostly Clear,10.5,2023-11-13 16:00:00,16
350,1043,1393,52,2.0,1,Mostly Clear,4.6,2023-11-13 17:00:00,17
283,901,1184,60,0.4,0,Clear,6.0,2023-11-13 18:00:00,18
202,578,780,63,-0.1,0,Clear,5.3,2023-11-13 19:00:00,19
131,411,542,76,-1.5,0,Clear,12.0,2023-11-13 20:00:00,20
125,344,469,79,-2.0,0,Clear,9.4,2023-11-13 21:00:00,21
102,205,307,68,0.1,0,Clear,8.0,2023-11-13 22:00:00,22
62,117,179,52,3.2,0,Clear,9.2,2023-11-13 23:00:00,23
26,35,61,41,6.2,0,Clear,7.9,2023-11-14 00:00:00,0
9,20,29,33,8.5,0,Clear,8.9,2023-11-14 01:00:00,1
7,15,22,29,10.2,0,Clear,11.9,2023-11-14 02:00:00,2
4,14,18,28,11.4,0,Clear,9.8,2023-11-14 03:00:00,3
4,19,23,28,12.0,0,Clear,9.0,2023-11-14 04:00:00,4
30,57,87,28,12.0,0,Clear,7.1,2023-11-14 05:00:00,5
72,229,301,31,10.8,0,Clear,7.0,2023-11-14 06:00:00,6
169,651,820,35,8.7,0,Clear,11.3,2023-11-14 07:00:00,7
324,1103,1427,33,8.0,0,Clear,16.3,2023-11-14 08:00:00,8
221,630,851,36,6.7,0,Clear,13.2,2023-11-14 09:00:00,9
167,300,467,38,5.6,0,Clear,13.8,2023-11-14 10:00:00,10
207,380,587,40,4.4,0,Clear,12.8,2023-11-14 11:00:00,11
237,462,699,43,3.4,0,Clear,11.8,2023-11-14 12:00:00,12
254,490,744,47,2.3,0,Clear,10.7,2023-11-14 13:00:00,13
235,485,720,52,1.2,0,Clear,9.3,2023-11-14 14:00:00,14
353,644,997,58,0.2,0,Clear,5.4,2023-11-14 15:00:00,15
379,850,1229,59,0.2,0,Clear,4.7,2023-11-14 16:00:00,16
492,1176,1668,66,-1.3,0,Clear,6.8,2023-11-14 17:00:00,17
350,907,1257,70,-1.8,0,Clear,8.6,2023-11-14 18:00:00,18
246,600,846,73,-2.1,0,Clear,9.5,2023-11-14 19:00:00,19
170,483,653,80,-2.8,0,Clear,10.2,2023-11-14 20:00:00,20
141,402,543,85,-3.4,0,Clear,8.5,2023-11-14 21:00:00,21
97,234,331,79,-1.6,0,Clear,6.5,2023-11-14 22:00:00,22
60,123,183,68,1.0,0,Clear,5.6,2023-11-14 23:00:00,23
25,68,93,56,3.5,0,Clear,6.2,2023-11-15 00:00:00,0
16,12,28,47,5.4,0,Clear,6.8,2023-11-15 01:00:00,1
8,13,21,39,6.7,0,Clear,6.8,2023-11-15 02:00:00,2
3,4,7,36,7.5,0,Clear,6.3,2023-11-15 03:00:00,3
4,16,20,34,8.0,0,Clear,5.7,2023-11-15 04:00:00,4
23,63,86,34,8.1,0,Clear,5.1,2023-11-15 05:00:00,5
68,257,325,36,7.5,0,Clear,5.5,2023-11-15 06:00:00,6
181,667,848,41,5.4,0,Clear,7.8,2023-11-15 07:00:00,7
282,1183,1465,42,5.8,0,Clear,5.6,2023-11-15 08:00:00,8
180,627,807,42,5.5,0,Clear,5.3,2023-11-15 09:00:00,9
150,341,491,48,3.8,0,Clear,7.1,2023-11-15 10:00:00,10
162,360,522,50,3.2,0,Clear,5.8,2023-11-15 11:00:00,11
210,463,673,48,3.8,0,Clear,4.0,2023-11-15 12:00:00,12
175,468,643,57,1.8,0,Clear,5.1,2023-11-15 13:00:00,13
224,466,690,60,1.1,0,Clear,5.1,2023-11-15 14:00:00,14
266,630,896,59,1.3,0,Clear,1.8,2023-11-15 15:00:00,15
332,833,1165,62,0.6,0,Clear,1.3,2023-11-15 16:00:00,16
384,1172,1556,78,-2.7,0,Clear,6.8,2023-11-15 17:00:00,17
351,895,1246,84,-3.8,0,Clear,9.2,2023-11-15 18:00:00,18
297,696,993,88,-4.6,0,Clear,7.9,2023-11-15 19:00:00,19
179,475,654,88,-4.7,0,Clear,8.7,2023-11-15 20:00:00,20
189,406,595,85,-4.3,0,Clear,7.2,2023-11-15 21:00:00,21
125,288,413,76,-2.5,0,Clear,3.8,2023-11-15 22:00:00,22
78,169,247,64,0.0,0,Clear,2.9,2023-11-15 23:00:00,23
37,60,97,52,2.7,0,Clear,1.6,2023-11-16 00:00:00,0
7,26,33,44,4.7,0,Clear,0.8,2023-11-16 01:00:00,1
5,13,18,38,6.3,0,Clear,0.8,2023-11-16 02:00:00,2
6,16,22,33,7.4,0,Clear,3.1,2023-11-16 03:00:00,3
4,19,23,31,8.1,0,Clear,5.4,2023-11-16 04:00:00,4
18,75,93,29,8.3,0,Clear,6.4,2023-11-16 05:00:00,5
78,232,310,29,7.8,0,Clear,6.1,2023-11-16 06:00:00,6
167,616,783,33,6.1,0,Clear,5.3,2023-11-16 07:00:00,7
283,1066,1349,30,6.8,0,Clear,4.4,2023-11-16 08:00:00,8
193,654,847,36,4.5,0,Clear,8.6,2023-11-16 09:00:00,9
160,364,524,44,3.2,0,Clear,8.4,2023-11-16 10:00:00,10
172,403,575,53,2.2,0,Clear,8.1,2023-11-16 11:00:00,11
237,484,721,56,1.4,0,Clear,8.8,2023-11-16 12:00:00,12
231,521,752,54,0.2,0,Clear,7.2,2023-11-16 13:00:00,13
308,475,783,55,-0.4,0,Clear,6.5,2023-11-16 14:00:00,14
341,688,1029,58,-1.0,0,Clear,7.3,2023-11-16 15:00:00,15
393,871,1264,60,-1.1,0,Clear,6.1,2023-11-16 16:00:00,16
467,1231,1698,60,-1.0,0,Clear,5.0,2023-11-16 17:00:00,17
350,940,1290,62,-1.2,0,Clear,4.8,2023-11-16 18:00:00,18
282,668,950,68,-2.4,0,Clear,6.0,2023-11-16 19:00:00,19
203,468,671,80,-4.3,0,Clear,7.9,2023-11-16 20:00:00,20
171,387,558,83,-4.7,0,Clear,7.9,2023-11-16 21:00:00,21
145,273,418,79,-3.9,0,Clear,2.9,2023-11-16 22:00:00,22
122,193,315,64,-1.0,0,Clear,3.1,2023-11-16 23:00:00,23
60,92,152,52,2.2,0,Clear,3.4,2023-11-17 00:00:00,0
46,49,95,43,4.5,0,Clear,3.1,2023-11-17 01:00:00,1
13,18,31,37,6.2,0,Clear,2.3,2023-11-17 02:00:00,2
14,12,26,33,7.4,0,Clear,1.9,2023-11-17 03:00:00,3
5,16,21,31,8.0,0,Clear,1.1,2023-11-17 04:00:00,4
28,44,72,30,8.1,0,Clear,2.9,2023-11-17 05:00:00,5
59,170,229,32,7.5,0,Clear,4.7,2023-11-17 06:00:00,6
147,438,585,37,5.7,0,Clear,5.4,2023-11-17 07:00:00,7
210,750,960,33,6.5,1,Mostly Clear,4.6,2023-11-17 08:00:00,8
238,536,774,40,4.4,1,Mostly Clear,6.8,2023-11-17 09:00:00,9
182,394,576,44,3.2,1,Mostly Clear,6.9,2023-11-17 10:00:00,10
233,464,697,46,2.4,0,Clear,6.0,2023-11-17 11:00:00,11
306,558,864,47,1.8,1,Mostly Clear,5.4,2023-11-17 12:00:00,12
310,597,907,46,0.9,1,Mostly Clear,6.4,2023-11-17 13:00:00,13
364,632,996,45,0.1,1,Mostly Clear,7.1,2023-11-17 14:00:00,14
415,791,1206,45,0.1,1,Mostly Clear,5.2,2023-11-17 15:00:00,15
412,891,1303,41,1.0,0,Clear,2.0,2023-11-17 16:00:00,16
426,910,1336,43,0.7,1,Mostly Clear,4.1,2023-11-17 17:00:00,17
404,747,1151,53,-1.1,1,Mostly Clear,5.4,2023-11-17 18:00:00,18
299,627,926,51,-0.2,1,Mostly Clear,3.1,2023-11-17 19:00:00,19
241,413,654,52,-1.0,1,Mostly Clear,3.2,2023-11-17 20:00:00,20
242,319,561,55,-1.4,1,Mostly Clear,2.5,2023-11-17 21:00:00,21
120,286,406,56,-1.4,1,Mostly Clear,1.1,2023-11-17 22:00:00,22
92,200,292,49,0.5,1,Mostly Clear,0.8,2023-11-17 23:00:00,23
80,165,245,40,3.3,0,Clear,1.5,2023-11-18 00:00:00,0
67,117,184,32,5.3,0,Clear,1.6,2023-11-18 01:00:00,1
48,90,138,26,6.9,1,Mostly Clear,2.2,2023-11-18 02:00:00,2
26,18,44,24,8.0,1,Mostly Clear,3.6,2023-11-18 03:00:00,3
15,15,30,23,8.7,1,Mostly Clear,4.1,2023-11-18 04:00:00,4
14,26,40,24,8.8,1,Mostly Clear,4.0,2023-11-18 05:00:00,5
44,76,120,25,8.6,1,Mostly Clear,3.1,2023-11-18 06:00:00,6
66,150,216,28,7.3,1,Mostly Clear,6.6,2023-11-18 07:00:00,7
138,279,417,29,7.5,2,Partly Cloudy,9.2,2023-11-18 08:00:00,8
281,450,731,30,6.7,1,Mostly Clear,7.3,2023-11-18 09:00:00,9
375,526,901,33,5.4,1,Mostly Clear,8.1,2023-11-18 10:00:00,10
488,673,1161,38,4.3,1,Mostly Clear,7.4,2023-11-18 11:00:00,11
452,615,1067,42,3.6,2,Partly Cloudy,6.6,2023-11-18 12:00:00,12
568,683,1251,43,3.2,2,Partly Cloudy,7.6,2023-11-18 13:00:00,13
580,644,1224,42,2.3,2,Partly Cloudy,7.3,2023-11-18 14:00:00,14
611,690,1301,39,1.9,2,Partly Cloudy,6.2,2023-11-18 15:00:00,15
447,652,1099,38,2.0,3,Cloudy,4.9,2023-11-18 16:00:00,16
342,513,855,39,1.7,2,Partly Cloudy,4.3,2023-11-18 17:00:00,17
250,444,694,38,2.0,3,Cloudy,3.6,2023-11-18 18:00:00,18
218,354,572,38,2.2,3,Cloudy,2.5,2023-11-18 19:00:00,19
174,289,463,46,1.2,2,Partly Cloudy,1.3,2023-11-18 20:00:00,20
175,186,361,50,0.3,2,Partly Cloudy,5.6,2023-11-18 21:00:00,21
175,289,464,50,1.3,2,Partly Cloudy,3.2,2023-11-18 22:00:00,22
133,211,344,43,3.2,2,Partly Cloudy,1.5,2023-11-18 23:00:00,23
94,163,257,35,5.1,1,Mostly Clear,3.1,2023-11-19 00:00:00,0
63,88,151,29,7.0,1,Mostly Clear,2.6,2023-11-19 01:00:00,1
50,77,127,24,8.5,1,Mostly Clear,1.8,2023-11-19 02:00:00,2
39,33,72,22,9.5,1,Mostly Clear,1.0,2023-11-19 03:00:00,3
16,17,33,21,10.2,1,Mostly Clear,1.5,2023-11-19 04:00:00,4
14,13,27,20,10.5,1,Mostly Clear,4.6,2023-11-19 05:00:00,5
28,50,78,20,10.2,0,Clear,5.6,2023-11-19 06:00:00,6
59,106,165,24,8.2,0,Clear,5.1,2023-11-19 07:00:00,7
101,221,322,22,8.1,0,Clear,9.0,2023-11-19 08:00:00,8
239,318,557,25,7.0,1,Mostly Clear,10.3,2023-11-19 09:00:00,9
296,491,787,28,5.8,0,Clear,8.5,2023-11-19 10:00:00,10
387,540,927,30,4.7,0,Clear,7.3,2023-11-19 11:00:00,11
452,635,1087,31,4.2,0,Clear,5.9,2023-11-19 12:00:00,12
503,672,1175,35,2.9,0,Clear,7.7,2023-11-19 13:00:00,13
497,649,1146,34,4.0,0,Clear,2.6,2023-11-19 14:00:00,14
479,691,1170,38,2.7,0,Clear,4.4,2023-11-19 15:00:00,15
442,625,1067,45,0.9,0,Clear,5.7,2023-11-19 16:00:00,16
312,496,808,42,1.8,0,Clear,3.3,2023-11-19 17:00:00,17
190,338,528,46,0.9,0,Clear,4.2,2023-11-19 18:00:00,18
156,314,470,54,-0.7,0,Clear,5.4,2023-11-19 19:00:00,19
117,211,328,63,-1.8,0,Clear,6.6,2023-11-19 20:00:00,20
93,179,272,66,-2.0,0,Clear,9.8,2023-11-19 21:00:00,21
94,142,236,55,0.1,0,Clear,7.6,2023-11-19 22:00:00,22
70,95,165,45,2.4,0,Clear,2.5,2023-11-19 23:00:00,23
17,30,47,38,5.4,0,Clear,8.0,2023-11-20 00:00:00,0
7,12,19,31,7.8,0,Clear,8.6,2023-11-20 01:00:00,1
6,12,18,27,9.4,0,Clear,5.4,2023-11-20 02:00:00,2
3,8,11,24,10.8,0,Clear,5.4,2023-11-20 03:00:00,3
4,17,21,22,12.0,0,Clear,5.7,2023-11-20 04:00:00,4
22,51,73,22,12.5,0,Clear,5.2,2023-11-20 05:00:00,5
56,185,241,24,11.3,0,Clear,9.9,2023-11-20 06:00:00,6
98,446,544,28,9.2,0,Clear,11.2,2023-11-20 07:00:00,7
174,793,967,29,8.6,0,Clear,6.7,2023-11-20 08:00:00,8
181,411,592,30,8.1,0,Clear,10.9,2023-11-20 09:00:00,9
138,277,415,31,7.4,0,Clear,15.4,2023-11-20 10:00:00,10
171,339,510,33,6.5,0,Clear,15.1,2023-11-20 11:00:00,11
206,413,619,37,5.3,0,Clear,14.0,2023-11-20 12:00:00,12
192,441,633,38,4.6,0,Clear,14.4,2023-11-20 13:00:00,13
204,420,624,42,3.7,0,Clear,15.7,2023-11-20 14:00:00,14
277,600,877,46,2.2,0,Clear,8.8,2023-11-20 15:00:00,15
240,613,853,49,1.1,0,Clear,8.8,2023-11-20 16:00:00,16
277,839,1116,52,0.3,0,Clear,8.9,2023-11-20 17:00:00,17
238,704,942,54,-0.1,0,Clear,11.3,2023-11-20 18:00:00,18
137,426,563,59,-1.3,0,Clear,8.7,2023-11-20 19:00:00,19
107,321,428,58,-1.9,0,Clear,6.0,2023-11-20 20:00:00,20
82,249,331,62,-2.7,0,Clear,6.3,2023-11-20 21:00:00,21
67,175,242,57,-1.2,0,Clear,5.9,2023-11-20 22:00:00,22
59,83,142,45,1.4,0,Clear,6.2,2023-11-20 23:00:00,23
24,27,51,34,3.9,0,Clear,8.8,2023-11-21 00:00:00,0
12,10,22,28,5.8,0,Clear,10.6,2023-11-21 01:00:00,1
3,10,13,24,7.4,0,Clear,10.7,2023-11-21 02:00:00,2
3,8,11,22,8.6,0,Clear,9.7,2023-11-21 03:00:00,3
5,22,27,21,9.2,0,Clear,7.8,2023-11-21 04:00:00,4
25,55,80,21,9.2,0,Clear,6.0,2023-11-21 05:00:00,5
56,174,230,26,8.0,0,Clear,4.0,2023-11-21 06:00:00,6
97,388,485,28,6.5,0,Clear,5.7,2023-11-21 07:00:00,7
88,440,528,29,6.5,0,Clear,5.8,2023-11-21 08:00:00,8
50,226,276,33,5.4,0,Clear,5.8,2023-11-21 09:00:00,9
39,137,176,37,4.3,0,Clear,6.0,2023-11-21 10:00:00,10
34,109,143,35,4.9,0,Clear,4.0,2023-11-21 11:00:00,11
47,121,168,37,4.2,0,Clear,2.2,2023-11-21 12:00:00,12
24,117,141,40,3.4,0,Clear,1.6,2023-11-21 13:00:00,13
36,102,138,45,1.7,0,Clear,4.7,2023-11-21 14:00:00,14
57,132,189,52,-0.1,0,Clear,6.0,2023-11-21 15:00:00,15
33,156,189,53,-0.3,0,Clear,4.8,2023-11-21 16:00:00,16
60,205,265,51,0.1,0,Clear,3.7,2023-11-21 17:00:00,17
38,182,220,62,-2.4,0,Clear,6.9,2023-11-21 18:00:00,18
30,82,112,66,-3.2,0,Clear,6.8,2023-11-21 19:00:00,19
20,53,73,61,-2.9,0,Clear,6.2,2023-11-21 20:00:00,20
15,38,53,71,-3.7,0,Clear,10.1,2023-11-21 21:00:00,21
13,30,43,66,-2.0,0,Clear,7.7,2023-11-21 22:00:00,22
16,37,53,53,0.9,0,Clear,4.7,2023-11-21 23:00:00,23
15,28,43,40,3.9,0,Clear,3.3,2023-11-22 00:00:00,0
8,30,38,32,5.9,0,Clear,2.7,2023-11-22 01:00:00,1
7,11,18,26,7.8,0,Clear,5.4,2023-11-22 02:00:00,2
8,8,16,23,9.0,0,Clear,6.4,2023-11-22 03:00:00,3
4,20,24,21,9.6,0,Clear,7.6,2023-11-22 04:00:00,4
13,58,71,21,9.7,0,Clear,7.3,2023-11-22 05:00:00,5
33,124,157,24,8.2,0,Clear,6.5,2023-11-22 06:00:00,6
61,270,331,30,5.8,0,Clear,7.2,2023-11-22 07:00:00,7
106,347,453,31,5.4,0,Clear,6.8,2023-11-22 08:00:00,8
123,295,418,32,4.4,0,Clear,9.1,2023-11-22 09:00:00,9
203,286,489,35,3.0,0,Clear,6.7,2023-11-22 10:00:00,10
225,416,641,34,3.1,0,Clear,5.1,2023-11-22 11:00:00,11
208,463,671,33,3.4,0,Clear,2.9,2023-11-22 12:00:00,12
299,475,774,35,2.7,0,Clear,2.9,2023-11-22 13:00:00,13
294,586,880,37,1.9,0,Clear,3.8,2023-11-22 14:00:00,14
320,583,903,44,-0.9,0,Clear,6.7,2023-11-22 15:00:00,15
324,566,890,45,-1.5,0,Clear,6.0,2023-11-22 16:00:00,16
204,487,691,42,-0.5,0,Clear,2.5,2023-11-22 17:00:00,17
137,385,522,45,-1.5,0,Clear,1.5,2023-11-22 18:00:00,18
145,296,441,53,-3.8,0,Clear,3.6,2023-11-22 19:00:00,19
89,217,306,67,-5.3,0,Clear,5.9,2023-11-22 20:00:00,20
106,187,293,66,-5.0,0,Clear,5.1,2023-11-22 21:00:00,21
91,152,243,60,-3.6,0,Clear,4.6,2023-11-22 22:00:00,22
64,93,157,53,-1.7,0,Clear,2.5,2023-11-22 23:00:00,23
53,71,124,42,1.3,0,Clear,0.8,2023-11-23 00:00:00,0
29,37,66,34,3.8,0,Clear,1.8,2023-11-23 01:00:00,1
16,11,27,27,6.1,0,Clear,5.2,2023-11-23 02:00:00,2
3,19,22,24,7.3,0,Clear,4.6,2023-11-23 03:00:00,3
7,16,23,23,8.0,0,Clear,6.5,2023-11-23 04:00:00,4
6,25,31,24,8.1,0,Clear,6.9,2023-11-23 05:00:00,5
27,45,72,27,7.0,1,Mostly Clear,5.8,2023-11-23 06:00:00,6
43,89,132,30,5.6,1,Mostly Clear,6.2,2023-11-23 07:00:00,7
114,171,285,27,6.1,1,Mostly Clear,9.0,2023-11-23 08:00:00,8
132,205,337,28,5.6,0,Clear,8.7,2023-11-23 09:00:00,9
211,235,446,34,4.0,2,Partly Cloudy,9.4,2023-11-23 10:00:00,10
225,270,495,36,4.5,0,Clear,13.1,2023-11-23 11:00:00,11
286,275,561,35,3.7,1,Mostly Clear,14.0,2023-11-23 12:00:00,12
284,281,565,36,3.6,0,Clear,13.6,2023-11-23 13:00:00,13
338,286,624,43,3.2,0,Clear,17.4,2023-11-23 14:00:00,14
268,278,546,43,2.7,0,Clear,17.3,2023-11-23 15:00:00,15
231,230,461,45,1.7,0,Clear,14.7,2023-11-23 16:00:00,16
163,165,328,49,0.3,0,Clear,12.5,2023-11-23 17:00:00,17
83,129,212,52,-0.7,0,Clear,10.5,2023-11-23 18:00:00,18
85,93,178,54,-1.1,0,Clear,11.5,2023-11-23 19:00:00,19
47,111,158,63,-0.9,0,Clear,14.9,2023-11-23 20:00:00,20
51,110,161,63,-1.3,0,Clear,16.9,2023-11-23 21:00:00,21
58,120,178,54,-0.2,0,Clear,14.3,2023-11-23 22:00:00,22
32,71,103,47,1.8,0,Clear,10.0,2023-11-23 23:00:00,23
15,43,58,39,3.8,0,Clear,9.7,2023-11-24 00:00:00,0
7,18,25,32,5.6,0,Clear,9.2,2023-11-24 01:00:00,1
11,12,23,28,7.3,0,Clear,7.3,2023-11-24 02:00:00,2
6,11,17,26,8.5,0,Clear,7.7,2023-11-24 03:00:00,3
5,10,15,25,9.1,0,Clear,8.7,2023-11-24 04:00:00,4
7,17,24,25,9.0,0,Clear,8.2,2023-11-24 05:00:00,5
14,35,49,28,7.6,0,Clear,6.6,2023-11-24 06:00:00,6
38,90,128,35,5.1,1,Mostly Clear,6.8,2023-11-24 07:00:00,7
87,133,220,32,5.3,1,Mostly Clear,9.7,2023-11-24 08:00:00,8
149,162,311,34,4.3,0,Clear,10.9,2023-11-24 09:00:00,9
199,213,412,38,3.2,0,Clear,10.1,2023-11-24 10:00:00,10
296,279,575,42,2.1,0,Clear,9.7,2023-11-24 11:00:00,11
337,324,661,47,1.1,0,Clear,9.4,2023-11-24 12:00:00,12
354,342,696,51,0.1,0,Clear,9.1,2023-11-24 13:00:00,13
356,367,723,57,-0.9,1,Mostly Clear,5.9,2023-11-24 14:00:00,14
335,449,784,52,0.2,1,Mostly Clear,3.4,2023-11-24 15:00:00,15
322,423,745,59,-1.3,1,Mostly Clear,4.8,2023-11-24 16:00:00,16
208,364,572,63,-2.4,1,Mostly Clear,6.5,2023-11-24 17:00:00,17
150,265,415,66,-3.1,1,Mostly Clear,6.0,2023-11-24 18:00:00,18
121,213,334,70,-3.8,1,Mostly Clear,5.4,2023-11-24 19:00:00,19
73,155,228,78,-5.0,1,Mostly Clear,6.6,2023-11-24 20:00:00,20
82,152,234,78,-5.0,1,Mostly Clear,5.9,2023-11-24 21:00:00,21
52,138,190,70,-3.7,0,Clear,3.8,2023-11-24 22:00:00,22
72,110,182,61,-1.8,0,Clear,1.6,2023-11-24 23:00:00,23
33,63,96,48,1.6,0,Clear,2.0,2023-11-25 00:00:00,0
32,51,83,41,3.8,0,Clear,2.2,2023-11-25 01:00:00,1
34,37,71,35,5.6,0,Clear,2.9,2023-11-25 02:00:00,2
25,22,47,31,6.8,0,Clear,2.4,2023-11-25 03:00:00,3
5,8,13,29,7.5,1,Mostly Clear,1.3,2023-11-25 04:00:00,4
8,17,25,28,7.7,1,Mostly Clear,2.6,2023-11-25 05:00:00,5
18,50,68,31,6.7,1,Mostly Clear,4.7,2023-11-25 06:00:00,6
43,69,112,34,5.6,1,Mostly Clear,4.7,2023-11-25 07:00:00,7
78,141,219,36,4.9,0,Clear,6.8,2023-11-25 08:00:00,8
147,255,402,39,3.9,0,Clear,9.8,2023-11-25 09:00:00,9
191,250,441,44,2.4,0,Clear,8.9,2023-11-25 10:00:00,10
239,339,578,45,1.9,0,Clear,5.6,2023-11-25 11:00:00,11
262,342,604,41,2.9,0,Clear,2.9,2023-11-25 12:00:00,12
272,345,617,43,2.3,0,Clear,2.1,2023-11-25 13:00:00,13
276,369,645,52,0.3,0,Clear,5.2,2023-11-25 14:00:00,14
351,394,745,59,-1.1,0,Clear,6.0,2023-11-25 15:00:00,15
217,395,612,59,-1.5,1,Mostly Clear,5.4,2023-11-25 16:00:00,16
182,351,533,55,-0.5,1,Mostly Clear,3.3,2023-11-25 17:00:00,17
133,261,394,58,-1.2,1,Mostly Clear,4.0,2023-11-25 18:00:00,18
92,218,310,63,-1.9,1,Mostly Clear,4.0,2023-11-25 19:00:00,19
77,168,245,76,-4.3,1,Mostly Clear,6.4,2023-11-25 20:00:00,20
70,139,209,80,-5.1,1,Mostly Clear,9.7,2023-11-25 21:00:00,21
64,123,187,73,-3.6,0,Clear,5.4,2023-11-25 22:00:00,22
73,130,203,65,-1.8,0,Clear,1.8,2023-11-25 23:00:00,23
42,78,120,50,1.5,0,Clear,0.7,2023-11-26 00:00:00,0
20,59,79,41,3.7,1,Mostly Clear,2.3,2023-11-26 01:00:00,1
31,37,68,36,5.3,0,Clear,1.8,2023-11-26 02:00:00,2
16,24,40,32,6.5,0,Clear,2.9,2023-11-26 03:00:00,3
4,11,15,30,7.2,1,Mostly Clear,1.8,2023-11-26 04:00:00,4
7,10,17,28,7.5,1,Mostly Clear,4.1,2023-11-26 05:00:00,5
10,41,51,32,6.5,1,Mostly Clear,3.6,2023-11-26 06:00:00,6
37,63,100,35,4.8,1,Mostly Clear,7.5,2023-11-26 07:00:00,7
56,147,203,33,5.4,1,Mostly Clear,10.2,2023-11-26 08:00:00,8
88,211,299,37,4.4,1,Mostly Clear,10.1,2023-11-26 09:00:00,9
158,303,461,40,3.5,1,Mostly Clear,7.7,2023-11-26 10:00:00,10
164,332,496,41,3.2,1,Mostly Clear,4.4,2023-11-26 11:00:00,11
165,369,534,39,3.5,1,Mostly Clear,1.0,2023-11-26 12:00:00,12
115,351,466,46,1.9,2,Partly Cloudy,5.1,2023-11-26 13:00:00,13
168,363,531,53,1.0,2,Partly Cloudy,5.8,2023-11-26 14:00:00,14
132,273,405,53,1.5,2,Partly Cloudy,3.8,2023-11-26 15:00:00,15
65,205,270,54,1.3,1,Mostly Clear,3.4,2023-11-26 16:00:00,16
54,165,219,56,0.9,1,Mostly Clear,1.6,2023-11-26 17:00:00,17
31,130,161,57,0.4,1,Mostly Clear,1.4,2023-11-26 18:00:00,18
36,130,166,61,-0.6,1,Mostly Clear,2.9,2023-11-26 19:00:00,19
49,139,188,62,-1.1,1,Mostly Clear,3.1,2023-11-26 20:00:00,20
38,108,146,71,-3.4,1,Mostly Clear,6.8,2023-11-26 21:00:00,21
42,110,152,64,-2.3,1,Mostly Clear,6.6,2023-11-26 22:00:00,22
23,72,95,54,-0.1,1,Mostly Clear,5.2,2023-11-26 23:00:00,23
15,33,48,45,1.9,1,Mostly Clear,3.3,2023-11-27 00:00:00,0
6,8,14,39,3.6,1,Mostly Clear,4.5,2023-11-27 01:00:00,1
4,11,15,35,5.0,1,Mostly Clear,3.4,2023-11-27 02:00:00,2
14,5,19,32,6.0,1,Mostly Clear,2.2,2023-11-27 03:00:00,3
8,14,22,30,6.7,0,Clear,1.3,2023-11-27 04:00:00,4
24,54,78,29,6.9,0,Clear,1.3,2023-11-27 05:00:00,5
48,175,223,32,6.2,0,Clear,3.2,2023-11-27 06:00:00,6
102,431,533,35,4.3,0,Clear,7.3,2023-11-27 07:00:00,7
162,816,978,36,4.2,0,Clear,5.5,2023-11-27 08:00:00,8
106,491,597,35,4.5,0,Clear,4.8,2023-11-27 09:00:00,9
91,295,386,41,2.4,0,Clear,8.8,2023-11-27 10:00:00,10
95,349,444,45,1.3,0,Clear,9.2,2023-11-27 11:00:00,11
120,432,552,45,1.4,0,Clear,4.3,2023-11-27 12:00:00,12
112,389,501,44,1.7,0,Clear,2.5,2023-11-27 13:00:00,13
144,395,539,53,-0.5,0,Clear,5.8,2023-11-27 14:00:00,14
151,516,667,63,-2.1,0,Clear,8.0,2023-11-27 15:00:00,15
174,597,771,68,-2.9,0,Clear,7.7,2023-11-27 16:00:00,16
243,857,1100,70,-3.5,0,Clear,7.4,2023-11-27 17:00:00,17
161,638,799,65,-3.0,0,Clear,4.6,2023-11-27 18:00:00,18
105,403,508,60,-2.1,0,Clear,2.4,2023-11-27 19:00:00,19
76,268,344,69,-2.7,0,Clear,2.2,2023-11-27 20:00:00,20
62,213,275,73,-3.0,0,Clear,2.3,2023-11-27 21:00:00,21
44,112,156,74,-2.8,0,Clear,1.8,2023-11-27 22:00:00,22
55,73,128,68,-1.6,0,Clear,4.1,2023-11-27 23:00:00,23
15,32,47,49,2.1,0,Clear,8.3,2023-11-28 00:00:00,0
9,12,21,38,4.7,0,Clear,7.9,2023-11-28 01:00:00,1
6,9,15,34,6.4,0,Clear,4.3,2023-11-28 02:00:00,2
6,5,11,32,7.3,0,Clear,2.6,2023-11-28 03:00:00,3
4,16,20,30,7.9,0,Clear,2.9,2023-11-28 04:00:00,4
19,53,72,30,8.1,0,Clear,4.6,2023-11-28 05:00:00,5
55,195,250,33,6.8,0,Clear,4.3,2023-11-28 06:00:00,6
136,558,694,33,6.6,0,Clear,4.4,2023-11-28 07:00:00,7
207,925,1132,35,5.3,0,Clear,11.5,2023-11-28 08:00:00,8
122,528,650,39,3.7,0,Clear,10.4,2023-11-28 09:00:00,9
79,251,330,41,2.5,0,Clear,8.7,2023-11-28 10:00:00,10
72,310,382,43,1.5,0,Clear,8.0,2023-11-28 11:00:00,11
82,383,465,41,2.2,0,Clear,4.7,2023-11-28 12:00:00,12
99,345,444,41,2.4,0,Clear,3.6,2023-11-28 13:00:00,13
101,337,438,50,-0.0,1,Mostly Clear,5.7,2023-11-28 14:00:00,14
131,458,589,59,-1.7,0,Clear,8.4,2023-11-28 15:00:00,15
165,598,763,64,-2.5,0,Clear,7.0,2023-11-28 16:00:00,16
180,813,993,66,-2.9,1,Mostly Clear,6.4,2023-11-28 17:00:00,17
154,641,795,64,-2.6,1,Mostly Clear,5.1,2023-11-28 18:00:00,18
98,400,498,65,-2.6,1,Mostly Clear,4.5,2023-11-28 19:00:00,19
77,295,372,59,-1.6,1,Mostly Clear,3.1,2023-11-28 20:00:00,20
49,204,253,61,-2.2,1,Mostly Clear,2.9,2023-11-28 21:00:00,21
35,134,169,67,-3.6,1,Mostly Clear,6.0,2023-11-28 22:00:00,22
36,74,110,59,-1.8,1,Mostly Clear,4.6,2023-11-28 23:00:00,23
12,22,34,45,1.5,1,Mostly Clear,5.4,2023-11-29 00:00:00,0
5,15,20,37,3.8,0,Clear,6.3,2023-11-29 01:00:00,1
3,6,9,33,5.4,0,Clear,6.1,2023-11-29 02:00:00,2
4,1,5,30,6.4,0,Clear,7.0,2023-11-29 03:00:00,3
6,13,19,29,6.9,0,Clear,7.4,2023-11-29 04:00:00,4
15,51,66,29,7.0,0,Clear,7.1,2023-11-29 05:00:00,5
43,174,217,33,5.5,1,Mostly Clear,5.7,2023-11-29 06:00:00,6
102,520,622,38,3.7,1,Mostly Clear,7.4,2023-11-29 07:00:00,7
162,933,1095,37,4.0,1,Mostly Clear,6.2,2023-11-29 08:00:00,8
137,461,598,40,2.8,1,Mostly Clear,8.9,2023-11-29 09:00:00,9
83,261,344,44,1.6,1,Mostly Clear,9.0,2023-11-29 10:00:00,10
89,305,394,49,0.4,2,Partly Cloudy,7.6,2023-11-29 11:00:00,11
105,385,490,54,-0.7,1,Mostly Clear,6.6,2023-11-29 12:00:00,12
105,351,456,54,-0.6,2,Partly Cloudy,4.8,2023-11-29 13:00:00,13
126,341,467,53,-0.5,2,Partly Cloudy,4.1,2023-11-29 14:00:00,14
158,499,657,53,-0.5,1,Mostly Clear,1.9,2023-11-29 15:00:00,15
186,595,781,55,-1.0,1,Mostly Clear,1.8,2023-11-29 16:00:00,16
215,817,1032,62,-2.6,1,Mostly Clear,4.4,2023-11-29 17:00:00,17
166,738,904,67,-3.6,2,Partly Cloudy,6.2,2023-11-29 18:00:00,18
149,548,697,68,-3.8,2,Partly Cloudy,7.2,2023-11-29 19:00:00,19
96,333,429,68,-4.2,1,Mostly Clear,7.7,2023-11-29 20:00:00,20
80,259,339,69,-4.5,1,Mostly Clear,9.5,2023-11-29 21:00:00,21
72,192,264,63,-3.2,1,Mostly Clear,8.7,2023-11-29 22:00:00,22
42,100,142,53,-1.0,0,Clear,5.0,2023-11-29 23:00:00,23
18,43,61,45,1.1,0,Clear,3.6,2023-11-30 00:00:00,0
4,20,24,39,3.0,0,Clear,4.3,2023-11-30 01:00:00,1
2,10,12,34,4.4,1,Mostly Clear,5.4,2023-11-30 02:00:00,2
2,5,7,32,5.3,1,Mostly Clear,5.8,2023-11-30 03:00:00,3
9,18,27,31,5.8,1,Mostly Clear,3.3,2023-11-30 04:00:00,4
17,62,79,31,5.8,1,Mostly Clear,2.4,2023-11-30 05:00:00,5
56,179,235,32,5.2,1,Mostly Clear,2.4,2023-11-30 06:00:00,6
108,543,651,36,3.7,1,Mostly Clear,4.8,2023-11-30 07:00:00,7
187,969,1156,39,3.3,1,Mostly Clear,8.9,2023-11-30 08:00:00,8
125,546,671,43,2.4,1,Mostly Clear,7.6,2023-11-30 09:00:00,9
136,326,462,46,1.9,2,Partly Cloudy,7.7,2023-11-30 10:00:00,10
137,343,480,48,1.2,3,Cloudy,6.8,2023-11-30 11:00:00,11
130,451,581,51,0.7,2,Partly Cloudy,4.4,2023-11-30 12:00:00,12
138,406,544,48,1.3,2,Partly Cloudy,1.8,2023-11-30 13:00:00,13
194,403,597,53,0.6,1,Mostly Clear,3.2,2023-11-30 14:00:00,14
236,608,844,61,-1.4,1,Mostly Clear,6.5,2023-11-30 15:00:00,15
274,792,1066,59,-1.9,1,Mostly Clear,8.6,2023-11-30 16:00:00,16
348,1063,1411,62,-2.4,1,Mostly Clear,8.9,2023-11-30 17:00:00,17
272,851,1123,70,-3.6,1,Mostly Clear,6.0,2023-11-30 18:00:00,18
217,632,849,68,-2.9,1,Mostly Clear,3.5,2023-11-30 19:00:00,19
157,419,576,67,-2.6,1,Mostly Clear,3.8,2023-11-30 20:00:00,20
136,350,486,71,-3.4,1,Mostly Clear,3.0,2023-11-30 21:00:00,21
96,279,375,73,-3.8,1,Mostly Clear,6.6,2023-11-30 22:00:00,22
75,163,238,65,-1.8,1,Mostly Clear,3.2,2023-11-30 23:00:00,23
49,93,142,52,1.3,1,Mostly Clear,2.5,2023-12-01 00:00:00,0
20,50,70,40,3.5,1,Mostly Clear,2.9,2023-12-01 01:00:00,1
16,18,34,34,5.0,0,Clear,1.9,2023-12-01 02:00:00,2
11,8,19,31,5.8,0,Clear,1.5,2023-12-01 03:00:00,3
9,14,23,29,6.1,0,Clear,2.3,2023-12-01 04:00:00,4
31,57,88,27,6.2,1,Mostly Clear,5.0,2023-12-01 05:00:00,5
50,159,209,30,5.3,1,Mostly Clear,5.1,2023-12-01 06:00:00,6
96,400,496,30,5.1,2,Partly Cloudy,3.7,2023-12-01 07:00:00,7
182,652,834,36,3.6,2,Partly Cloudy,9.9,2023-12-01 08:00:00,8
154,455,609,40,2.1,0,Clear,11.0,2023-12-01 09:00:00,9
103,311,414,46,0.5,0,Clear,7.1,2023-12-01 10:00:00,10
139,405,544,53,-0.2,0,Clear,6.3,2023-12-01 11:00:00,11
138,413,551,57,-0.4,0,Clear,5.7,2023-12-01 12:00:00,12
146,401,547,54,-0.0,0,Clear,4.4,2023-12-01 13:00:00,13
118,348,466,51,-0.1,0,Clear,3.2,2023-12-01 14:00:00,14
108,284,392,52,-0.7,0,Clear,3.3,2023-12-01 15:00:00,15
72,307,379,56,-1.9,0,Clear,4.3,2023-12-01 16:00:00,16
132,454,586,57,-2.1,0,Clear,2.9,2023-12-01 17:00:00,17
148,443,591,58,-2.6,0,Clear,0.7,2023-12-01 18:00:00,18
110,345,455,60,-3.0,0,Clear,4.1,2023-12-01 19:00:00,19
114,262,376,68,-3.8,0,Clear,3.4,2023-12-01 20:00:00,20
95,221,316,78,-5.1,0,Clear,4.5,2023-12-01 21:00:00,21
116,243,359,90,-6.3,0,Clear,3.1,2023-12-01 22:00:00,22
104,227,331,80,-5.0,0,Clear,1.3,2023-12-01 23:00:00,23
99,177,276,63,-2.0,0,Clear,0.4,2023-12-02 00:00:00,0
81,92,173,49,1.2,0,Clear,1.6,2023-12-02 01:00:00,1
33,56,89,41,3.2,0,Clear,3.4,2023-12-02 02:00:00,2
21,25,46,35,4.5,0,Clear,3.8,2023-12-02 03:00:00,3
10,15,25,31,5.2,0,Clear,3.3,2023-12-02 04:00:00,4
13,32,45,30,5.3,0,Clear,3.5,2023-12-02 05:00:00,5
27,59,86,35,3.8,0,Clear,4.7,2023-12-02 06:00:00,6
51,121,172,39,2.7,0,Clear,5.2,2023-12-02 07:00:00,7
97,255,352,33,4.2,1,Mostly Clear,0.4,2023-12-02 08:00:00,8
169,385,554,35,3.4,1,Mostly Clear,4.2,2023-12-02 09:00:00,9
304,521,825,44,0.7,1,Mostly Clear,6.6,2023-12-02 10:00:00,10
340,583,923,47,-0.4,0,Clear,6.8,2023-12-02 11:00:00,11
425,612,1037,44,1.1,0,Clear,4.0,2023-12-02 12:00:00,12
475,689,1164,51,0.1,0,Clear,4.3,2023-12-02 13:00:00,13
534,708,1242,67,-3.0,0,Clear,7.6,2023-12-02 14:00:00,14
490,694,1184,65,-3.7,0,Clear,8.2,2023-12-02 15:00:00,15
391,667,1058,60,-3.0,1,Mostly Clear,4.2,2023-12-02 16:00:00,16
375,631,1006,58,-2.8,1,Mostly Clear,4.3,2023-12-02 17:00:00,17
293,554,847,63,-4.1,1,Mostly Clear,5.4,2023-12-02 18:00:00,18
217,430,647,59,-3.3,1,Mostly Clear,3.3,2023-12-02 19:00:00,19
230,310,540,67,-4.3,1,Mostly Clear,1.9,2023-12-02 20:00:00,20
121,277,398,74,-5.9,1,Mostly Clear,4.7,2023-12-02 21:00:00,21
104,193,297,74,-5.7,1,Mostly Clear,3.9,2023-12-02 22:00:00,22
94,170,264,65,-3.9,1,Mostly Clear,2.5,2023-12-02 23:00:00,23
68,93,161,49,-0.4,1,Mostly Clear,2.4,2023-12-03 00:00:00,0
35,46,81,40,2.2,1,Mostly Clear,3.4,2023-12-03 01:00:00,1
22,36,58,34,4.0,0,Clear,4.7,2023-12-03 02:00:00,2
13,13,26,30,5.1,0,Clear,4.2,2023-12-03 03:00:00,3
7,19,26,28,5.6,0,Clear,2.6,2023-12-03 04:00:00,4
5,12,17,27,5.7,0,Clear,2.5,2023-12-03 05:00:00,5
7,25,32,30,4.7,0,Clear,3.5,2023-12-03 06:00:00,6
21,47,68,30,4.3,0,Clear,2.5,2023-12-03 07:00:00,7
40,143,183,32,2.7,0,Clear,5.3,2023-12-03 08:00:00,8
89,230,319,37,1.2,0,Clear,9.7,2023-12-03 09:00:00,9
159,345,504,42,-0.4,0,Clear,7.4,2023-12-03 10:00:00,10
221,413,634,39,0.6,0,Clear,3.1,2023-12-03 11:00:00,11
246,491,737,41,0.2,0,Clear,2.3,2023-12-03 12:00:00,12
195,519,714,50,-2.2,0,Clear,6.6,2023-12-03 13:00:00,13
296,541,837,54,-3.2,0,Clear,8.6,2023-12-03 14:00:00,14
288,582,870,60,-4.0,0,Clear,8.4,2023-12-03 15:00:00,15
244,510,754,67,-4.7,0,Clear,8.7,2023-12-03 16:00:00,16
205,466,671,74,-5.6,0,Clear,7.1,2023-12-03 17:00:00,17
169,420,589,76,-6.0,0,Clear,5.1,2023-12-03 18:00:00,18
119,312,431,75,-5.9,0,Clear,3.8,2023-12-03 19:00:00,19
93,249,342,84,-8.2,0,Clear,5.0,2023-12-03 20:00:00,20
79,214,293,76,-6.3,0,Clear,3.1,2023-12-03 21:00:00,21
72,214,286,76,-6.1,0,Clear,6.8,2023-12-03 22:00:00,22
57,129,186,63,-3.1,0,Clear,4.7,2023-12-03 23:00:00,23
23,45,68,51,0.0,0,Clear,2.8,2023-12-04 00:00:00,0
13,27,40,41,3.2,0,Clear,2.9,2023-12-04 01:00:00,1
11,15,26,33,6.0,0,Clear,1.6,2023-12-04 02:00:00,2
4,13,17,28,7.7,0,Clear,1.1,2023-12-04 03:00:00,3
7,17,24,24,9.1,0,Clear,0.5,2023-12-04 04:00:00,4
28,64,92,24,9.3,0,Clear,1.5,2023-12-04 05:00:00,5
53,184,237,25,8.5,0,Clear,4.3,2023-12-04 06:00:00,6
124,540,664,31,5.4,0,Clear,9.4,2023-12-04 07:00:00,7
193,891,1084,26,6.7,0,Clear,10.9,2023-12-04 08:00:00,8
167,487,654,25,8.0,0,Clear,5.6,2023-12-04 09:00:00,9
104,282,386,28,6.7,0,Clear,6.1,2023-12-04 10:00:00,10
106,311,417,30,4.5,0,Clear,13.6,2023-12-04 11:00:00,11
169,403,572,33,3.6,0,Clear,13.1,2023-12-04 12:00:00,12
171,405,576,37,3.2,0,Clear,15.2,2023-12-04 13:00:00,13
155,430,585,44,1.6,0,Clear,12.6,2023-12-04 14:00:00,14
243,528,771,51,0.0,0,Clear,9.7,2023-12-04 15:00:00,15
248,722,970,53,-0.5,0,Clear,10.2,2023-12-04 16:00:00,16
259,977,1236,58,-1.5,0,Clear,9.4,2023-12-04 17:00:00,17
247,820,1067,60,-2.1,0,Clear,9.7,2023-12-04 18:00:00,18
165,558,723,62,-2.8,0,Clear,8.7,2023-12-04 19:00:00,19
125,396,521,66,-3.1,0,Clear,7.9,2023-12-04 20:00:00,20
108,338,446,68,-3.3,0,Clear,5.2,2023-12-04 21:00:00,21
84,216,300,63,-2.2,0,Clear,1.5,2023-12-04 22:00:00,22
46,102,148,57,-0.9,0,Clear,2.7,2023-12-04 23:00:00,23
19,57,76,46,2.3,0,Clear,4.3,2023-12-05 00:00:00,0
7,18,25,37,4.8,0,Clear,7.6,2023-12-05 01:00:00,1
4,6,10,31,7.0,0,Clear,10.0,2023-12-05 02:00:00,2
4,4,8,27,8.6,0,Clear,11.2,2023-12-05 03:00:00,3
3,19,22,26,9.4,0,Clear,12.2,2023-12-05 04:00:00,4
31,63,94,26,9.3,0,Clear,12.3,2023-12-05 05:00:00,5
56,226,282,30,7.5,0,Clear,10.3,2023-12-05 06:00:00,6
137,593,730,35,5.5,0,Clear,12.5,2023-12-05 07:00:00,7
249,1054,1303,36,5.1,0,Clear,12.2,2023-12-05 08:00:00,8
174,533,707,39,3.9,0,Clear,12.1,2023-12-05 09:00:00,9
102,309,411,41,2.8,0,Clear,12.8,2023-12-05 10:00:00,10
127,326,453,44,1.7,0,Clear,11.5,2023-12-05 11:00:00,11
143,386,529,48,0.6,0,Clear,10.5,2023-12-05 12:00:00,12
151,408,559,53,-0.6,0,Clear,8.9,2023-12-05 13:00:00,13
170,376,546,59,-1.8,0,Clear,6.7,2023-12-05 14:00:00,14
211,541,752,62,-2.3,0,Clear,5.3,2023-12-05 15:00:00,15
249,746,995,66,-3.1,0,Clear,5.7,2023-12-05 16:00:00,16
302,970,1272,61,-2.1,0,Clear,2.5,2023-12-05 17:00:00,17
262,850,1112,63,-2.5,0,Clear,2.3,2023-12-05 18:00:00,18
184,578,762,67,-3.1,0,Clear,3.6,2023-12-05 19:00:00,19
132,470,602,73,-4.0,0,Clear,3.7,2023-12-05 20:00:00,20
133,356,489,76,-4.5,0,Clear,2.5,2023-12-05 21:00:00,21
77,228,305,79,-5.0,0,Clear,3.2,2023-12-05 22:00:00,22
42,130,172,67,-2.9,0,Clear,4.3,2023-12-05 23:00:00,23
25,63,88,53,0.1,0,Clear,5.2,2023-12-06 00:00:00,0
9,16,25,44,2.5,0,Clear,5.8,2023-12-06 01:00:00,1
0,11,11,39,4.3,0,Clear,3.4,2023-12-06 02:00:00,2
6,2,8,35,5.6,0,Clear,1.1,2023-12-06 03:00:00,3
6,11,17,33,6.5,0,Clear,1.3,2023-12-06 04:00:00,4
35,56,91,32,6.8,0,Clear,3.4,2023-12-06 05:00:00,5
50,217,267,37,5.2,0,Clear,5.4,2023-12-06 06:00:00,6
145,548,693,42,3.4,0,Clear,8.3,2023-12-06 07:00:00,7
245,1049,1294,41,3.6,0,Clear,10.0,2023-12-06 08:00:00,8
151,554,705,45,2.4,0,Clear,8.6,2023-12-06 09:00:00,9
89,268,357,46,1.8,0,Clear,6.5,2023-12-06 10:00:00,10
112,314,426,44,2.4,0,Clear,4.6,2023-12-06 11:00:00,11
96,361,457,45,2.6,0,Clear,3.2,2023-12-06 12:00:00,12
104,346,450,53,1.3,0,Clear,4.3,2023-12-06 13:00:00,13
119,362,481,63,-1.0,0,Clear,6.4,2023-12-06 14:00:00,14
164,464,628,65,-2.1,0,Clear,6.5,2023-12-06 15:00:00,15
209,634,843,60,-1.3,0,Clear,4.5,2023-12-06 16:00:00,16
275,1012,1287,58,-1.0,0,Clear,2.2,2023-12-06 17:00:00,17
273,864,1137,59,-1.1,0,Clear,1.5,2023-12-06 18:00:00,18
192,527,719,60,-1.2,0,Clear,3.0,2023-12-06 19:00:00,19
134,351,485,77,-4.7,1,Mostly Clear,10.5,2023-12-06 20:00:00,20
126,336,462,75,-4.3,0,Clear,11.5,2023-12-06 21:00:00,21
74,244,318,58,-1.6,0,Clear,10.5,2023-12-06 22:00:00,22
49,128,177,36,2.5,0,Clear,6.9,2023-12-06 23:00:00,23
35,46,81,25,6.0,0,Clear,4.3,2023-12-07 00:00:00,0
9,30,39,19,9.0,0,Clear,4.2,2023-12-07 01:00:00,1
4,16,20,15,11.7,0,Clear,5.0,2023-12-07 02:00:00,2
4,6,10,13,13.6,0,Clear,5.4,2023-12-07 03:00:00,3
7,16,23,12,14.6,0,Clear,6.5,2023-12-07 04:00:00,4
17,55,72,14,13.8,0,Clear,7.3,2023-12-07 05:00:00,5
55,192,247,16,11.8,0,Clear,7.3,2023-12-07 06:00:00,6
124,493,617,18,9.6,0,Clear,13.4,2023-12-07 07:00:00,7
220,945,1165,17,9.0,0,Clear,15.6,2023-12-07 08:00:00,8
131,547,678,18,7.7,0,Clear,14.6,2023-12-07 09:00:00,9
99,241,340,19,6.6,0,Clear,13.2,2023-12-07 10:00:00,10
119,311,430,21,5.0,0,Clear,10.2,2023-12-07 11:00:00,11
110,354,464,21,4.6,0,Clear,8.8,2023-12-07 12:00:00,12
132,342,474,25,3.7,1,Mostly Clear,8.0,2023-12-07 13:00:00,13
121,377,498,25,4.3,1,Mostly Clear,5.5,2023-12-07 14:00:00,14
176,496,672,28,2.4,1,Mostly Clear,7.1,2023-12-07 15:00:00,15
215,650,865,25,4.3,1,Mostly Clear,0.4,2023-12-07 16:00:00,16
277,920,1197,33,0.8,1,Mostly Clear,6.5,2023-12-07 17:00:00,17
256,768,1024,31,1.5,1,Mostly Clear,4.3,2023-12-07 18:00:00,18
182,522,704,35,0.6,1,Mostly Clear,5.6,2023-12-07 19:00:00,19
117,389,506,37,0.1,1,Mostly Clear,9.9,2023-12-07 20:00:00,20
117,315,432,39,-0.5,1,Mostly Clear,8.8,2023-12-07 21:00:00,21
131,279,410,38,0.1,1,Mostly Clear,6.4,2023-12-07 22:00:00,22
81,178,259,40,1.1,1,Mostly Clear,6.4,2023-12-07 23:00:00,23
44,84,128,45,2.4,1,Mostly Clear,9.8,2023-12-08 00:00:00,0
19,37,56,43,3.8,1,Mostly Clear,7.7,2023-12-08 01:00:00,1
9,29,38,38,5.1,1,Mostly Clear,8.0,2023-12-08 02:00:00,2
9,9,18,35,6.1,2,Partly Cloudy,7.9,2023-12-08 03:00:00,3
8,12,20,34,6.8,2,Partly Cloudy,5.8,2023-12-08 04:00:00,4
18,48,66,33,7.0,2,Partly Cloudy,4.1,2023-12-08 05:00:00,5
54,168,222,38,5.8,3,Cloudy,4.8,2023-12-08 06:00:00,6
93,399,492,41,4.6,2,Partly Cloudy,7.6,2023-12-08 07:00:00,7
166,638,804,40,4.9,1,Mostly Clear,3.8,2023-12-08 08:00:00,8
163,435,598,48,2.2,0,Clear,8.6,2023-12-08 09:00:00,9
124,304,428,53,0.7,1,Mostly Clear,8.7,2023-12-08 10:00:00,10
180,404,584,54,0.6,1,Mostly Clear,6.4,2023-12-08 11:00:00,11
188,470,658,51,2.0,2,Partly Cloudy,3.9,2023-12-08 12:00:00,12
233,510,743,53,1.6,2,Partly Cloudy,3.4,2023-12-08 13:00:00,13
279,515,794,55,0.6,1,Mostly Clear,4.4,2023-12-08 14:00:00,14
314,655,969,55,0.4,1,Mostly Clear,3.1,2023-12-08 15:00:00,15
319,764,1083,58,-0.2,1,Mostly Clear,1.1,2023-12-08 16:00:00,16
319,846,1165,60,-0.7,0,Clear,2.5,2023-12-08 17:00:00,17
319,695,1014,62,-1.3,0,Clear,1.1,2023-12-08 18:00:00,18
256,504,760,74,-3.4,0,Clear,3.6,2023-12-08 19:00:00,19
182,408,590,76,-3.2,1,Mostly Clear,3.3,2023-12-08 20:00:00,20
146,290,436,85,-6.2,0,Clear,8.9,2023-12-08 21:00:00,21
131,260,391,84,-5.2,0,Clear,5.4,2023-12-08 22:00:00,22
135,280,415,70,-2.9,0,Clear,2.6,2023-12-08 23:00:00,23
93,187,280,59,-0.3,0,Clear,2.9,2023-12-09 00:00:00,0
89,133,222,50,2.0,0,Clear,3.1,2023-12-09 01:00:00,1
51,60,111,42,4.4,0,Clear,3.3,2023-12-09 02:00:00,2
20,20,40,36,6.4,0,Clear,3.6,2023-12-09 03:00:00,3
7,15,22,32,7.9,0,Clear,6.4,2023-12-09 04:00:00,4
9,25,34,31,8.3,0,Clear,3.9,2023-12-09 05:00:00,5
21,45,66,38,5.8,0,Clear,7.0,2023-12-09 06:00:00,6
34,104,138,44,3.8,1,Mostly Clear,8.6,2023-12-09 07:00:00,7
109,219,328,47,3.7,0,Clear,12.4,2023-12-09 08:00:00,8
160,375,535,50,2.3,2,Partly Cloudy,11.0,2023-12-09 09:00:00,9
266,500,766,51,1.8,1,Mostly Clear,9.3,2023-12-09 10:00:00,10
412,577,989,42,3.9,1,Mostly Clear,2.3,2023-12-09 11:00:00,11
455,651,1106,46,1.7,2,Partly Cloudy,9.9,2023-12-09 12:00:00,12
551,710,1261,45,1.2,1,Mostly Clear,10.9,2023-12-09 13:00:00,13
568,720,1288,46,0.8,1,Mostly Clear,11.5,2023-12-09 14:00:00,14
475,723,1198,57,-1.1,2,Partly Cloudy,10.6,2023-12-09 15:00:00,15
418,687,1105,57,-1.5,2,Partly Cloudy,10.2,2023-12-09 16:00:00,16
304,574,878,52,-1.9,2,Partly Cloudy,9.9,2023-12-09 17:00:00,17
275,476,751,52,-2.2,1,Mostly Clear,10.4,2023-12-09 18:00:00,18
208,448,656,49,-2.9,1,Mostly Clear,8.7,2023-12-09 19:00:00,19
177,322,499,47,-1.3,1,Mostly Clear,11.3,2023-12-09 20:00:00,20
150,275,425,50,-2.6,1,Mostly Clear,9.9,2023-12-09 21:00:00,21
162,243,405,47,-1.9,0,Clear,5.9,2023-12-09 22:00:00,22
148,261,409,37,0.7,0,Clear,7.4,2023-12-09 23:00:00,23
125,196,321,30,4.4,0,Clear,5.4,2023-12-10 00:00:00,0
113,168,281,26,7.1,0,Clear,5.1,2023-12-10 01:00:00,1
55,85,140,23,8.8,0,Clear,13.0,2023-12-10 02:00:00,2
22,27,49,20,9.9,0,Clear,15.9,2023-12-10 03:00:00,3
10,22,32,20,10.0,0,Clear,16.6,2023-12-10 04:00:00,4
7,15,22,22,9.2,0,Clear,18.5,2023-12-10 05:00:00,5
19,45,64,27,7.3,0,Clear,18.3,2023-12-10 06:00:00,6
56,116,172,36,4.8,0,Clear,19.4,2023-12-10 07:00:00,7
74,159,233,42,3.7,1,Mostly Clear,18.9,2023-12-10 08:00:00,8
44,122,166,45,2.3,0,Clear,18.4,2023-12-10 09:00:00,9
32,121,153,50,1.2,0,Clear,18.1,2023-12-10 10:00:00,10
51,172,223,56,-0.1,0,Clear,15.6,2023-12-10 11:00:00,11
58,188,246,61,-1.1,0,Clear,11.4,2023-12-10 12:00:00,12
133,292,425,66,-2.3,0,Clear,9.1,2023-12-10 13:00:00,13
116,320,436,71,-3.2,0,Clear,8.3,2023-12-10 14:00:00,14
144,304,448,75,-3.8,0,Clear,9.0,2023-12-10 15:00:00,15
86,286,372,82,-4.8,0,Clear,8.3,2023-12-10 16:00:00,16
54,167,221,86,-5.7,0,Clear,7.9,2023-12-10 17:00:00,17
37,112,149,88,-6.6,0,Clear,7.1,2023-12-10 18:00:00,18
21,94,115,89,-7.2,0,Clear,5.3,2023-12-10 19:00:00,19
21,74,95,95,-8.1,1,Mostly Clear,4.0,2023-12-10 20:00:00,20
20,67,87,94,-8.9,3,Cloudy,4.3,2023-12-10 21:00:00,21
13,47,60,93,-8.4,3,Cloudy,4.6,2023-12-10 22:00:00,22
15,31,46,93,-6.6,2,Partly Cloudy,3.8,2023-12-10 23:00:00,23
11,16,27,81,-4.4,1,Mostly Clear,4.6,2023-12-11 00:00:00,0
3,4,7,69,-2.1,1,Mostly Clear,5.0,2023-12-11 01:00:00,1
2,10,12,59,-0.3,0,Clear,3.6,2023-12-11 02:00:00,2
5,5,10,53,1.0,1,Mostly Clear,2.9,2023-12-11 03:00:00,3
4,7,11,49,1.7,1,Mostly Clear,4.0,2023-12-11 04:00:00,4
8,34,42,46,1.9,1,Mostly Clear,3.7,2023-12-11 05:00:00,5
42,135,177,48,1.2,1,Mostly Clear,2.3,2023-12-11 06:00:00,6
83,363,446,53,-0.4,1,Mostly Clear,4.3,2023-12-11 07:00:00,7
131,676,807,50,0.6,0,Clear,2.9,2023-12-11 08:00:00,8
108,392,500,59,-1.5,1,Mostly Clear,9.4,2023-12-11 09:00:00,9
90,287,377,63,-2.4,1,Mostly Clear,9.0,2023-12-11 10:00:00,10
86,293,379,68,-2.8,1,Mostly Clear,7.9,2023-12-11 11:00:00,11
109,419,528,74,-3.3,1,Mostly Clear,8.4,2023-12-11 12:00:00,12
107,344,451,80,-4.0,1,Mostly Clear,6.2,2023-12-11 13:00:00,13
154,357,511,82,-4.5,0,Clear,10.1,2023-12-11 14:00:00,14
180,463,643,84,-5.9,0,Clear,7.1,2023-12-11 15:00:00,15
176,625,801,81,-6.2,1,Mostly Clear,5.1,2023-12-11 16:00:00,16
235,893,1128,82,-6.6,1,Mostly Clear,10.5,2023-12-11 17:00:00,17
224,628,852,84,-7.1,1,Mostly Clear,7.9,2023-12-11 18:00:00,18
148,490,638,85,-7.3,0,Clear,10.8,2023-12-11 19:00:00,19
92,292,384,77,-6.7,0,Clear,11.5,2023-12-11 20:00:00,20
78,224,302,78,-7.5,0,Clear,8.5,2023-12-11 21:00:00,21
52,224,276,76,-6.3,0,Clear,7.6,2023-12-11 22:00:00,22
43,106,149,69,-4.5,0,Clear,5.2,2023-12-11 23:00:00,23
13,41,54,52,-1.2,0,Clear,4.8,2023-12-12 00:00:00,0
18,18,36,40,2.2,0,Clear,0.5,2023-12-12 01:00:00,1
6,9,15,33,5.3,0,Clear,4.8,2023-12-12 02:00:00,2
8,9,17,27,8.3,0,Clear,7.6,2023-12-12 03:00:00,3
3,29,32,23,9.8,0,Clear,8.7,2023-12-12 04:00:00,4
22,61,83,24,9.2,0,Clear,9.2,2023-12-12 05:00:00,5
55,181,236,31,6.7,0,Clear,10.2,2023-12-12 06:00:00,6
103,538,641,25,8.0,0,Clear,5.3,2023-12-12 07:00:00,7
224,908,1132,30,6.0,1,Mostly Clear,14.5,2023-12-12 08:00:00,8
115,498,613,21,5.9,1,Mostly Clear,17.0,2023-12-12 09:00:00,9
78,241,319,20,5.1,1,Mostly Clear,20.3,2023-12-12 10:00:00,10
90,319,409,19,4.8,0,Clear,19.1,2023-12-12 11:00:00,11
116,380,496,20,3.9,0,Clear,17.7,2023-12-12 12:00:00,12
140,346,486,20,3.3,0,Clear,21.7,2023-12-12 13:00:00,13
123,386,509,19,3.3,0,Clear,24.9,2023-12-12 14:00:00,14
197,558,755,20,2.7,1,Mostly Clear,23.2,2023-12-12 15:00:00,15
233,685,918,20,2.5,2,Partly Cloudy,20.2,2023-12-12 16:00:00,16
276,968,1244,21,2.3,3,Cloudy,18.7,2023-12-12 17:00:00,17
235,784,1019,21,2.0,2,Partly Cloudy,15.8,2023-12-12 18:00:00,18
187,517,704,20,2.3,2,Partly Cloudy,17.0,2023-12-12 19:00:00,19
109,407,516,19,3.9,2,Partly Cloudy,25.7,2023-12-12 20:00:00,20
92,309,401,19,3.3,2,Partly Cloudy,26.2,2023-12-12 21:00:00,21
96,195,291,35,2.3,2,Partly Cloudy,15.4,2023-12-12 22:00:00,22
58,105,163,44,2.4,1,Mostly Clear,12.4,2023-12-12 23:00:00,23
24,31,55,40,3.5,2,Partly Cloudy,12.8,2023-12-13 00:00:00,0
14,31,45,33,4.4,2,Partly Cloudy,15.2,2023-12-13 01:00:00,1
4,14,18,35,4.7,2,Partly Cloudy,21.0,2023-12-13 02:00:00,2
6,1,7,32,4.2,2,Partly Cloudy,25.3,2023-12-13 03:00:00,3
5,13,18,31,3.2,2,Partly Cloudy,27.0,2023-12-13 04:00:00,4
24,54,78,40,1.8,2,Partly Cloudy,26.0,2023-12-13 05:00:00,5
52,166,218,48,0.6,2,Partly Cloudy,24.1,2023-12-13 06:00:00,6
134,527,661,48,0.1,2,Partly Cloudy,24.2,2023-12-13 07:00:00,7
225,917,1142,50,-0.2,3,Cloudy,21.3,2023-12-13 08:00:00,8
165,497,662,42,-0.2,3,Cloudy,18.4,2023-12-13 09:00:00,9
133,279,412,38,-0.4,2,Partly Cloudy,14.4,2023-12-13 10:00:00,10
137,318,455,38,-0.8,2,Partly Cloudy,10.5,2023-12-13 11:00:00,11
114,383,497,39,-1.3,2,Partly Cloudy,10.8,2023-12-13 12:00:00,12
151,324,475,44,-2.1,2,Partly Cloudy,11.3,2023-12-13 13:00:00,13
128,333,461,49,-2.6,2,Partly Cloudy,12.3,2023-12-13 14:00:00,14
221,486,707,54,-3.2,3,Cloudy,13.0,2023-12-13 15:00:00,15
216,677,893,55,-3.5,3,Cloudy,12.1,2023-12-13 16:00:00,16
308,968,1276,56,-3.7,3,Cloudy,11.3,2023-12-13 17:00:00,17
251,775,1026,56,-3.9,2,Partly Cloudy,12.2,2023-12-13 18:00:00,18
244,621,865,57,-4.1,2,Partly Cloudy,12.9,2023-12-13 19:00:00,19
121,354,475,63,-4.8,2,Partly Cloudy,14.8,2023-12-13 20:00:00,20
134,315,449,64,-5.5,2,Partly Cloudy,16.3,2023-12-13 21:00:00,21
70,233,303,63,-5.8,2,Partly Cloudy,15.3,2023-12-13 22:00:00,22
46,138,184,58,-5.2,2,Partly Cloudy,14.1,2023-12-13 23:00:00,23
15,67,82,54,-4.5,2,Partly Cloudy,11.4,2023-12-14 00:00:00,0
18,23,41,50,-3.7,2,Partly Cloudy,10.7,2023-12-14 01:00:00,1
6,23,29,48,-3.0,2,Partly Cloudy,10.8,2023-12-14 02:00:00,2
5,9,14,45,-2.5,3,Cloudy,10.6,2023-12-14 03:00:00,3
10,13,23,44,-2.2,3,Cloudy,10.6,2023-12-14 04:00:00,4
21,48,69,44,-2.3,2,Partly Cloudy,10.9,2023-12-14 05:00:00,5
51,172,223,45,-2.8,2,Partly Cloudy,12.2,2023-12-14 06:00:00,6
121,444,565,48,-3.6,2,Partly Cloudy,12.3,2023-12-14 07:00:00,7
204,826,1030,50,-4.6,1,Mostly Clear,12.3,2023-12-14 08:00:00,8
152,468,620,52,-5.3,1,Mostly Clear,13.0,2023-12-14 09:00:00,9
109,278,387,53,-5.8,0,Clear,12.8,2023-12-14 10:00:00,10
91,292,383,55,-6.4,0,Clear,12.1,2023-12-14 11:00:00,11
135,388,523,56,-7.0,0,Clear,13.2,2023-12-14 12:00:00,12
133,336,469,59,-7.6,0,Clear,11.2,2023-12-14 13:00:00,13
175,353,528,61,-8.2,0,Clear,10.4,2023-12-14 14:00:00,14
197,452,649,64,-8.8,0,Clear,11.8,2023-12-14 15:00:00,15
241,615,856,67,-9.2,1,Mostly Clear,11.2,2023-12-14 16:00:00,16
333,848,1181,70,-9.9,0,Clear,9.2,2023-12-14 17:00:00,17
269,708,977,73,-10.4,0,Clear,10.4,2023-12-14 18:00:00,18
195,502,697,76,-11.0,0,Clear,10.9,2023-12-14 19:00:00,19
112,349,461,84,-11.7,1,Mostly Clear,6.4,2023-12-14 20:00:00,20
156,287,443,85,-12.1,0,Clear,9.2,2023-12-14 21:00:00,21
96,223,319,85,-11.6,1,Mostly Clear,3.8,2023-12-14 22:00:00,22
62,160,222,76,-10.2,0,Clear,2.2,2023-12-14 23:00:00,23
45,76,121,66,-8.8,0,Clear,4.3,2023-12-15 00:00:00,0
24,51,75,59,-7.5,0,Clear,4.1,2023-12-15 01:00:00,1
8,26,34,52,-6.3,0,Clear,4.9,2023-12-15 02:00:00,2
9,7,16,48,-5.5,0,Clear,8.2,2023-12-15 03:00:00,3
3,15,18,46,-5.0,1,Mostly Clear,6.6,2023-12-15 04:00:00,4
24,44,68,45,-4.9,1,Mostly Clear,8.0,2023-12-15 05:00:00,5
47,151,198,46,-5.2,1,Mostly Clear,5.4,2023-12-15 06:00:00,6
104,348,452,48,-5.6,1,Mostly Clear,5.2,2023-12-15 07:00:00,7
154,577,731,53,-6.5,1,Mostly Clear,9.6,2023-12-15 08:00:00,8
135,430,565,54,-6.9,1,Mostly Clear,10.4,2023-12-15 09:00:00,9
141,325,466,56,-7.4,1,Mostly Clear,9.5,2023-12-15 10:00:00,10
189,371,560,60,-8.2,0,Clear,5.0,2023-12-15 11:00:00,11
218,458,676,61,-8.4,0,Clear,9.4,2023-12-15 12:00:00,12
243,525,768,66,-9.0,0,Clear,8.8,2023-12-15 13:00:00,13
270,537,807,73,-9.8,0,Clear,7.7,2023-12-15 14:00:00,14
298,644,942,77,-10.0,0,Clear,9.5,2023-12-15 15:00:00,15
310,684,994,75,-9.6,0,Clear,4.7,2023-12-15 16:00:00,16
303,757,1060,75,-9.3,1,Mostly Clear,2.5,2023-12-15 17:00:00,17
259,612,871,77,-9.7,0,Clear,3.1,2023-12-15 18:00:00,18
214,478,692,79,-10.1,1,Mostly Clear,0.8,2023-12-15 19:00:00,19
169,339,508,82,-10.4,1,Mostly Clear,0.4,2023-12-15 20:00:00,20
123,264,387,83,-10.8,2,Partly Cloudy,3.6,2023-12-15 21:00:00,21
139,292,431,84,-11.4,2,Partly Cloudy,3.6,2023-12-15 22:00:00,22
123,220,343,74,-9.8,3,Cloudy,2.4,2023-12-15 23:00:00,23
80,160,240,66,-8.1,3,Cloudy,3.4,2023-12-16 00:00:00,0
79,116,195,61,-7.2,3,Cloudy,3.6,2023-12-16 01:00:00,1
58,72,130,56,-6.3,3,Cloudy,4.1,2023-12-16 02:00:00,2
37,42,79,53,-5.7,2,Partly Cloudy,2.7,2023-12-16 03:00:00,3
5,11,16,52,-5.3,2,Partly Cloudy,1.8,2023-12-16 04:00:00,4
8,13,21,50,-5.0,2,Partly Cloudy,4.0,2023-12-16 05:00:00,5
23,43,66,49,-5.0,2,Partly Cloudy,4.3,2023-12-16 06:00:00,6
45,116,161,52,-5.8,3,Cloudy,5.9,2023-12-16 07:00:00,7
88,186,274,59,-7.1,1,Mostly Clear,8.6,2023-12-16 08:00:00,8
164,303,467,62,-7.7,2,Partly Cloudy,8.7,2023-12-16 09:00:00,9
290,426,716,64,-8.2,2,Partly Cloudy,7.9,2023-12-16 10:00:00,10
324,532,856,67,-8.9,1,Mostly Clear,8.2,2023-12-16 11:00:00,11
453,633,1086,69,-9.5,1,Mostly Clear,7.6,2023-12-16 12:00:00,12
442,632,1074,73,-10.2,1,Mostly Clear,5.8,2023-12-16 13:00:00,13
477,670,1147,72,-9.6,1,Mostly Clear,4.3,2023-12-16 14:00:00,14
501,733,1234,71,-9.0,1,Mostly Clear,2.3,2023-12-16 15:00:00,15
411,622,1033,73,-9.4,1,Mostly Clear,1.8,2023-12-16 16:00:00,16
283,494,777,74,-10.1,2,Partly Cloudy,3.6,2023-12-16 17:00:00,17
265,445,710,80,-11.6,1,Mostly Clear,5.1,2023-12-16 18:00:00,18
195,393,588,83,-12.5,1,Mostly Clear,5.5,2023-12-16 19:00:00,19
151,267,418,81,-11.9,1,Mostly Clear,4.3,2023-12-16 20:00:00,20
118,215,333,81,-11.6,1,Mostly Clear,1.5,2023-12-16 21:00:00,21
98,216,314,85,-12.3,0,Clear,3.3,2023-12-16 22:00:00,22
101,236,337,75,-10.8,0,Clear,2.7,2023-12-16 23:00:00,23
102,133,235,64,-8.3,0,Clear,2.6,2023-12-17 00:00:00,0
86,155,241,56,-6.4,0,Clear,3.7,2023-12-17 01:00:00,1
44,72,116,50,-5.0,0,Clear,4.6,2023-12-17 02:00:00,2
24,25,49,46,-3.9,0,Clear,4.1,2023-12-17 03:00:00,3
16,12,28,44,-3.3,0,Clear,3.2,2023-12-17 04:00:00,4
8,16,24,43,-3.1,0,Clear,3.3,2023-12-17 05:00:00,5
20,39,59,44,-3.3,0,Clear,3.1,2023-12-17 06:00:00,6
26,90,116,48,-4.6,0,Clear,8.1,2023-12-17 07:00:00,7
76,174,250,54,-5.8,0,Clear,10.9,2023-12-17 08:00:00,8
117,257,374,57,-6.6,0,Clear,9.4,2023-12-17 09:00:00,9
184,360,544,62,-7.7,0,Clear,6.2,2023-12-17 10:00:00,10
245,428,673,66,-8.4,0,Clear,5.5,2023-12-17 11:00:00,11
295,469,764,67,-8.7,0,Clear,5.2,2023-12-17 12:00:00,12
242,533,775,65,-8.5,0,Clear,4.0,2023-12-17 13:00:00,13
182,350,532,65,-8.2,0,Clear,3.9,2023-12-17 14:00:00,14
150,293,443,67,-7.9,0,Clear,2.6,2023-12-17 15:00:00,15
89,196,285,69,-7.9,0,Clear,1.8,2023-12-17 16:00:00,16
47,132,179,70,-8.0,0,Clear,0.4,2023-12-17 17:00:00,17
26,80,106,71,-8.4,0,Clear,1.9,2023-12-17 18:00:00,18
21,68,89,71,-8.9,0,Clear,2.6,2023-12-17 19:00:00,19
14,24,38,80,-11.2,0,Clear,4.7,2023-12-17 20:00:00,20
9,32,41,82,-11.6,0,Clear,3.8,2023-12-17 21:00:00,21
14,19,33,84,-11.7,0,Clear,3.1,2023-12-17 22:00:00,22
7,19,26,75,-10.2,0,Clear,1.8,2023-12-17 23:00:00,23
4,10,14,63,-7.8,0,Clear,1.5,2023-12-18 00:00:00,0
0,5,5,52,-5.7,0,Clear,0.5,2023-12-18 01:00:00,1
7,9,16,45,-4.2,0,Clear,1.1,2023-12-18 02:00:00,2
9,5,14,41,-3.1,0,Clear,1.5,2023-12-18 03:00:00,3
9,10,19,39,-2.2,0,Clear,2.6,2023-12-18 04:00:00,4
17,28,45,38,-1.7,0,Clear,3.5,2023-12-18 05:00:00,5
32,142,174,42,-2.2,0,Clear,2.8,2023-12-18 06:00:00,6
79,283,362,40,-2.0,0,Clear,3.1,2023-12-18 07:00:00,7
129,612,741,50,-4.5,0,Clear,10.4,2023-12-18 08:00:00,8
115,370,485,54,-5.7,0,Clear,10.9,2023-12-18 09:00:00,9
102,233,335,56,-6.3,0,Clear,10.6,2023-12-18 10:00:00,10
113,300,413,58,-7.0,0,Clear,9.0,2023-12-18 11:00:00,11
139,353,492,61,-7.9,0,Clear,7.3,2023-12-18 12:00:00,12
144,367,511,62,-8.5,0,Clear,6.8,2023-12-18 13:00:00,13
182,390,572,61,-8.3,0,Clear,5.0,2023-12-18 14:00:00,14
193,451,644,58,-7.6,0,Clear,0.8,2023-12-18 15:00:00,15
229,621,850,59,-8.0,1,Mostly Clear,2.5,2023-12-18 16:00:00,16
249,722,971,63,-8.7,1,Mostly Clear,4.1,2023-12-18 17:00:00,17
205,623,828,70,-10.2,0,Clear,5.2,2023-12-18 18:00:00,18
162,440,602,74,-11.2,0,Clear,5.9,2023-12-18 19:00:00,19
102,299,401,80,-11.7,0,Clear,1.9,2023-12-18 20:00:00,20
73,190,263,85,-13.2,0,Clear,5.7,2023-12-18 21:00:00,21
53,161,214,82,-12.2,1,Mostly Clear,4.6,2023-12-18 22:00:00,22
34,79,113,72,-10.2,0,Clear,2.8,2023-12-18 23:00:00,23
22,36,58,61,-8.4,0,Clear,2.9,2023-12-19 00:00:00,0
23,39,62,51,-6.3,0,Clear,3.4,2023-12-19 01:00:00,1
1,9,10,44,-4.5,0,Clear,3.0,2023-12-19 02:00:00,2
4,6,10,41,-3.4,0,Clear,0.5,2023-12-19 03:00:00,3
4,18,22,40,-2.7,0,Clear,1.8,2023-12-19 04:00:00,4
14,49,63,39,-2.5,1,Mostly Clear,1.9,2023-12-19 05:00:00,5
35,153,188,42,-2.8,0,Clear,3.0,2023-12-19 06:00:00,6
112,420,532,41,-3.0,1,Mostly Clear,2.2,2023-12-19 07:00:00,7
176,705,881,53,-5.4,1,Mostly Clear,6.2,2023-12-19 08:00:00,8
128,443,571,56,-6.0,0,Clear,7.2,2023-12-19 09:00:00,9
125,280,405,60,-6.7,1,Mostly Clear,5.1,2023-12-19 10:00:00,10
97,278,375,59,-6.4,1,Mostly Clear,4.0,2023-12-19 11:00:00,11
105,280,385,57,-6.2,0,Clear,3.4,2023-12-19 12:00:00,12
91,313,404,65,-8.1,0,Clear,5.9,2023-12-19 13:00:00,13
130,332,462,58,-6.7,0,Clear,4.1,2023-12-19 14:00:00,14
182,390,572,61,-6.8,0,Clear,3.6,2023-12-19 15:00:00,15
202,567,769,67,-8.0,0,Clear,2.8,2023-12-19 16:00:00,16
228,777,1005,84,-11.3,0,Clear,5.1,2023-12-19 17:00:00,17
180,586,766,89,-12.1,0,Clear,3.1,2023-12-19 18:00:00,18
118,417,535,91,-12.8,3,Cloudy,1.3,2023-12-19 19:00:00,19
83,282,365,88,-14.1,3,Cloudy,1.8,2023-12-19 20:00:00,20
61,196,257,87,-14.6,3,Cloudy,2.9,2023-12-19 21:00:00,21
56,122,178,89,-13.9,3,Cloudy,3.1,2023-12-19 22:00:00,22
41,93,134,86,-11.8,1,Mostly Clear,3.3,2023-12-19 23:00:00,23
30,54,84,68,-8.7,0,Clear,1.0,2023-12-20 00:00:00,0
19,19,38,55,-6.2,0,Clear,1.1,2023-12-20 01:00:00,1
3,12,15,46,-3.7,0,Clear,2.9,2023-12-20 02:00:00,2
5,2,7,41,-2.3,0,Clear,2.1,2023-12-20 03:00:00,3
5,6,11,39,-1.5,0,Clear,2.2,2023-12-20 04:00:00,4
10,42,52,39,-1.3,0,Clear,4.2,2023-12-20 05:00:00,5
26,141,167,41,-1.9,0,Clear,7.0,2023-12-20 06:00:00,6
85,345,430,50,-4.0,0,Clear,6.3,2023-12-20 07:00:00,7
155,630,785,49,-4.0,0,Clear,7.6,2023-12-20 08:00:00,8
129,387,516,50,-4.6,0,Clear,8.7,2023-12-20 09:00:00,9
86,263,349,51,-5.0,0,Clear,4.3,2023-12-20 10:00:00,10
131,291,422,49,-4.6,0,Clear,2.2,2023-12-20 11:00:00,11
122,362,484,52,-5.0,0,Clear,2.9,2023-12-20 12:00:00,12
129,355,484,60,-6.8,0,Clear,5.2,2023-12-20 13:00:00,13
161,386,547,62,-7.2,0,Clear,4.7,2023-12-20 14:00:00,14
225,536,761,65,-8.0,0,Clear,5.1,2023-12-20 15:00:00,15
193,658,851,61,-7.1,1,Mostly Clear,3.1,2023-12-20 16:00:00,16
238,704,942,62,-7.4,1,Mostly Clear,3.2,2023-12-20 17:00:00,17
205,624,829,69,-8.6,1,Mostly Clear,4.1,2023-12-20 18:00:00,18
127,347,474,75,-9.6,0,Clear,3.9,2023-12-20 19:00:00,19
75,249,324,90,-11.7,0,Clear,2.9,2023-12-20 20:00:00,20
91,200,291,90,-13.0,2,Partly Cloudy,4.3,2023-12-20 21:00:00,21
87,184,271,89,-12.7,3,Cloudy,3.3,2023-12-20 22:00:00,22
40,122,162,84,-10.5,0,Clear,4.1,2023-12-20 23:00:00,23
26,43,69,63,-6.7,0,Clear,6.3,2023-12-21 00:00:00,0
18,23,41,50,-4.1,0,Clear,7.2,2023-12-21 01:00:00,1
5,4,9,43,-2.2,0,Clear,4.6,2023-12-21 02:00:00,2
3,5,8,39,-1.0,0,Clear,3.9,2023-12-21 03:00:00,3
6,13,19,36,-0.3,0,Clear,4.8,2023-12-21 04:00:00,4
9,40,49,35,0.1,0,Clear,5.4,2023-12-21 05:00:00,5
35,147,182,38,-0.9,0,Clear,5.7,2023-12-21 06:00:00,6
70,280,350,42,-2.4,0,Clear,11.0,2023-12-21 07:00:00,7
132,459,591,42,-2.9,0,Clear,13.0,2023-12-21 08:00:00,8
118,342,460,44,-4.0,0,Clear,12.0,2023-12-21 09:00:00,9
113,260,373,46,-4.9,0,Clear,11.5,2023-12-21 10:00:00,10
110,316,426,48,-5.8,0,Clear,10.2,2023-12-21 11:00:00,11
112,367,479,52,-6.7,0,Clear,9.2,2023-12-21 12:00:00,12
176,386,562,58,-7.8,0,Clear,5.5,2023-12-21 13:00:00,13
189,400,589,54,-6.8,0,Clear,3.6,2023-12-21 14:00:00,14
202,525,727,59,-8.0,0,Clear,4.1,2023-12-21 15:00:00,15
224,551,775,61,-8.3,0,Clear,4.3,2023-12-21 16:00:00,16
206,524,730,60,-8.3,0,Clear,4.2,2023-12-21 17:00:00,17
163,496,659,61,-8.4,0,Clear,2.7,2023-12-21 18:00:00,18
120,289,409,67,-9.6,0,Clear,2.9,2023-12-21 19:00:00,19
97,231,328,87,-14.1,0,Clear,4.6,2023-12-21 20:00:00,20
66,209,275,88,-14.3,0,Clear,4.0,2023-12-21 21:00:00,21
75,162,237,84,-13.2,0,Clear,2.4,2023-12-21 22:00:00,22
42,134,176,73,-11.4,0,Clear,1.3,2023-12-21 23:00:00,23
30,65,95,60,-8.9,0,Clear,2.2,2023-12-22 00:00:00,0
14,38,52,49,-6.5,0,Clear,3.2,2023-12-22 01:00:00,1
7,10,17,43,-4.8,0,Clear,3.3,2023-12-22 02:00:00,2
8,9,17,41,-3.5,0,Clear,2.2,2023-12-22 03:00:00,3
4,13,17,39,-2.7,0,Clear,1.6,2023-12-22 04:00:00,4
13,35,48,38,-2.3,0,Clear,2.5,2023-12-22 05:00:00,5
28,87,115,41,-2.8,1,Mostly Clear,4.0,2023-12-22 06:00:00,6
51,183,234,43,-4.0,0,Clear,5.4,2023-12-22 07:00:00,7
79,245,324,49,-4.9,0,Clear,7.6,2023-12-22 08:00:00,8
99,252,351,52,-5.6,0,Clear,7.8,2023-12-22 09:00:00,9
107,249,356,55,-6.4,1,Mostly Clear,8.0,2023-12-22 10:00:00,10
157,340,497,58,-7.1,0,Clear,8.3,2023-12-22 11:00:00,11
169,360,529,62,-7.9,1,Mostly Clear,6.8,2023-12-22 12:00:00,12
190,395,585,59,-6.8,1,Mostly Clear,4.0,2023-12-22 13:00:00,13
238,443,681,60,-6.9,1,Mostly Clear,0.8,2023-12-22 14:00:00,14
278,493,771,62,-7.2,1,Mostly Clear,0.8,2023-12-22 15:00:00,15
230,483,713,63,-7.7,0,Clear,1.1,2023-12-22 16:00:00,16
173,392,565,65,-8.2,1,Mostly Clear,3.9,2023-12-22 17:00:00,17
156,270,426,66,-8.7,1,Mostly Clear,2.3,2023-12-22 18:00:00,18
96,226,322,67,-8.9,1,Mostly Clear,0.0,2023-12-22 19:00:00,19
80,175,255,79,-10.3,1,Mostly Clear,4.1,2023-12-22 20:00:00,20
72,162,234,81,-10.5,1,Mostly Clear,2.7,2023-12-22 21:00:00,21
58,156,214,81,-10.7,1,Mostly Clear,2.5,2023-12-22 22:00:00,22
56,116,172,75,-9.8,1,Mostly Clear,3.1,2023-12-22 23:00:00,23
31,64,95,63,-7.4,1,Mostly Clear,1.0,2023-12-23 00:00:00,0
37,41,78,53,-5.1,1,Mostly Clear,2.3,2023-12-23 01:00:00,1
17,24,41,46,-3.5,1,Mostly Clear,2.6,2023-12-23 02:00:00,2
12,12,24,41,-2.2,1,Mostly Clear,2.5,2023-12-23 03:00:00,3
7,9,16,39,-1.5,1,Mostly Clear,3.6,2023-12-23 04:00:00,4
11,21,32,38,-1.3,1,Mostly Clear,4.0,2023-12-23 05:00:00,5
15,45,60,42,-2.2,0,Clear,3.7,2023-12-23 06:00:00,6
31,80,111,47,-3.9,0,Clear,7.7,2023-12-23 07:00:00,7
55,134,189,46,-3.8,0,Clear,9.8,2023-12-23 08:00:00,8
95,200,295,49,-4.8,0,Clear,8.9,2023-12-23 09:00:00,9
118,237,355,53,-5.9,0,Clear,6.6,2023-12-23 10:00:00,10
154,315,469,55,-6.4,0,Clear,5.9,2023-12-23 11:00:00,11
171,321,492,54,-6.1,0,Clear,4.4,2023-12-23 12:00:00,12
211,343,554,53,-5.9,0,Clear,1.1,2023-12-23 13:00:00,13
225,333,558,54,-6.3,0,Clear,2.5,2023-12-23 14:00:00,14
220,342,562,64,-8.1,0,Clear,5.8,2023-12-23 15:00:00,15
175,339,514,71,-8.8,0,Clear,6.5,2023-12-23 16:00:00,16
113,277,390,66,-7.5,0,Clear,2.5,2023-12-23 17:00:00,17
106,228,334,66,-7.8,0,Clear,3.2,2023-12-23 18:00:00,18
71,170,241,66,-8.1,0,Clear,3.1,2023-12-23 19:00:00,19
93,144,237,73,-8.6,0,Clear,2.1,2023-12-23 20:00:00,20
63,155,218,76,-10.2,0,Clear,5.3,2023-12-23 21:00:00,21
64,144,208,80,-11.1,0,Clear,5.5,2023-12-23 22:00:00,22
55,123,178,74,-9.7,1,Mostly Clear,3.4,2023-12-23 23:00:00,23
41,43,84,63,-7.1,0,Clear,4.0,2023-12-24 00:00:00,0
18,33,51,53,-4.7,1,Mostly Clear,4.5,2023-12-24 01:00:00,1
15,19,34,48,-3.2,1,Mostly Clear,3.3,2023-12-24 02:00:00,2
8,16,24,46,-2.7,0,Clear,4.1,2023-12-24 03:00:00,3
10,9,19,43,-1.9,0,Clear,2.3,2023-12-24 04:00:00,4
9,14,23,42,-1.6,1,Mostly Clear,1.5,2023-12-24 05:00:00,5
9,47,56,42,-1.7,1,Mostly Clear,0.5,2023-12-24 06:00:00,6
26,49,75,42,-1.8,1,Mostly Clear,1.8,2023-12-24 07:00:00,7
29,67,96,45,-1.9,1,Mostly Clear,2.1,2023-12-24 08:00:00,8
38,115,153,46,-2.1,0,Clear,3.3,2023-12-24 09:00:00,9
83,178,261,56,-4.5,1,Mostly Clear,6.6,2023-12-24 10:00:00,10
102,227,329,56,-4.3,1,Mostly Clear,5.0,2023-12-24 11:00:00,11
106,250,356,56,-4.4,0,Clear,4.2,2023-12-24 12:00:00,12
134,277,411,59,-5.1,0,Clear,5.0,2023-12-24 13:00:00,13
161,298,459,57,-4.7,0,Clear,2.9,2023-12-24 14:00:00,14
179,260,439,58,-5.2,0,Clear,3.7,2023-12-24 15:00:00,15
137,282,419,67,-7.3,0,Clear,5.9,2023-12-24 16:00:00,16
106,177,283,67,-7.6,0,Clear,5.4,2023-12-24 17:00:00,17
66,175,241,64,-7.1,0,Clear,2.6,2023-12-24 18:00:00,18
68,121,189,66,-7.5,0,Clear,3.1,2023-12-24 19:00:00,19
57,72,129,76,-10.2,0,Clear,10.1,2023-12-24 20:00:00,20
47,73,120,79,-10.5,0,Clear,4.9,2023-12-24 21:00:00,21
32,83,115,80,-10.0,0,Clear,4.0,2023-12-24 22:00:00,22
37,48,85,71,-8.4,0,Clear,3.4,2023-12-24 23:00:00,23
18,33,51,60,-5.8,0,Clear,2.0,2023-12-25 00:00:00,0
10,11,21,51,-3.8,0,Clear,2.8,2023-12-25 01:00:00,1
9,17,26,44,-2.0,0,Clear,3.3,2023-12-25 02:00:00,2
5,6,11,39,-0.6,0,Clear,2.9,2023-12-25 03:00:00,3
3,6,9,36,0.3,0,Clear,2.3,2023-12-25 04:00:00,4
1,7,8,34,0.8,0,Clear,3.9,2023-12-25 05:00:00,5
10,29,39,38,-0.1,0,Clear,4.6,2023-12-25 06:00:00,6
14,29,43,43,-2.1,0,Clear,7.6,2023-12-25 07:00:00,7
25,55,80,42,-1.9,0,Clear,12.7,2023-12-25 08:00:00,8
65,86,151,49,-2.9,0,Clear,12.7,2023-12-25 09:00:00,9
109,105,214,52,-3.9,0,Clear,10.4,2023-12-25 10:00:00,10
127,119,246,54,-4.9,0,Clear,8.3,2023-12-25 11:00:00,11
195,184,379,55,-5.7,0,Clear,6.5,2023-12-25 12:00:00,12
230,224,454,50,-4.5,0,Clear,3.2,2023-12-25 13:00:00,13
323,247,570,51,-5.0,0,Clear,2.1,2023-12-25 14:00:00,14
304,284,588,55,-5.8,0,Clear,4.1,2023-12-25 15:00:00,15
223,191,414,65,-7.8,0,Clear,6.4,2023-12-25 16:00:00,16
116,167,283,59,-6.5,0,Clear,3.9,2023-12-25 17:00:00,17
95,100,195,66,-8.2,0,Clear,5.5,2023-12-25 18:00:00,18
56,100,156,66,-8.5,0,Clear,5.6,2023-12-25 19:00:00,19
45,69,114,64,-7.8,0,Clear,3.3,2023-12-25 20:00:00,20
27,71,98,67,-8.5,0,Clear,1.3,2023-12-25 21:00:00,21
36,70,106,71,-9.4,1,Mostly Clear,4.1,2023-12-25 22:00:00,22
26,53,79,66,-8.4,1,Mostly Clear,4.6,2023-12-25 23:00:00,23
12,36,48,55,-6.0,1,Mostly Clear,3.9,2023-12-26 00:00:00,0
8,23,31,47,-3.8,1,Mostly Clear,4.6,2023-12-26 01:00:00,1
5,7,12,41,-2.1,1,Mostly Clear,4.3,2023-12-26 02:00:00,2
5,4,9,37,-1.0,1,Mostly Clear,2.5,2023-12-26 03:00:00,3
7,6,13,36,-0.5,1,Mostly Clear,3.3,2023-12-26 04:00:00,4
9,18,27,35,-0.3,1,Mostly Clear,5.2,2023-12-26 05:00:00,5
15,41,56,38,-0.9,1,Mostly Clear,4.7,2023-12-26 06:00:00,6
26,74,100,42,-2.2,0,Clear,4.8,2023-12-26 07:00:00,7
35,92,127,43,-3.2,1,Mostly Clear,9.4,2023-12-26 08:00:00,8
32,87,119,48,-4.2,1,Mostly Clear,8.3,2023-12-26 09:00:00,9
44,86,130,49,-4.2,1,Mostly Clear,4.5,2023-12-26 10:00:00,10
56,106,162,47,-3.9,1,Mostly Clear,2.0,2023-12-26 11:00:00,11
67,136,203,48,-4.2,1,Mostly Clear,2.9,2023-12-26 12:00:00,12
92,180,272,49,-4.6,1,Mostly Clear,3.1,2023-12-26 13:00:00,13
68,184,252,52,-5.2,0,Clear,2.9,2023-12-26 14:00:00,14
117,247,364,53,-5.7,0,Clear,1.8,2023-12-26 15:00:00,15
87,269,356,54,-5.9,0,Clear,3.3,2023-12-26 16:00:00,16
119,275,394,56,-6.3,0,Clear,4.4,2023-12-26 17:00:00,17
68,235,303,60,-6.8,0,Clear,3.0,2023-12-26 18:00:00,18
69,153,222,62,-7.3,0,Clear,4.4,2023-12-26 19:00:00,19
69,115,184,67,-8.3,0,Clear,3.7,2023-12-26 20:00:00,20
40,103,143,68,-8.6,1,Mostly Clear,3.9,2023-12-26 21:00:00,21
31,74,105,76,-10.4,1,Mostly Clear,5.8,2023-12-26 22:00:00,22
9,56,65,65,-8.5,1,Mostly Clear,2.5,2023-12-26 23:00:00,23
11,17,28,54,-5.8,0,Clear,4.0,2023-12-27 00:00:00,0
7,6,13,46,-3.8,0,Clear,5.8,2023-12-27 01:00:00,1
1,6,7,40,-2.3,0,Clear,2.4,2023-12-27 02:00:00,2
3,5,8,35,-1.0,1,Mostly Clear,4.3,2023-12-27 03:00:00,3
2,8,10,31,0.4,0,Clear,3.1,2023-12-27 04:00:00,4
7,16,23,30,0.9,0,Clear,2.1,2023-12-27 05:00:00,5
25,58,83,31,0.8,0,Clear,1.3,2023-12-27 06:00:00,6
28,140,168,33,-0.0,0,Clear,1.3,2023-12-27 07:00:00,7
38,151,189,44,-2.5,0,Clear,9.0,2023-12-27 08:00:00,8
39,108,147,46,-3.2,2,Partly Cloudy,6.2,2023-12-27 09:00:00,9
47,101,148,48,-3.2,71,Light Snow,5.4,2023-12-27 10:00:00,10
52,137,189,51,-3.5,1,Mostly Clear,4.7,2023-12-27 11:00:00,11
41,100,141,51,-3.5,0,Clear,4.3,2023-12-27 12:00:00,12
29,139,168,50,-3.7,0,Clear,3.4,2023-12-27 13:00:00,13
48,122,170,51,-4.0,0,Clear,2.8,2023-12-27 14:00:00,14
34,101,135,59,-6.0,0,Clear,5.8,2023-12-27 15:00:00,15
32,120,152,60,-6.2,0,Clear,5.8,2023-12-27 16:00:00,16
28,94,122,67,-7.7,0,Clear,8.8,2023-12-27 17:00:00,17
31,102,133,69,-8.0,0,Clear,7.5,2023-12-27 18:00:00,18
26,54,80,70,-8.3,0,Clear,10.1,2023-12-27 19:00:00,19
18,60,78,73,-9.2,0,Clear,8.9,2023-12-27 20:00:00,20
42,120,162,71,-9.0,0,Clear,6.1,2023-12-27 21:00:00,21
31,101,132,73,-8.8,0,Clear,5.6,2023-12-27 22:00:00,22
26,68,94,65,-6.8,0,Clear,7.1,2023-12-27 23:00:00,23
14,28,42,51,-3.3,0,Clear,5.5,2023-12-28 00:00:00,0
17,18,35,39,-0.3,0,Clear,4.7,2023-12-28 01:00:00,1
7,6,13,33,2.2,0,Clear,4.3,2023-12-28 02:00:00,2
2,5,7,30,4.2,0,Clear,5.5,2023-12-28 03:00:00,3
6,10,16,29,5.1,0,Clear,6.1,2023-12-28 04:00:00,4
9,38,47,30,5.1,0,Clear,5.1,2023-12-28 05:00:00,5
30,75,105,31,4.7,0,Clear,3.2,2023-12-28 06:00:00,6
42,157,199,33,4.0,0,Clear,1.9,2023-12-28 07:00:00,7
68,215,283,37,3.0,0,Clear,5.2,2023-12-28 08:00:00,8
121,243,364,48,-0.6,0,Clear,8.6,2023-12-28 09:00:00,9
140,199,339,46,-1.5,0,Clear,11.5,2023-12-28 10:00:00,10
161,238,399,49,-2.5,0,Clear,11.9,2023-12-28 11:00:00,11
255,299,554,51,-3.4,0,Clear,11.3,2023-12-28 12:00:00,12
272,351,623,54,-4.0,0,Clear,11.7,2023-12-28 13:00:00,13
378,350,728,58,-4.6,0,Clear,12.8,2023-12-28 14:00:00,14
375,409,784,64,-5.2,0,Clear,12.1,2023-12-28 15:00:00,15
329,479,808,71,-6.3,0,Clear,8.7,2023-12-28 16:00:00,16
261,453,714,70,-6.2,0,Clear,5.8,2023-12-28 17:00:00,17
160,363,523,74,-7.3,0,Clear,7.4,2023-12-28 18:00:00,18
151,245,396,76,-7.9,0,Clear,9.4,2023-12-28 19:00:00,19
120,212,332,80,-9.2,0,Clear,9.5,2023-12-28 20:00:00,20
85,168,253,80,-9.6,0,Clear,9.9,2023-12-28 21:00:00,21
60,154,214,81,-9.0,0,Clear,7.9,2023-12-28 22:00:00,22
36,104,140,71,-7.1,0,Clear,3.6,2023-12-28 23:00:00,23
37,47,84,61,-4.8,0,Clear,5.2,2023-12-29 00:00:00,0
26,31,57,52,-2.9,0,Clear,4.6,2023-12-29 01:00:00,1
25,20,45,45,-1.3,1,Mostly Clear,4.1,2023-12-29 02:00:00,2
9,11,20,42,-0.1,0,Clear,1.9,2023-12-29 03:00:00,3
11,9,20,40,0.5,1,Mostly Clear,1.8,2023-12-29 04:00:00,4
16,26,42,40,0.8,1,Mostly Clear,1.5,2023-12-29 05:00:00,5
35,88,123,50,0.3,1,Mostly Clear,2.2,2023-12-29 06:00:00,6
54,153,207,42,0.2,1,Mostly Clear,2.3,2023-12-29 07:00:00,7
81,224,305,47,-0.8,1,Mostly Clear,0.7,2023-12-29 08:00:00,8
128,234,362,47,-0.9,1,Mostly Clear,1.0,2023-12-29 09:00:00,9
173,242,415,48,-1.3,1,Mostly Clear,3.1,2023-12-29 10:00:00,10
280,328,608,59,-4.1,1,Mostly Clear,6.7,2023-12-29 11:00:00,11
298,365,663,63,-5.1,0,Clear,8.6,2023-12-29 12:00:00,12
316,393,709,67,-6.0,0,Clear,7.2,2023-12-29 13:00:00,13
365,438,803,67,-6.0,0,Clear,6.0,2023-12-29 14:00:00,14
408,500,908,59,-4.6,0,Clear,3.3,2023-12-29 15:00:00,15
353,464,817,62,-5.1,1,Mostly Clear,1.1,2023-12-29 16:00:00,16
235,435,670,63,-5.4,0,Clear,1.5,2023-12-29 17:00:00,17
167,306,473,64,-5.6,0,Clear,1.1,2023-12-29 18:00:00,18
132,259,391,65,-5.9,0,Clear,4.3,2023-12-29 19:00:00,19
94,165,259,78,-9.8,0,Clear,9.5,2023-12-29 20:00:00,20
89,150,239,79,-10.1,0,Clear,9.4,2023-12-29 21:00:00,21
93,157,250,76,-8.5,0,Clear,4.1,2023-12-29 22:00:00,22
66,123,189,71,-7.2,0,Clear,4.0,2023-12-29 23:00:00,23
49,70,119,60,-4.5,0,Clear,4.8,2023-12-30 00:00:00,0
22,53,75,49,-1.6,0,Clear,7.0,2023-12-30 01:00:00,1
22,40,62,40,1.3,0,Clear,7.6,2023-12-30 02:00:00,2
19,13,32,35,3.6,0,Clear,7.2,2023-12-30 03:00:00,3
7,9,16,33,4.9,0,Clear,7.4,2023-12-30 04:00:00,4
9,25,34,32,5.3,0,Clear,6.4,2023-12-30 05:00:00,5
16,38,54,49,2.8,0,Clear,6.2,2023-12-30 06:00:00,6
33,78,111,49,0.9,0,Clear,7.6,2023-12-30 07:00:00,7
45,134,179,47,0.4,0,Clear,12.2,2023-12-30 08:00:00,8
109,210,319,51,-0.8,0,Clear,11.3,2023-12-30 09:00:00,9
167,266,433,52,-1.7,0,Clear,10.9,2023-12-30 10:00:00,10
219,337,556,57,-3.2,0,Clear,7.0,2023-12-30 11:00:00,11
297,333,630,59,-3.7,0,Clear,6.1,2023-12-30 12:00:00,12
322,326,648,64,-4.8,0,Clear,6.7,2023-12-30 13:00:00,13
343,352,695,67,-5.2,0,Clear,10.2,2023-12-30 14:00:00,14
340,417,757,69,-5.7,1,Mostly Clear,10.7,2023-12-30 15:00:00,15
280,437,717,71,-6.4,0,Clear,10.2,2023-12-30 16:00:00,16
230,295,525,76,-7.4,0,Clear,7.4,2023-12-30 17:00:00,17
145,256,401,72,-7.1,0,Clear,5.3,2023-12-30 18:00:00,18
115,227,342,68,-6.4,0,Clear,4.1,2023-12-30 19:00:00,19
84,147,231,72,-6.8,0,Clear,2.5,2023-12-30 20:00:00,20
67,131,198,77,-8.8,0,Clear,13.8,2023-12-30 21:00:00,21
82,159,241,77,-8.3,0,Clear,11.7,2023-12-30 22:00:00,22
75,144,219,68,-6.4,0,Clear,6.1,2023-12-30 23:00:00,23
40,91,131,59,-4.5,0,Clear,4.6,2023-12-31 00:00:00,0
39,41,80,52,-2.8,0,Clear,5.6,2023-12-31 01:00:00,1
21,31,52,45,-1.0,0,Clear,7.6,2023-12-31 02:00:00,2
12,18,30,41,0.4,0,Clear,6.2,2023-12-31 03:00:00,3
14,10,24,39,1.2,0,Clear,4.1,2023-12-31 04:00:00,4
6,12,18,39,1.4,0,Clear,2.7,2023-12-31 05:00:00,5
14,42,56,39,1.2,0,Clear,2.2,2023-12-31 06:00:00,6
27,71,98,50,-0.9,0,Clear,5.0,2023-12-31 07:00:00,7
50,128,178,54,-1.9,0,Clear,8.0,2023-12-31 08:00:00,8
84,198,282,53,-2.7,0,Clear,10.2,2023-12-31 09:00:00,9
125,259,384,54,-3.8,0,Clear,10.1,2023-12-31 10:00:00,10
226,337,563,56,-4.6,0,Clear,9.8,2023-12-31 11:00:00,11
245,389,634,60,-5.6,0,Clear,8.7,2023-12-31 12:00:00,12
289,386,675,65,-6.5,0,Clear,6.5,2023-12-31 13:00:00,13
286,400,686,60,-5.3,0,Clear,1.5,2023-12-31 14:00:00,14
249,400,649,64,-6.4,0,Clear,4.1,2023-12-31 15:00:00,15
250,390,640,69,-7.3,0,Clear,4.3,2023-12-31 16:00:00,16
206,296,502,68,-7.0,0,Clear,3.3,2023-12-31 17:00:00,17
150,220,370,69,-7.4,0,Clear,3.1,2023-12-31 18:00:00,18
132,190,322,71,-7.7,0,Clear,3.3,2023-12-31 19:00:00,19
125,194,319,79,-10.2,0,Clear,6.7,2023-12-31 20:00:00,20
84,137,221,80,-11.0,0,Clear,10.0,2023-12-31 21:00:00,21
83,142,225,80,-10.4,0,Clear,8.7,2023-12-31 22:00:00,22
82,106,188,73,-8.5,0,Clear,3.7,2023-12-31 23:00:00,23
